ProductID,Date,StockOnHand,DeliveredQuantity,SalesQuantity,WasteQuantity,Recommended stock Quantity
75,2022/06/01,58,36,36,6,94
76,2022/06/01,67,40,42,7,109
99,2022/06/01,6,0,0,0,6
117,2022/06/01,5,4,1,0,6
118,2022/06/01,6,4,0,0,6
119,2022/06/01,4,0,3,0,7
120,2022/06/01,8,0,0,0,8
149,2022/06/01,3,0,0,0,3
184,2022/06/01,25,15,8,1,33
195,2022/06/01,47,33,32,1,79
218,2022/06/01,39,27,21,9,60
296,2022/06/01,4,0,1,0,5
300,2022/06/01,14,8,1,0,15
304,2022/06/01,16,6,2,0,18
317,2022/06/01,16,16,8,0,24
343,2022/06/01,7,4,1,0,8
353,2022/06/01,5,0,1,0,6
373,2022/06/01,12,8,8,0,20
374,2022/06/01,6,4,2,0,8
388,2022/06/01,27,21,15,0,42
419,2022/06/01,17,16,11,0,28
420,2022/06/01,12,8,8,0,20
462,2022/06/01,18,8,4,0,22
519,2022/06/01,11,0,2,0,13
525,2022/06/01,8,0,2,0,10
596,2022/06/01,18,4,3,0,21
597,2022/06/01,28,12,7,0,35
598,2022/06/01,8,0,4,0,12
1035,2022/06/01,15,12,6,0,21
1084,2022/06/01,27,10,8,4,35
1111,2022/06/01,12,0,0,0,12
1113,2022/06/01,11,6,0,0,11
1114,2022/06/01,14,6,4,0,18
1115,2022/06/01,10,6,1,0,11
1117,2022/06/01,8,0,0,0,8
1118,2022/06/01,13,0,1,0,14
1119,2022/06/01,7,0,0,0,7
1692,2022/06/01,15,0,7,0,22
1693,2022/06/01,31,0,5,0,36
1747,2022/06/01,34,20,17,0,51
1772,2022/06/01,6,0,0,0,6
1773,2022/06/01,11,0,0,0,11
1774,2022/06/01,10,8,5,0,15
1782,2022/06/01,43,24,16,2,59
1795,2022/06/01,27,14,7,0,34
1914,2022/06/01,5,0,0,0,5
1915,2022/06/01,6,0,0,0,6
1923,2022/06/01,12,0,1,0,13
1934,2022/06/01,9,6,2,0,11
1963,2022/06/01,25,16,15,0,40
1984,2022/06/01,5,0,3,0,8
2135,2022/06/01,10,6,0,0,10
2136,2022/06/01,8,6,1,0,9
2148,2022/06/01,4,0,2,0,6
2183,2022/06/01,7,6,5,0,12
2193,2022/06/01,34,21,15,8,49
2237,2022/06/01,6,0,0,0,6
2358,2022/06/01,20,8,2,0,22
2361,2022/06/01,16,7,2,0,18
2445,2022/06/01,21,0,5,0,26
2449,2022/06/01,8,0,6,0,14
2451,2022/06/01,0,0,8,0,8
2475,2022/06/01,12,0,1,0,13
2476,2022/06/01,6,0,0,0,6
2507,2022/06/01,28,12,7,0,35
2525,2022/06/01,7,0,1,0,8
2562,2022/06/01,37,0,7,0,44
2582,2022/06/01,5,0,0,0,5
2586,2022/06/01,23,20,10,1,33
2631,2022/06/01,4,0,4,0,8
2685,2022/06/01,13,8,6,0,19
2723,2022/06/01,10,0,0,0,10
2730,2022/06/01,9,6,1,0,10
2731,2022/06/01,14,0,1,0,15
2732,2022/06/01,7,0,0,0,7
2734,2022/06/01,5,0,0,0,5
2735,2022/06/01,15,8,2,0,17
2761,2022/06/01,22,20,12,0,34
2788,2022/06/01,21,12,9,8,30
2812,2022/06/01,5,0,0,0,5
2813,2022/06/01,9,0,1,0,10
2814,2022/06/01,7,0,2,0,9
2913,2022/06/01,8,0,2,0,10
2914,2022/06/01,5,0,1,0,6
3015,2022/06/01,7,0,0,0,7
3033,2022/06/01,8,0,0,0,8
3035,2022/06/01,6,0,0,0,6
4446,2022/06/01,19,9,8,1,27
12136,2022/06/01,31,18,21,7,52
12516,2022/06/01,8,0,2,0,10
12518,2022/06/01,12,0,1,0,13
12523,2022/06/01,11,4,1,0,12
16062,2022/06/01,7,0,0,0,7
16063,2022/06/01,11,6,0,0,11
19322,2022/06/01,8,0,0,0,8
19329,2022/06/01,12,0,2,0,14
19516,2022/06/01,12,8,6,0,18
19520,2022/06/01,9,0,1,0,10
75,2022/06/02,60,44,59,2,119
76,2022/06/02,52,32,36,0,88
99,2022/06/02,6,0,1,0,7
117,2022/06/02,8,4,6,0,14
118,2022/06/02,10,4,2,0,12
119,2022/06/02,1,0,0,0,1
120,2022/06/02,8,0,2,3,10
149,2022/06/02,9,6,0,0,9
184,2022/06/02,31,15,19,1,50
195,2022/06/02,39,24,28,0,67
218,2022/06/02,18,9,10,10,28
296,2022/06/02,9,6,3,0,12
300,2022/06/02,13,0,3,0,16
304,2022/06/02,14,0,5,0,19
317,2022/06/02,16,8,9,0,25
343,2022/06/02,10,4,5,1,15
353,2022/06/02,4,0,0,0,4
373,2022/06/02,12,8,12,0,24
374,2022/06/02,8,4,1,0,9
388,2022/06/02,31,18,24,4,55
419,2022/06/02,6,0,6,0,12
420,2022/06/02,4,0,0,0,4
462,2022/06/02,14,0,6,0,20
519,2022/06/02,21,12,8,0,29
525,2022/06/02,6,0,0,0,6
596,2022/06/02,15,0,2,4,17
597,2022/06/02,22,0,12,2,34
598,2022/06/02,4,0,2,0,6
1035,2022/06/02,15,6,2,0,17
1084,2022/06/02,15,0,5,0,20
1111,2022/06/02,12,0,0,0,12
1113,2022/06/02,11,0,0,0,11
1114,2022/06/02,10,0,0,0,10
1115,2022/06/02,9,0,2,0,11
1117,2022/06/02,8,0,0,0,8
1118,2022/06/02,12,0,2,0,14
1119,2022/06/02,7,0,0,0,7
1692,2022/06/02,8,0,4,0,12
1693,2022/06/02,26,0,3,0,29
1747,2022/06/02,32,15,27,0,59
1772,2022/06/02,6,0,0,0,6
1773,2022/06/02,11,0,1,0,12
1774,2022/06/02,5,0,3,0,8
1782,2022/06/02,34,9,22,9,56
1795,2022/06/02,34,14,19,0,53
1914,2022/06/02,5,0,0,0,5
1915,2022/06/02,6,0,0,0,6
1923,2022/06/02,11,0,0,0,11
1934,2022/06/02,7,0,2,0,9
1963,2022/06/02,18,8,11,0,29
1984,2022/06/02,8,6,0,0,8
2135,2022/06/02,10,0,1,0,11
2136,2022/06/02,7,0,0,0,7
2148,2022/06/02,2,0,1,0,3
2183,2022/06/02,8,6,4,0,12
2193,2022/06/02,26,15,15,6,41
2237,2022/06/02,6,0,2,0,8
2358,2022/06/02,18,0,3,0,21
2361,2022/06/02,14,0,5,0,19
2445,2022/06/02,16,0,4,0,20
2449,2022/06/02,10,8,10,0,20
2451,2022/06/02,2,10,1,0,3
2475,2022/06/02,11,0,0,0,11
2476,2022/06/02,6,0,1,0,7
2507,2022/06/02,21,0,14,0,35
2525,2022/06/02,6,0,0,0,6
2562,2022/06/02,30,0,11,0,41
2582,2022/06/02,5,0,0,0,5
2586,2022/06/02,32,20,27,1,59
2631,2022/06/02,6,6,0,0,6
2685,2022/06/02,11,4,6,0,17
2723,2022/06/02,10,0,1,0,11
2730,2022/06/02,8,0,1,0,9
2731,2022/06/02,13,0,1,0,14
2732,2022/06/02,7,0,1,0,8
2734,2022/06/02,9,4,4,0,13
2735,2022/06/02,13,0,1,0,14
2761,2022/06/02,30,20,22,1,52
2788,2022/06/02,20,16,12,1,32
2812,2022/06/02,5,0,0,0,5
2813,2022/06/02,8,0,0,0,8
2814,2022/06/02,5,0,0,0,5
2913,2022/06/02,6,0,0,0,6
2914,2022/06/02,4,0,1,0,5
3015,2022/06/02,7,0,0,0,7
3033,2022/06/02,8,0,0,0,8
3035,2022/06/02,6,0,0,0,6
4446,2022/06/02,19,9,9,8,28
12136,2022/06/02,25,21,20,2,45
12516,2022/06/02,6,0,4,0,10
12518,2022/06/02,11,0,5,0,16
12523,2022/06/02,10,0,3,0,13
16062,2022/06/02,7,0,0,0,7
16063,2022/06/02,11,0,1,0,12
19322,2022/06/02,8,0,0,0,8
19329,2022/06/02,10,0,2,0,12
19516,2022/06/02,6,0,2,0,8
19520,2022/06/02,8,0,0,0,8
75,2022/06/03,11,12,10,0,21
76,2022/06/03,46,32,34,0,80
99,2022/06/03,5,0,0,0,5
117,2022/06/03,6,4,3,0,9
118,2022/06/03,8,0,3,0,11
119,2022/06/03,5,4,2,0,7
120,2022/06/03,3,0,1,0,4
149,2022/06/03,9,0,0,0,9
184,2022/06/03,20,9,15,7,35
195,2022/06/03,40,30,28,0,68
218,2022/06/03,28,30,28,0,56
296,2022/06/03,12,6,4,0,16
300,2022/06/03,10,0,5,1,15
304,2022/06/03,15,6,3,0,18
317,2022/06/03,24,16,11,0,35
343,2022/06/03,8,4,1,0,9
353,2022/06/03,4,0,1,0,5
373,2022/06/03,0,0,0,0,0
374,2022/06/03,11,4,4,0,15
388,2022/06/03,26,24,27,0,53
419,2022/06/03,8,8,8,0,16
420,2022/06/03,12,8,7,0,19
462,2022/06/03,16,8,7,0,23
519,2022/06/03,25,12,12,0,37
525,2022/06/03,6,0,3,0,9
596,2022/06/03,13,4,3,0,16
597,2022/06/03,31,24,17,1,48
598,2022/06/03,8,6,2,0,10
1035,2022/06/03,25,12,7,0,32
1084,2022/06/03,20,10,11,0,31
1111,2022/06/03,12,0,1,0,13
1112,2022/06/03,7,0,0,0,7
1113,2022/06/03,11,0,0,0,11
1114,2022/06/03,10,0,0,0,10
1115,2022/06/03,7,0,1,0,8
1117,2022/06/03,8,0,0,0,8
1118,2022/06/03,10,0,3,0,13
1119,2022/06/03,7,0,1,0,8
1692,2022/06/03,4,0,0,0,4
1693,2022/06/03,23,0,0,0,23
1747,2022/06/03,25,20,24,0,49
1772,2022/06/03,6,0,0,0,6
1773,2022/06/03,10,0,1,0,11
1774,2022/06/03,2,0,0,0,2
1782,2022/06/03,18,15,15,2,33
1795,2022/06/03,36,21,7,0,43
1914,2022/06/03,5,0,0,0,5
1915,2022/06/03,6,0,0,0,6
1923,2022/06/03,11,0,4,0,15
1934,2022/06/03,11,6,2,0,13
1963,2022/06/03,15,8,9,0,24
1984,2022/06/03,14,6,4,0,18
2135,2022/06/03,9,0,1,0,10
2136,2022/06/03,7,0,0,0,7
2148,2022/06/03,5,4,2,0,7
2183,2022/06/03,16,12,5,0,21
2193,2022/06/03,23,18,7,7,30
2237,2022/06/03,4,0,0,0,4
2358,2022/06/03,15,0,3,0,18
2361,2022/06/03,16,7,7,0,23
2445,2022/06/03,18,6,3,5,21
2449,2022/06/03,16,16,11,0,27
2451,2022/06/03,6,5,7,0,13
2475,2022/06/03,11,0,0,0,11
2476,2022/06/03,5,0,4,0,9
2507,2022/06/03,20,12,9,0,29
2525,2022/06/03,6,0,3,0,9
2562,2022/06/03,27,8,14,0,41
2582,2022/06/03,9,4,1,0,10
2586,2022/06/03,20,16,17,0,37
2631,2022/06/03,12,6,2,0,14
2685,2022/06/03,13,8,10,3,23
2723,2022/06/03,9,0,0,0,9
2730,2022/06/03,7,0,2,0,9
2731,2022/06/03,12,0,3,0,15
2732,2022/06/03,6,0,3,0,9
2734,2022/06/03,9,4,2,0,11
2735,2022/06/03,12,0,1,0,13
2761,2022/06/03,22,15,21,0,43
2788,2022/06/03,26,20,24,0,50
2812,2022/06/03,5,0,1,0,6
2813,2022/06/03,8,0,2,0,10
2814,2022/06/03,11,6,1,0,12
2913,2022/06/03,12,6,4,0,16
2914,2022/06/03,3,0,1,0,4
3015,2022/06/03,7,0,3,0,10
3033,2022/06/03,8,0,0,0,8
3035,2022/06/03,6,0,1,0,7
4446,2022/06/03,17,15,8,0,25
12136,2022/06/03,27,24,25,0,52
12516,2022/06/03,6,4,0,0,6
12518,2022/06/03,16,10,4,0,20
12523,2022/06/03,7,0,2,0,9
16062,2022/06/03,7,0,0,0,7
16063,2022/06/03,10,0,4,0,14
19322,2022/06/03,8,0,0,0,8
19329,2022/06/03,8,0,1,0,9
19516,2022/06/03,12,8,5,0,17
19520,2022/06/03,8,0,1,0,9
75,2022/06/04,25,24,22,0,47
76,2022/06/04,40,28,25,0,65
99,2022/06/04,5,0,0,0,5
117,2022/06/04,3,0,2,0,5
118,2022/06/04,9,4,3,0,12
119,2022/06/04,3,0,1,0,4
120,2022/06/04,2,0,1,0,3
149,2022/06/04,9,0,1,0,10
184,2022/06/04,10,12,12,0,22
195,2022/06/04,33,21,23,1,56
218,2022/06/04,18,18,19,0,37
296,2022/06/04,14,6,10,0,24
300,2022/06/04,12,8,5,0,17
304,2022/06/04,12,0,5,0,17
317,2022/06/04,28,16,8,0,36
343,2022/06/04,7,0,1,0,8
353,2022/06/04,3,0,0,0,3
373,2022/06/04,16,16,8,0,24
374,2022/06/04,11,4,1,0,12
388,2022/06/04,-16,9,6,0,-10
419,2022/06/04,16,16,7,0,23
420,2022/06/04,21,16,8,0,29
462,2022/06/04,17,8,4,0,21
519,2022/06/04,19,6,8,0,27
525,2022/06/04,3,0,1,0,4
596,2022/06/04,10,0,3,0,13
597,2022/06/04,13,0,11,0,24
598,2022/06/04,6,0,2,0,8
1035,2022/06/04,18,0,7,0,25
1084,2022/06/04,9,0,7,0,16
1111,2022/06/04,11,0,0,0,11
1112,2022/06/04,7,0,0,0,7
1113,2022/06/04,11,0,0,0,11
1114,2022/06/04,10,0,5,0,15
1115,2022/06/04,6,0,2,0,8
1117,2022/06/04,8,0,0,0,8
1118,2022/06/04,7,0,0,0,7
1119,2022/06/04,6,0,0,0,6
1692,2022/06/04,12,8,5,0,17
1693,2022/06/04,23,0,0,0,23
1747,2022/06/04,21,20,20,0,41
1772,2022/06/04,6,0,0,0,6
1773,2022/06/04,9,0,3,0,12
1774,2022/06/04,2,0,0,0,2
1782,2022/06/04,4,18,17,0,21
1795,2022/06/04,57,28,24,1,81
1914,2022/06/04,5,0,0,0,5
1915,2022/06/04,6,0,0,0,6
1923,2022/06/04,7,0,1,0,8
1934,2022/06/04,9,0,4,2,13
1963,2022/06/04,22,16,16,0,38
1984,2022/06/04,10,0,4,0,14
2135,2022/06/04,8,0,1,0,9
2136,2022/06/04,7,0,0,0,7
2148,2022/06/04,7,4,3,0,10
2183,2022/06/04,17,6,3,0,20
2193,2022/06/04,9,0,5,3,14
2237,2022/06/04,4,0,3,0,7
2358,2022/06/04,12,0,5,0,17
2361,2022/06/04,9,0,3,0,12
2445,2022/06/04,16,6,6,0,22
2449,2022/06/04,21,16,6,0,27
2451,2022/06/04,4,5,4,0,8
2475,2022/06/04,11,0,1,0,12
2476,2022/06/04,1,0,0,0,1
2507,2022/06/04,10,0,8,0,18
2525,2022/06/04,3,0,1,0,4
2562,2022/06/04,21,8,4,0,25
2582,2022/06/04,12,4,2,0,14
2586,2022/06/04,11,8,8,0,19
2631,2022/06/04,16,6,1,0,17
2685,2022/06/04,0,0,2,0,2
2723,2022/06/04,9,0,0,0,9
2730,2022/06/04,5,0,2,0,7
2731,2022/06/04,9,0,2,0,11
2732,2022/06/04,3,0,1,0,4
2734,2022/06/04,7,0,2,0,9
2735,2022/06/04,11,0,3,0,14
2761,2022/06/04,11,10,12,0,23
2788,2022/06/04,13,12,14,1,27
2812,2022/06/04,4,0,0,0,4
2813,2022/06/04,6,0,0,0,6
2814,2022/06/04,10,0,0,0,10
2913,2022/06/04,8,0,2,0,10
2914,2022/06/04,2,0,0,0,2
3015,2022/06/04,4,0,1,0,5
3033,2022/06/04,8,0,0,0,8
3035,2022/06/04,5,0,0,0,5
4446,2022/06/04,21,12,17,1,38
12136,2022/06/04,17,15,15,0,32
12516,2022/06/04,6,0,1,0,7
12518,2022/06/04,12,0,0,0,12
12523,2022/06/04,9,4,3,0,12
16062,2022/06/04,7,0,1,0,8
16063,2022/06/04,6,0,1,0,7
19322,2022/06/04,8,0,1,0,9
19329,2022/06/04,7,0,0,0,7
19516,2022/06/04,23,16,7,0,30
19520,2022/06/04,7,0,2,0,9
75,2022/06/05,35,32,25,0,60
76,2022/06/05,39,24,22,3,61
99,2022/06/05,5,0,0,0,5
117,2022/06/05,1,0,0,0,1
118,2022/06/05,6,0,2,1,8
119,2022/06/05,6,4,2,0,8
120,2022/06/05,5,4,0,1,5
149,2022/06/05,8,0,1,0,9
184,2022/06/05,1,3,3,0,4
195,2022/06/05,30,21,18,0,48
218,2022/06/05,17,18,11,0,28
296,2022/06/05,10,6,4,0,14
300,2022/06/05,7,0,2,0,9
304,2022/06/05,7,0,4,0,11
317,2022/06/05,36,16,14,0,50
343,2022/06/05,6,0,1,0,7
353,2022/06/05,3,0,0,0,3
373,2022/06/05,16,8,7,0,23
374,2022/06/05,14,4,5,0,19
388,2022/06/05,-10,12,12,0,2
419,2022/06/05,25,16,7,0,32
420,2022/06/05,21,8,8,0,29
462,2022/06/05,13,0,10,2,23
519,2022/06/05,17,6,6,0,23
525,2022/06/05,2,0,1,0,3
596,2022/06/05,7,0,1,0,8
597,2022/06/05,2,0,4,0,6
598,2022/06/05,4,0,1,1,5
1035,2022/06/05,17,6,5,0,22
1084,2022/06/05,12,10,7,0,19
1111,2022/06/05,11,0,0,0,11
1113,2022/06/05,11,0,1,1,12
1114,2022/06/05,5,0,0,0,5
1115,2022/06/05,10,6,3,0,13
1117,2022/06/05,8,0,0,0,8
1118,2022/06/05,7,0,0,0,7
1119,2022/06/05,6,0,2,0,8
1692,2022/06/05,15,8,4,0,19
1693,2022/06/05,23,0,0,0,23
1747,2022/06/05,6,5,4,0,10
1772,2022/06/05,6,0,0,0,6
1773,2022/06/05,6,0,0,0,6
1774,2022/06/05,2,0,0,0,2
1782,2022/06/05,-1,12,10,0,9
1795,2022/06/05,32,0,11,0,43
1914,2022/06/05,5,0,0,0,5
1915,2022/06/05,6,0,1,0,7
1923,2022/06/05,6,0,3,0,9
1934,2022/06/05,9,6,3,1,12
1963,2022/06/05,30,24,14,1,44
1984,2022/06/05,12,6,1,0,13
2135,2022/06/05,7,0,2,0,9
2136,2022/06/05,7,0,1,0,8
2148,2022/06/05,12,8,1,0,13
2183,2022/06/05,20,6,5,0,25
2193,2022/06/05,13,12,4,0,17
2237,2022/06/05,7,6,3,0,10
2358,2022/06/05,15,8,0,7,15
2361,2022/06/05,6,0,1,1,7
2445,2022/06/05,16,6,2,0,18
2449,2022/06/05,23,8,8,0,31
2451,2022/06/05,15,15,4,0,19
2475,2022/06/05,10,0,0,0,10
2476,2022/06/05,1,0,0,0,1
2507,2022/06/05,8,6,6,0,14
2525,2022/06/05,2,0,2,0,4
2562,2022/06/05,25,8,7,0,32
2582,2022/06/05,10,0,1,0,11
2586,2022/06/05,11,8,11,0,22
2631,2022/06/05,21,6,1,0,22
2685,2022/06/05,2,4,2,0,4
2723,2022/06/05,9,0,1,0,10
2730,2022/06/05,3,0,6,0,9
2731,2022/06/05,7,0,2,0,9
2732,2022/06/05,2,0,0,0,2
2734,2022/06/05,5,0,0,0,5
2735,2022/06/05,8,0,2,0,10
2761,2022/06/05,9,10,10,0,19
2788,2022/06/05,11,12,12,1,23
2812,2022/06/05,4,0,1,0,5
2813,2022/06/05,6,0,1,0,7
2814,2022/06/05,10,0,1,0,11
2913,2022/06/05,12,6,1,2,13
2914,2022/06/05,8,6,1,0,9
3015,2022/06/05,3,0,1,0,4
3033,2022/06/05,8,0,2,0,10
3035,2022/06/05,5,0,0,0,5
4446,2022/06/05,9,6,6,2,15
12136,2022/06/05,17,15,14,0,31
12516,2022/06/05,9,4,1,0,10
12518,2022/06/05,12,0,0,0,12
12523,2022/06/05,14,8,3,0,17
16062,2022/06/05,6,0,0,0,6
16063,2022/06/05,5,0,2,0,7
19322,2022/06/05,7,0,0,0,7
19329,2022/06/05,7,0,0,0,7
19516,2022/06/05,32,16,8,0,40
19520,2022/06/05,5,0,0,0,5
75,2022/06/06,50,40,28,1,78
76,2022/06/06,58,44,36,0,94
99,2022/06/06,5,0,0,0,5
117,2022/06/06,5,4,0,0,5
118,2022/06/06,3,0,1,1,4
119,2022/06/06,4,0,2,0,6
120,2022/06/06,4,0,4,0,8
149,2022/06/06,7,0,1,0,8
184,2022/06/06,10,12,5,0,15
195,2022/06/06,36,24,25,0,61
218,2022/06/06,27,21,20,0,47
296,2022/06/06,6,0,3,0,9
300,2022/06/06,5,0,4,0,9
304,2022/06/06,9,6,4,0,13
317,2022/06/06,38,16,10,0,48
343,2022/06/06,9,4,1,0,10
353,2022/06/06,9,6,0,0,9
373,2022/06/06,17,8,7,0,24
374,2022/06/06,9,0,3,0,12
388,2022/06/06,-4,18,11,0,7
419,2022/06/06,34,16,14,1,48
420,2022/06/06,21,8,9,0,30
462,2022/06/06,9,8,11,0,20
519,2022/06/06,17,6,1,0,18
525,2022/06/06,6,5,1,0,7
596,2022/06/06,10,4,4,0,14
597,2022/06/06,10,12,7,0,17
598,2022/06/06,8,6,2,0,10
1035,2022/06/06,12,0,4,2,16
1084,2022/06/06,10,5,7,0,17
1111,2022/06/06,11,0,0,0,11
1113,2022/06/06,9,0,1,0,10
1114,2022/06/06,5,0,0,0,5
1115,2022/06/06,7,0,1,0,8
1117,2022/06/06,8,0,0,0,8
1118,2022/06/06,13,6,1,0,14
1119,2022/06/06,4,0,0,0,4
1692,2022/06/06,19,8,7,0,26
1693,2022/06/06,23,0,0,0,23
1747,2022/06/06,22,20,13,0,35
1772,2022/06/06,6,0,1,0,7
1773,2022/06/06,6,0,1,0,7
1774,2022/06/06,10,8,0,0,10
1782,2022/06/06,13,24,18,0,31
1795,2022/06/06,21,0,12,0,33
1915,2022/06/06,11,6,1,0,12
1923,2022/06/06,9,6,1,0,10
1934,2022/06/06,5,0,2,0,7
1963,2022/06/06,31,16,8,0,39
1984,2022/06/06,11,0,2,0,13
2135,2022/06/06,11,6,1,0,12
2136,2022/06/06,6,0,1,0,7
2148,2022/06/06,11,0,1,0,12
2183,2022/06/06,15,0,3,6,18
2193,2022/06/06,24,15,15,6,39
2237,2022/06/06,4,0,2,0,6
2358,2022/06/06,8,0,5,0,13
2361,2022/06/06,11,7,0,0,11
2445,2022/06/06,14,0,4,0,18
2449,2022/06/06,23,8,10,0,33
2451,2022/06/06,11,0,6,0,17
2475,2022/06/06,10,0,0,0,10
2476,2022/06/06,7,6,1,0,8
2507,2022/06/06,14,12,8,0,22
2525,2022/06/06,6,6,0,0,6
2562,2022/06/06,26,8,8,9,34
2582,2022/06/06,9,0,1,0,10
2586,2022/06/06,16,16,11,0,27
2631,2022/06/06,26,6,0,4,26
2685,2022/06/06,4,4,4,0,8
2723,2022/06/06,8,0,0,0,8
2730,2022/06/06,3,6,0,0,3
2731,2022/06/06,11,6,1,0,12
2732,2022/06/06,10,8,0,0,10
2734,2022/06/06,5,0,0,0,5
2735,2022/06/06,6,0,5,0,11
2761,2022/06/06,13,15,11,0,24
2788,2022/06/06,10,12,8,1,18
2812,2022/06/06,9,6,1,0,10
2813,2022/06/06,11,6,0,0,11
2814,2022/06/06,9,0,1,0,10
2913,2022/06/06,9,0,0,0,9
2914,2022/06/06,7,0,0,0,7
3015,2022/06/06,10,8,0,0,10
3033,2022/06/06,6,0,0,0,6
3035,2022/06/06,11,6,2,0,13
4446,2022/06/06,13,12,12,0,25
12136,2022/06/06,28,24,20,0,48
12516,2022/06/06,8,0,4,0,12
12518,2022/06/06,12,0,2,0,14
12523,2022/06/06,11,0,1,0,12
16062,2022/06/06,6,0,0,0,6
16063,2022/06/06,9,6,0,0,9
19322,2022/06/06,7,0,1,0,8
19329,2022/06/06,13,6,0,0,13
19516,2022/06/06,40,16,12,0,52
19520,2022/06/06,5,0,1,0,6
75,2022/06/07,61,40,30,14,91
76,2022/06/07,58,36,44,2,102
99,2022/06/07,5,0,0,0,5
117,2022/06/07,9,4,3,0,12
118,2022/06/07,5,4,2,0,7
119,2022/06/07,6,4,5,0,11
120,2022/06/07,4,4,3,0,7
149,2022/06/07,6,0,1,0,7
184,2022/06/07,17,12,5,0,22
195,2022/06/07,44,33,31,0,75
218,2022/06/07,31,24,26,2,57
296,2022/06/07,9,6,8,0,17
300,2022/06/07,9,8,5,0,14
304,2022/06/07,5,0,1,0,6
317,2022/06/07,44,16,4,0,48
343,2022/06/07,8,0,4,0,12
353,2022/06/07,9,0,1,0,10
373,2022/06/07,18,8,7,0,25
374,2022/06/07,6,0,1,0,7
388,2022/06/07,3,18,17,1,20
419,2022/06/07,35,16,11,0,46
420,2022/06/07,20,8,4,0,24
462,2022/06/07,-2,0,2,0,0
519,2022/06/07,22,6,3,0,25
525,2022/06/07,10,5,0,0,10
596,2022/06/07,10,4,2,0,12
597,2022/06/07,22,18,11,0,33
598,2022/06/07,6,0,1,0,7
1035,2022/06/07,12,6,2,0,14
1084,2022/06/07,13,10,5,0,18
1111,2022/06/07,11,0,1,0,12
1113,2022/06/07,8,0,0,0,8
1114,2022/06/07,11,6,0,0,11
1115,2022/06/07,12,6,2,0,14
1117,2022/06/07,8,0,0,0,8
1118,2022/06/07,12,0,2,0,14
1119,2022/06/07,4,0,0,0,4
1692,2022/06/07,12,0,1,0,13
1693,2022/06/07,23,0,0,0,23
1747,2022/06/07,24,15,14,0,38
1772,2022/06/07,5,0,0,0,5
1773,2022/06/07,11,6,2,0,13
1774,2022/06/07,10,0,5,0,15
1782,2022/06/07,14,18,15,0,29
1795,2022/06/07,9,0,7,0,16
1915,2022/06/07,10,0,1,0,11
1923,2022/06/07,8,0,2,0,10
1934,2022/06/07,3,0,1,0,4
1963,2022/06/07,39,16,7,0,46
1984,2022/06/07,9,0,2,1,11
2135,2022/06/07,10,0,1,0,11
2136,2022/06/07,5,0,1,0,6
2148,2022/06/07,14,4,1,0,15
2183,2022/06/07,6,0,1,0,7
2193,2022/06/07,18,15,16,1,34
2237,2022/06/07,8,6,2,0,10
2358,2022/06/07,11,8,9,0,20
2361,2022/06/07,18,7,4,1,22
2445,2022/06/07,16,6,2,0,18
2449,2022/06/07,21,8,7,0,28
2451,2022/06/07,5,0,5,0,10
2475,2022/06/07,10,0,1,0,11
2476,2022/06/07,6,0,3,0,9
2507,2022/06/07,18,12,7,0,25
2525,2022/06/07,6,0,2,0,8
2562,2022/06/07,17,8,8,0,25
2582,2022/06/07,12,4,2,0,14
2586,2022/06/07,21,16,15,0,36
2631,2022/06/07,22,0,6,3,28
2685,2022/06/07,8,8,3,0,11
2723,2022/06/07,8,0,0,0,8
2730,2022/06/07,3,0,1,0,4
2731,2022/06/07,10,0,3,0,13
2732,2022/06/07,10,0,0,0,10
2734,2022/06/07,9,4,1,0,10
2735,2022/06/07,9,8,1,0,10
2761,2022/06/07,23,20,12,0,35
2788,2022/06/07,21,20,11,0,32
2812,2022/06/07,8,0,0,0,8
2813,2022/06/07,11,0,1,0,12
2814,2022/06/07,8,0,0,0,8
2913,2022/06/07,9,0,1,0,10
2914,2022/06/07,7,0,0,0,7
3015,2022/06/07,10,0,1,0,11
3033,2022/06/07,6,0,0,0,6
3035,2022/06/07,9,0,2,0,11
4446,2022/06/07,13,12,12,0,25
12136,2022/06/07,31,24,21,2,52
12516,2022/06/07,8,4,3,0,11
12518,2022/06/07,20,10,2,0,22
12523,2022/06/07,10,0,1,0,11
16062,2022/06/07,6,0,0,0,6
16063,2022/06/07,9,0,0,0,9
19322,2022/06/07,6,0,0,0,6
19329,2022/06/07,13,0,1,0,14
19516,2022/06/07,36,8,6,0,42
19520,2022/06/07,12,8,0,0,12
75,2022/06/08,49,32,38,5,87
76,2022/06/08,49,36,30,1,79
99,2022/06/08,5,0,0,0,5
117,2022/06/08,6,0,2,0,8
118,2022/06/08,7,4,1,0,8
119,2022/06/08,1,0,0,0,1
120,2022/06/08,1,0,1,0,2
149,2022/06/08,5,0,0,0,5
184,2022/06/08,24,12,8,0,32
195,2022/06/08,46,33,28,5,74
218,2022/06/08,24,21,16,7,40
296,2022/06/08,7,6,4,0,11
300,2022/06/08,12,8,3,0,15
304,2022/06/08,10,6,1,1,11
317,2022/06/08,48,8,12,0,60
343,2022/06/08,4,0,1,0,5
353,2022/06/08,8,0,0,0,8
373,2022/06/08,19,8,8,0,27
374,2022/06/08,9,4,3,0,12
388,2022/06/08,9,24,17,1,26
419,2022/06/08,40,16,13,0,53
420,2022/06/08,16,0,5,0,21
462,2022/06/08,4,8,4,0,8
519,2022/06/08,25,6,7,0,32
525,2022/06/08,10,0,0,0,10
596,2022/06/08,12,4,2,0,14
597,2022/06/08,16,6,9,0,25
598,2022/06/08,5,0,2,0,7
1035,2022/06/08,16,6,3,0,19
1084,2022/06/08,13,5,4,0,17
1111,2022/06/08,10,0,4,0,14
1113,2022/06/08,8,0,0,0,8
1114,2022/06/08,11,0,3,0,14
1115,2022/06/08,10,0,2,0,12
1117,2022/06/08,8,0,1,0,9
1118,2022/06/08,10,0,0,0,10
1119,2022/06/08,10,6,0,0,10
1692,2022/06/08,19,8,9,0,28
1693,2022/06/08,23,0,0,0,23
1747,2022/06/08,30,20,21,0,51
1772,2022/06/08,5,0,3,0,8
1773,2022/06/08,9,0,0,0,9
1774,2022/06/08,5,0,0,0,5
1782,2022/06/08,16,18,14,0,30
1795,2022/06/08,9,7,8,0,17
1914,2022/06/08,11,0,1,0,12
1915,2022/06/08,9,0,2,0,11
1923,2022/06/08,6,0,0,0,6
1934,2022/06/08,2,0,2,0,4
1963,2022/06/08,32,0,10,0,42
1984,2022/06/08,12,6,2,0,14
2135,2022/06/08,9,0,0,0,9
2136,2022/06/08,4,0,2,0,6
2148,2022/06/08,13,0,4,0,17
2183,2022/06/08,11,6,3,0,14
2193,2022/06/08,16,15,14,0,30
2237,2022/06/08,6,0,2,0,8
2358,2022/06/08,2,0,4,0,6
2361,2022/06/08,20,7,7,0,27
2445,2022/06/08,20,6,5,0,25
2449,2022/06/08,22,8,6,0,28
2451,2022/06/08,0,0,5,0,5
2475,2022/06/08,9,0,0,0,9
2476,2022/06/08,3,0,0,0,3
2507,2022/06/08,17,6,12,0,29
2525,2022/06/08,10,6,1,0,11
2562,2022/06/08,17,8,8,0,25
2582,2022/06/08,10,0,1,0,11
2586,2022/06/08,18,12,9,0,27
2631,2022/06/08,13,0,3,0,16
2685,2022/06/08,13,8,4,0,17
2723,2022/06/08,8,0,0,0,8
2730,2022/06/08,8,6,0,0,8
2731,2022/06/08,7,0,1,0,8
2732,2022/06/08,10,0,0,0,10
2734,2022/06/08,12,4,1,0,13
2735,2022/06/08,8,0,1,0,9
2761,2022/06/08,26,15,12,0,38
2788,2022/06/08,22,12,11,7,33
2812,2022/06/08,8,0,1,0,9
2813,2022/06/08,10,0,0,0,10
2814,2022/06/08,8,0,1,0,9
2913,2022/06/08,8,0,0,0,8
2914,2022/06/08,7,0,0,0,7
3015,2022/06/08,9,0,2,0,11
3033,2022/06/08,6,0,0,0,6
3035,2022/06/08,7,0,0,0,7
4446,2022/06/08,13,12,11,0,24
12136,2022/06/08,29,21,19,0,48
12516,2022/06/08,5,0,2,0,7
12518,2022/06/08,18,0,0,0,18
12523,2022/06/08,13,4,4,0,17
16062,2022/06/08,6,0,0,0,6
16063,2022/06/08,9,0,3,0,12
19322,2022/06/08,6,0,1,0,7
19329,2022/06/08,12,0,1,0,13
19516,2022/06/08,30,0,10,0,40
19520,2022/06/08,12,0,1,0,13
75,2022/06/09,46,40,29,2,75
76,2022/06/09,61,44,34,1,95
99,2022/06/09,5,0,0,0,5
117,2022/06/09,4,0,1,0,5
118,2022/06/09,6,0,2,0,8
119,2022/06/09,1,0,0,0,1
120,2022/06/09,0,0,0,0,0
149,2022/06/09,5,0,1,0,6
184,2022/06/09,28,12,8,2,36
195,2022/06/09,40,27,26,1,66
218,2022/06/09,13,12,14,0,27
296,2022/06/09,9,6,2,0,11
300,2022/06/09,9,0,3,0,12
304,2022/06/09,14,6,5,0,19
317,2022/06/09,44,8,7,0,51
343,2022/06/09,3,0,2,0,5
353,2022/06/09,8,0,0,0,8
373,2022/06/09,19,8,4,0,23
374,2022/06/09,10,4,3,0,13
388,2022/06/09,15,24,19,4,34
419,2022/06/09,35,8,10,0,45
420,2022/06/09,19,8,5,0,24
462,2022/06/09,8,8,8,0,16
519,2022/06/09,24,6,8,0,32
525,2022/06/09,10,0,5,0,15
596,2022/06/09,10,0,3,0,13
597,2022/06/09,19,12,15,0,34
598,2022/06/09,9,6,1,0,10
1035,2022/06/09,13,0,2,5,15
1084,2022/06/09,19,10,5,0,24
1111,2022/06/09,6,0,2,0,8
1113,2022/06/09,8,0,1,0,9
1114,2022/06/09,8,0,2,0,10
1115,2022/06/09,8,0,0,0,8
1117,2022/06/09,7,0,1,0,8
1118,2022/06/09,10,0,1,0,11
1119,2022/06/09,10,0,2,0,12
1692,2022/06/09,10,0,6,0,16
1693,2022/06/09,23,0,1,0,24
1747,2022/06/09,24,15,20,0,44
1772,2022/06/09,2,0,0,0,2
1773,2022/06/09,9,0,1,0,10
1774,2022/06/09,5,0,0,0,5
1782,2022/06/09,26,24,24,2,50
1795,2022/06/09,22,21,11,0,33
1914,2022/06/09,10,0,0,0,10
1915,2022/06/09,7,0,0,0,7
1923,2022/06/09,6,0,1,0,7
1934,2022/06/09,0,0,0,0,0
1963,2022/06/09,38,16,9,0,47
1984,2022/06/09,10,0,4,2,14
2135,2022/06/09,9,0,0,0,9
2136,2022/06/09,2,0,1,0,3
2148,2022/06/09,14,4,3,0,17
2183,2022/06/09,8,0,2,12,10
2193,2022/06/09,11,9,12,0,23
2237,2022/06/09,10,6,1,0,11
2358,2022/06/09,6,8,1,0,7
2361,2022/06/09,13,0,4,0,17
2445,2022/06/09,15,0,3,5,18
2449,2022/06/09,16,0,6,0,22
2451,2022/06/09,5,10,6,0,11
2475,2022/06/09,9,0,0,0,9
2476,2022/06/09,3,0,0,0,3
2507,2022/06/09,17,12,14,0,31
2525,2022/06/09,9,0,0,0,9
2562,2022/06/09,17,8,5,0,22
2582,2022/06/09,9,0,0,0,9
2586,2022/06/09,29,20,13,0,42
2631,2022/06/09,10,0,3,6,13
2685,2022/06/09,13,4,5,0,18
2723,2022/06/09,8,0,0,0,8
2730,2022/06/09,8,0,2,0,10
2731,2022/06/09,6,0,0,0,6
2732,2022/06/09,10,0,0,0,10
2734,2022/06/09,11,0,4,0,15
2735,2022/06/09,7,0,3,0,10
2761,2022/06/09,29,15,13,0,42
2788,2022/06/09,20,16,17,4,37
2812,2022/06/09,7,0,2,0,9
2813,2022/06/09,10,0,1,0,11
2814,2022/06/09,13,6,0,0,13
2913,2022/06/09,8,0,1,1,9
2914,2022/06/09,7,0,0,0,7
3033,2022/06/09,6,0,0,0,6
3035,2022/06/09,7,0,1,0,8
4446,2022/06/09,11,9,8,0,19
12136,2022/06/09,31,21,21,3,52
12516,2022/06/09,3,0,1,0,4
12518,2022/06/09,18,0,2,0,20
12523,2022/06/09,10,0,0,0,10
16062,2022/06/09,6,0,0,0,6
16063,2022/06/09,6,0,0,0,6
19329,2022/06/09,11,0,0,0,11
19516,2022/06/09,28,8,6,0,34
19520,2022/06/09,11,0,1,0,12
75,2022/06/10,31,16,27,0,58
76,2022/06/10,54,28,37,0,91
99,2022/06/10,5,0,1,0,6
117,2022/06/10,7,4,1,0,8
118,2022/06/10,8,4,1,0,9
119,2022/06/10,5,4,0,0,5
120,2022/06/10,4,4,0,0,4
149,2022/06/10,10,6,1,0,11
184,2022/06/10,30,12,16,2,46
195,2022/06/10,37,24,28,1,65
218,2022/06/10,23,24,24,1,47
296,2022/06/10,7,0,4,0,11
300,2022/06/10,14,8,7,0,21
304,2022/06/10,9,0,2,0,11
317,2022/06/10,45,8,5,0,50
343,2022/06/10,5,4,3,0,8
353,2022/06/10,8,0,3,0,11
373,2022/06/10,15,0,5,0,20
374,2022/06/10,11,4,6,0,17
388,2022/06/10,16,24,37,0,53
419,2022/06/10,25,0,6,0,31
420,2022/06/10,22,8,4,0,26
462,2022/06/10,8,8,4,0,12
519,2022/06/10,22,6,6,0,28
525,2022/06/10,10,5,3,0,13
596,2022/06/10,15,8,4,0,19
597,2022/06/10,22,18,6,0,28
598,2022/06/10,8,0,2,0,10
1035,2022/06/10,12,6,14,0,26
1084,2022/06/10,34,20,3,0,37
1111,2022/06/10,4,0,1,0,5
1112,2022/06/10,7,0,3,0,10
1113,2022/06/10,7,0,0,0,7
1114,2022/06/10,6,0,1,0,7
1115,2022/06/10,8,0,4,0,12
1117,2022/06/10,6,0,2,0,8
1118,2022/06/10,15,6,2,0,17
1119,2022/06/10,8,0,0,0,8
1692,2022/06/10,12,8,5,0,17
1693,2022/06/10,22,0,0,0,22
1747,2022/06/10,24,20,20,0,44
1772,2022/06/10,2,0,0,0,2
1773,2022/06/10,8,0,1,0,9
1774,2022/06/10,13,8,0,0,13
1782,2022/06/10,24,24,27,1,51
1795,2022/06/10,25,14,14,0,39
1914,2022/06/10,10,0,0,0,10
1915,2022/06/10,7,0,0,0,7
1923,2022/06/10,11,6,0,0,11
1934,2022/06/10,6,6,3,0,9
1963,2022/06/10,45,16,7,0,52
1984,2022/06/10,4,0,4,0,8
2135,2022/06/10,9,0,5,0,14
2136,2022/06/10,7,6,0,0,7
2148,2022/06/10,10,0,2,0,12
2183,2022/06/10,0,6,5,0,5
2193,2022/06/10,17,18,16,0,33
2237,2022/06/10,9,0,3,0,12
2358,2022/06/10,5,0,1,0,6
2361,2022/06/10,9,0,3,0,12
2445,2022/06/10,13,6,10,0,23
2449,2022/06/10,18,8,4,0,22
2451,2022/06/10,4,5,5,0,9
2475,2022/06/10,9,0,1,0,10
2476,2022/06/10,9,6,0,0,9
2507,2022/06/10,9,6,9,0,18
2525,2022/06/10,9,0,1,0,10
2562,2022/06/10,28,16,0,2,28
2582,2022/06/10,9,0,1,0,10
2586,2022/06/10,32,16,11,4,43
2631,2022/06/10,1,0,2,0,3
2685,2022/06/10,16,8,11,5,27
2723,2022/06/10,8,0,1,0,9
2730,2022/06/10,12,6,1,0,13
2731,2022/06/10,12,6,2,0,14
2732,2022/06/10,10,0,0,0,10
2734,2022/06/10,7,0,2,0,9
2735,2022/06/10,12,8,1,0,13
2761,2022/06/10,36,20,16,0,52
2788,2022/06/10,19,20,22,0,41
2812,2022/06/10,5,0,1,0,6
2813,2022/06/10,9,0,1,0,10
2814,2022/06/10,13,0,1,0,14
2913,2022/06/10,6,0,1,3,7
2914,2022/06/10,7,0,0,0,7
3033,2022/06/10,6,0,1,0,7
3035,2022/06/10,6,0,1,0,7
4446,2022/06/10,12,9,7,0,19
12136,2022/06/10,34,27,25,1,59
12516,2022/06/10,6,4,1,0,7
12518,2022/06/10,16,0,2,0,18
12523,2022/06/10,9,0,2,0,11
16062,2022/06/10,6,0,0,0,6
16063,2022/06/10,6,0,2,0,8
19329,2022/06/10,11,0,1,0,12
19516,2022/06/10,22,0,4,0,26
19520,2022/06/10,10,0,0,0,10
75,2022/06/11,30,24,23,0,53
76,2022/06/11,47,28,29,0,76
99,2022/06/11,4,0,0,0,4
117,2022/06/11,6,0,0,0,6
118,2022/06/11,7,0,3,0,10
119,2022/06/11,5,0,1,0,6
120,2022/06/11,8,4,2,0,10
149,2022/06/11,9,0,0,0,9
184,2022/06/11,18,6,16,2,34
195,2022/06/11,34,24,24,0,58
218,2022/06/11,26,24,18,2,44
296,2022/06/11,9,6,2,0,11
300,2022/06/11,7,0,5,0,12
304,2022/06/11,13,6,4,0,17
317,2022/06/11,40,0,7,0,47
343,2022/06/11,2,0,2,0,4
353,2022/06/11,5,0,0,0,5
373,2022/06/11,18,8,6,0,24
374,2022/06/11,5,0,2,0,7
388,2022/06/11,-3,18,17,0,14
419,2022/06/11,19,0,10,0,29
420,2022/06/11,26,8,3,0,29
462,2022/06/11,12,8,6,0,18
519,2022/06/11,22,6,5,0,27
525,2022/06/11,7,0,5,0,12
596,2022/06/11,11,0,3,0,14
597,2022/06/11,16,0,16,0,32
598,2022/06/11,12,6,4,0,16
1035,2022/06/11,4,6,3,0,7
1084,2022/06/11,31,0,8,1,39
1111,2022/06/11,3,0,2,0,5
1112,2022/06/11,4,0,0,0,4
1113,2022/06/11,7,0,1,0,8
1114,2022/06/11,5,0,0,0,5
1115,2022/06/11,4,0,5,0,9
1117,2022/06/11,4,0,1,0,5
1118,2022/06/11,13,0,2,0,15
1119,2022/06/11,8,0,2,0,10
1692,2022/06/11,7,0,3,0,10
1693,2022/06/11,22,0,0,0,22
1747,2022/06/11,29,25,16,0,45
1772,2022/06/11,2,0,0,0,2
1773,2022/06/11,7,0,1,0,8
1774,2022/06/11,13,0,1,0,14
1782,2022/06/11,11,15,17,2,28
1795,2022/06/11,39,28,15,0,54
1914,2022/06/11,10,0,3,0,13
1915,2022/06/11,7,0,2,0,9
1923,2022/06/11,11,0,3,0,14
1934,2022/06/11,9,6,7,0,16
1963,2022/06/11,54,16,3,0,57
1984,2022/06/11,6,6,2,0,8
2135,2022/06/11,4,0,3,0,7
2136,2022/06/11,7,0,0,0,7
2148,2022/06/11,8,0,1,0,9
2183,2022/06/11,1,6,5,0,6
2193,2022/06/11,10,9,8,0,18
2237,2022/06/11,6,0,1,0,7
2358,2022/06/11,12,8,3,0,15
2361,2022/06/11,13,7,7,0,20
2445,2022/06/11,9,6,4,0,13
2449,2022/06/11,22,8,6,0,28
2451,2022/06/11,4,5,4,0,8
2476,2022/06/11,9,0,0,0,9
2507,2022/06/11,12,12,9,0,21
2525,2022/06/11,8,0,4,0,12
2562,2022/06/11,34,8,6,0,40
2582,2022/06/11,8,0,1,0,9
2586,2022/06/11,29,12,11,0,40
2631,2022/06/11,5,6,1,0,6
2685,2022/06/11,4,4,5,0,9
2723,2022/06/11,7,0,0,0,7
2730,2022/06/11,11,0,4,0,15
2731,2022/06/11,10,0,2,0,12
2732,2022/06/11,10,0,0,0,10
2734,2022/06/11,5,0,1,0,6
2735,2022/06/11,11,0,2,0,13
2761,2022/06/11,35,15,12,0,47
2788,2022/06/11,16,16,15,2,31
2812,2022/06/11,4,0,3,0,7
2813,2022/06/11,8,0,2,0,10
2814,2022/06/11,12,0,4,0,16
2913,2022/06/11,8,6,0,0,8
2914,2022/06/11,7,0,0,0,7
3033,2022/06/11,5,0,0,0,5
3035,2022/06/11,5,0,0,0,5
4446,2022/06/11,17,12,9,0,26
12136,2022/06/11,32,21,15,8,47
12516,2022/06/11,5,0,0,0,5
12518,2022/06/11,14,0,1,0,15
12523,2022/06/11,7,0,4,0,11
16062,2022/06/11,6,0,0,0,6
16063,2022/06/11,4,0,2,0,6
19329,2022/06/11,10,0,3,0,13
19516,2022/06/11,18,0,7,0,25
19520,2022/06/11,10,0,0,0,10
75,2022/06/12,33,28,24,0,57
76,2022/06/12,40,24,24,0,64
99,2022/06/12,4,0,0,0,4
117,2022/06/12,10,4,2,0,12
118,2022/06/12,8,4,2,0,10
119,2022/06/12,8,4,2,0,10
120,2022/06/12,6,0,0,0,6
149,2022/06/12,9,0,0,0,9
184,2022/06/12,3,3,1,1,4
195,2022/06/12,29,21,21,0,50
218,2022/06/12,20,18,15,3,35
296,2022/06/12,13,6,8,0,21
300,2022/06/12,2,0,3,0,5
304,2022/06/12,9,0,3,0,12
317,2022/06/12,49,16,14,5,63
343,2022/06/12,4,4,1,0,5
353,2022/06/12,5,0,0,0,5
373,2022/06/12,20,8,6,0,26
374,2022/06/12,15,12,3,0,18
388,2022/06/12,-8,12,14,0,6
419,2022/06/12,17,8,11,0,28
420,2022/06/12,23,0,18,1,41
462,2022/06/12,14,8,9,0,23
519,2022/06/12,23,6,3,0,26
525,2022/06/12,2,0,1,0,3
596,2022/06/12,12,4,1,0,13
597,2022/06/12,12,12,6,0,18
598,2022/06/12,8,0,1,0,9
1035,2022/06/12,1,0,1,0,2
1084,2022/06/12,32,10,8,0,40
1111,2022/06/12,1,0,0,0,1
1112,2022/06/12,4,0,0,0,4
1113,2022/06/12,6,0,1,0,7
1114,2022/06/12,5,0,0,0,5
1115,2022/06/12,-1,0,3,0,2
1117,2022/06/12,3,0,1,0,4
1118,2022/06/12,11,0,1,0,12
1119,2022/06/12,6,0,2,0,8
1692,2022/06/12,12,8,5,0,17
1693,2022/06/12,22,0,0,0,22
1747,2022/06/12,23,10,13,0,36
1772,2022/06/12,2,0,0,0,2
1773,2022/06/12,6,0,0,0,6
1774,2022/06/12,12,0,2,0,14
1782,2022/06/12,1,9,12,3,13
1795,2022/06/12,24,0,12,0,36
1914,2022/06/12,7,0,2,0,9
1915,2022/06/12,5,0,0,0,5
1923,2022/06/12,8,0,2,0,10
1934,2022/06/12,2,0,1,0,3
1963,2022/06/12,59,8,24,0,83
1984,2022/06/12,4,0,0,0,4
2135,2022/06/12,1,0,0,0,1
2136,2022/06/12,7,0,0,0,7
2148,2022/06/12,15,8,5,0,20
2183,2022/06/12,2,6,3,0,5
2193,2022/06/12,17,15,11,0,28
2237,2022/06/12,5,0,2,0,7
2358,2022/06/12,17,8,7,0,24
2361,2022/06/12,13,7,5,0,18
2445,2022/06/12,11,6,2,0,13
2449,2022/06/12,24,8,8,1,32
2451,2022/06/12,15,15,3,0,18
2476,2022/06/12,9,0,0,0,9
2507,2022/06/12,9,6,10,0,19
2525,2022/06/12,4,0,2,0,6
2562,2022/06/12,36,8,3,1,39
2582,2022/06/12,11,4,1,0,12
2586,2022/06/12,18,0,11,6,29
2631,2022/06/12,10,6,6,0,16
2685,2022/06/12,-1,0,0,0,-1
2723,2022/06/12,7,0,0,0,7
2730,2022/06/12,7,0,3,0,10
2731,2022/06/12,8,0,2,0,10
2732,2022/06/12,10,0,1,0,11
2734,2022/06/12,8,4,3,0,11
2735,2022/06/12,9,0,1,0,10
2761,2022/06/12,23,0,9,5,32
2788,2022/06/12,8,12,7,0,15
2812,2022/06/12,7,6,0,0,7
2813,2022/06/12,6,0,0,0,6
2814,2022/06/12,8,0,1,0,9
2913,2022/06/12,8,0,2,0,10
2914,2022/06/12,7,0,1,0,8
3015,2022/06/12,7,0,0,0,7
3033,2022/06/12,5,0,0,0,5
3035,2022/06/12,5,0,0,0,5
4446,2022/06/12,20,12,6,5,26
12136,2022/06/12,21,15,9,3,30
12516,2022/06/12,13,8,3,0,16
12518,2022/06/12,13,0,8,0,21
12523,2022/06/12,7,4,4,0,11
16062,2022/06/12,6,0,1,0,7
16063,2022/06/12,2,0,1,0,3
19322,2022/06/12,5,0,0,0,5
19516,2022/06/12,11,0,9,0,20
19520,2022/06/12,10,0,2,0,12
75,2022/06/13,41,32,36,2,77
76,2022/06/13,53,36,31,0,84
99,2022/06/13,4,0,0,0,4
117,2022/06/13,8,0,0,0,8
118,2022/06/13,6,0,2,3,8
119,2022/06/13,6,0,2,0,8
120,2022/06/13,10,4,1,0,11
149,2022/06/13,9,0,0,0,9
184,2022/06/13,7,6,3,0,10
195,2022/06/13,35,27,20,0,55
218,2022/06/13,27,24,12,3,39
296,2022/06/13,11,6,6,0,17
300,2022/06/13,7,8,2,0,9
304,2022/06/13,6,0,2,0,8
317,2022/06/13,38,8,37,0,75
343,2022/06/13,3,0,3,0,6
353,2022/06/13,11,6,0,0,11
373,2022/06/13,22,8,22,0,44
374,2022/06/13,12,0,6,0,18
388,2022/06/13,-4,18,14,0,10
419,2022/06/13,22,16,22,0,44
420,2022/06/13,4,0,0,0,4
462,2022/06/13,13,8,10,0,23
519,2022/06/13,26,6,1,0,27
525,2022/06/13,6,5,2,0,8
596,2022/06/13,15,4,4,0,19
597,2022/06/13,18,12,9,0,27
598,2022/06/13,7,0,1,0,8
1035,2022/06/13,6,6,2,0,8
1084,2022/06/13,24,0,1,1,25
1111,2022/06/13,7,6,1,0,8
1112,2022/06/13,10,6,0,0,10
1113,2022/06/13,5,0,0,0,5
1114,2022/06/13,11,6,0,0,11
1115,2022/06/13,2,6,0,0,2
1117,2022/06/13,10,8,1,0,11
1118,2022/06/13,10,0,0,0,10
1692,2022/06/13,15,8,12,0,27
1693,2022/06/13,22,0,0,0,22
1747,2022/06/13,25,15,10,0,35
1772,2022/06/13,10,8,0,0,10
1773,2022/06/13,6,0,0,0,6
1774,2022/06/13,10,0,2,0,12
1782,2022/06/13,10,24,13,0,23
1795,2022/06/13,26,14,7,0,33
1914,2022/06/13,5,0,0,0,5
1915,2022/06/13,5,0,0,0,5
1923,2022/06/13,6,0,0,0,6
1934,2022/06/13,7,6,1,0,8
1963,2022/06/13,43,8,35,0,78
1984,2022/06/13,10,6,0,0,10
2135,2022/06/13,7,6,0,0,7
2136,2022/06/13,7,0,0,0,7
2148,2022/06/13,10,0,0,0,10
2183,2022/06/13,5,6,0,0,5
2193,2022/06/13,24,18,7,3,31
2237,2022/06/13,9,6,2,0,11
2358,2022/06/13,10,0,11,0,21
2361,2022/06/13,8,0,2,0,10
2445,2022/06/13,15,6,8,0,23
2449,2022/06/13,23,8,20,0,43
2451,2022/06/13,12,0,10,0,22
2476,2022/06/13,9,0,0,0,9
2507,2022/06/13,11,12,4,0,15
2525,2022/06/13,2,0,0,0,2
2562,2022/06/13,40,8,24,0,64
2582,2022/06/13,10,0,2,0,12
2586,2022/06/13,13,12,8,0,21
2631,2022/06/13,4,0,4,0,8
2685,2022/06/13,3,4,5,0,8
2723,2022/06/13,7,0,0,0,7
2730,2022/06/13,4,0,0,0,4
2731,2022/06/13,6,0,0,0,6
2732,2022/06/13,9,0,0,0,9
2734,2022/06/13,5,0,1,0,6
2735,2022/06/13,16,8,2,0,18
2761,2022/06/13,19,10,12,0,31
2788,2022/06/13,17,16,9,0,26
2812,2022/06/13,7,0,1,0,8
2813,2022/06/13,6,0,0,0,6
2814,2022/06/13,7,0,0,0,7
2913,2022/06/13,6,0,1,0,7
2914,2022/06/13,6,0,0,0,6
3015,2022/06/13,7,0,0,0,7
3033,2022/06/13,5,0,0,0,5
3035,2022/06/13,11,6,2,0,13
4446,2022/06/13,21,12,10,1,31
12136,2022/06/13,30,21,15,3,45
12516,2022/06/13,10,0,5,0,15
12518,2022/06/13,5,0,6,1,11
12523,2022/06/13,3,0,2,0,5
16062,2022/06/13,5,0,1,0,6
16063,2022/06/13,7,6,0,0,7
19322,2022/06/13,5,0,0,0,5
19516,2022/06/13,19,16,15,0,34
19520,2022/06/13,8,0,0,0,8
75,2022/06/14,35,32,29,0,64
76,2022/06/14,65,44,37,0,102
99,2022/06/14,4,0,1,0,5
117,2022/06/14,8,0,5,0,13
118,2022/06/14,1,0,4,0,5
119,2022/06/14,4,0,2,0,6
120,2022/06/14,9,0,0,0,9
149,2022/06/14,9,0,0,0,9
184,2022/06/14,13,9,9,0,22
195,2022/06/14,45,30,32,3,77
218,2022/06/14,35,24,17,7,52
296,2022/06/14,5,0,4,0,9
300,2022/06/14,13,8,4,0,17
304,2022/06/14,10,6,5,0,15
317,2022/06/14,10,16,17,0,27
343,2022/06/14,4,4,2,0,6
353,2022/06/14,11,0,2,0,13
373,2022/06/14,8,8,9,0,17
374,2022/06/14,6,0,5,0,11
388,2022/06/14,0,18,19,0,19
419,2022/06/14,8,8,8,0,16
420,2022/06/14,12,8,8,0,20
462,2022/06/14,3,0,7,0,10
519,2022/06/14,25,0,6,0,31
525,2022/06/14,4,0,1,0,5
596,2022/06/14,11,0,2,0,13
597,2022/06/14,15,6,10,0,25
598,2022/06/14,6,0,0,0,6
1035,2022/06/14,10,6,4,0,14
1084,2022/06/14,22,0,1,11,23
1111,2022/06/14,6,0,0,0,6
1112,2022/06/14,10,0,0,0,10
1113,2022/06/14,5,0,1,0,6
1114,2022/06/14,11,0,2,0,13
1115,2022/06/14,8,6,0,0,8
1117,2022/06/14,9,0,0,0,9
1118,2022/06/14,10,0,2,0,12
1119,2022/06/14,10,6,0,0,10
1692,2022/06/14,19,16,0,0,19
1693,2022/06/14,8,8,8,0,16
1747,2022/06/14,36,20,15,3,51
1772,2022/06/14,10,0,1,0,11
1773,2022/06/14,6,0,0,0,6
1774,2022/06/14,8,0,0,0,8
1782,2022/06/14,21,24,10,3,31
1795,2022/06/14,26,7,8,0,34
1914,2022/06/14,11,6,0,0,11
1915,2022/06/14,11,6,1,0,12
1923,2022/06/14,6,0,0,0,6
1934,2022/06/14,6,0,1,0,7
1963,2022/06/14,6,8,9,0,15
1984,2022/06/14,10,0,1,0,11
2135,2022/06/14,7,0,0,0,7
2136,2022/06/14,7,0,1,0,8
2148,2022/06/14,10,0,3,0,13
2183,2022/06/14,11,6,3,0,14
2193,2022/06/14,14,0,11,0,25
2237,2022/06/14,7,0,0,0,7
2358,2022/06/14,7,8,5,0,12
2361,2022/06/14,13,7,4,0,17
2445,2022/06/14,7,0,2,0,9
2449,2022/06/14,11,8,7,0,18
2451,2022/06/14,2,0,6,0,8
2476,2022/06/14,9,0,0,0,9
2507,2022/06/14,19,12,13,0,32
2525,2022/06/14,8,6,1,0,9
2562,2022/06/14,28,8,24,0,52
2582,2022/06/14,8,0,3,0,11
2586,2022/06/14,21,16,9,0,30
2631,2022/06/14,6,6,3,0,9
2685,2022/06/14,6,8,7,0,13
2723,2022/06/14,7,0,1,0,8
2730,2022/06/14,10,6,1,0,11
2731,2022/06/14,6,0,0,0,6
2732,2022/06/14,9,0,0,0,9
2734,2022/06/14,4,0,1,0,5
2735,2022/06/14,14,0,5,0,19
2761,2022/06/14,17,10,14,0,31
2788,2022/06/14,24,16,11,9,35
2812,2022/06/14,12,6,2,0,14
2813,2022/06/14,12,6,1,0,13
2814,2022/06/14,13,6,1,0,14
2913,2022/06/14,5,0,1,0,6
2914,2022/06/14,6,0,0,0,6
3015,2022/06/14,7,0,0,0,7
3033,2022/06/14,5,0,1,0,6
3035,2022/06/14,9,0,1,0,10
4446,2022/06/14,22,12,12,3,34
12136,2022/06/14,27,15,11,7,38
12516,2022/06/14,5,0,2,0,7
12518,2022/06/14,-2,0,1,0,-1
12523,2022/06/14,1,0,0,0,1
16062,2022/06/14,4,0,0,0,4
16063,2022/06/14,7,0,2,0,9
19322,2022/06/14,5,0,0,0,5
19516,2022/06/14,11,8,8,0,19
19520,2022/06/14,8,0,0,0,8
75,2022/06/15,46,40,34,0,80
76,2022/06/15,68,40,41,5,109
99,2022/06/15,3,0,0,0,3
117,2022/06/15,3,0,2,1,5
118,2022/06/15,1,4,3,0,4
119,2022/06/15,6,4,4,0,10
120,2022/06/15,9,0,1,5,10
149,2022/06/15,9,0,0,0,9
184,2022/06/15,16,12,13,0,29
195,2022/06/15,40,30,33,0,73
218,2022/06/15,35,24,26,4,61
296,2022/06/15,7,6,4,0,11
300,2022/06/15,9,0,1,0,10
304,2022/06/15,5,0,1,0,6
317,2022/06/15,9,16,15,0,24
343,2022/06/15,2,0,1,0,3
353,2022/06/15,9,0,0,0,9
373,2022/06/15,15,16,15,0,30
374,2022/06/15,5,4,2,0,7
388,2022/06/15,-1,18,16,0,15
419,2022/06/15,16,16,16,0,32
420,2022/06/15,4,0,0,0,4
462,2022/06/15,4,8,8,0,12
519,2022/06/15,19,0,7,0,26
525,2022/06/15,8,5,0,0,8
596,2022/06/15,9,0,1,0,10
597,2022/06/15,17,12,11,0,28
598,2022/06/15,12,6,1,0,13
1035,2022/06/15,12,6,8,0,20
1084,2022/06/15,10,0,7,0,17
1111,2022/06/15,12,6,1,0,13
1112,2022/06/15,10,0,0,0,10
1113,2022/06/15,10,6,1,0,11
1114,2022/06/15,9,0,3,0,12
1115,2022/06/15,8,0,1,0,9
1117,2022/06/15,9,0,0,0,9
1118,2022/06/15,8,0,1,0,9
1119,2022/06/15,10,0,0,0,10
1692,2022/06/15,27,8,8,0,35
1693,2022/06/15,0,0,0,0,0
1747,2022/06/15,27,10,16,0,43
1772,2022/06/15,9,0,0,0,9
1773,2022/06/15,6,0,1,0,7
1774,2022/06/15,8,0,3,0,11
1782,2022/06/15,23,15,16,4,39
1795,2022/06/15,32,14,10,0,42
1914,2022/06/15,11,0,0,0,11
1915,2022/06/15,10,0,0,0,10
1923,2022/06/15,12,6,1,0,13
1934,2022/06/15,5,0,1,0,6
1963,2022/06/15,13,16,16,0,29
1984,2022/06/15,15,6,2,1,17
2135,2022/06/15,7,0,4,0,11
2136,2022/06/15,6,0,0,0,6
2148,2022/06/15,7,0,2,0,9
2183,2022/06/15,8,0,9,0,17
2193,2022/06/15,15,12,8,1,23
2237,2022/06/15,7,0,1,0,8
2358,2022/06/15,2,0,4,0,6
2361,2022/06/15,16,7,3,0,19
2445,2022/06/15,11,6,2,0,13
2449,2022/06/15,4,0,0,0,4
2451,2022/06/15,-4,0,3,0,-1
2476,2022/06/15,9,0,1,0,10
2507,2022/06/15,18,12,7,0,25
2525,2022/06/15,7,0,2,0,9
2562,2022/06/15,12,8,13,0,25
2582,2022/06/15,5,0,0,0,5
2586,2022/06/15,24,12,8,0,32
2631,2022/06/15,3,0,2,0,5
2685,2022/06/15,3,4,1,0,4
2730,2022/06/15,9,0,2,0,11
2731,2022/06/15,12,6,2,0,14
2732,2022/06/15,9,0,0,0,9
2734,2022/06/15,3,0,2,0,5
2735,2022/06/15,9,0,3,0,12
2761,2022/06/15,13,10,9,0,22
2788,2022/06/15,20,16,13,3,33
2812,2022/06/15,10,0,2,0,12
2813,2022/06/15,11,0,2,0,13
2814,2022/06/15,12,0,6,0,18
2913,2022/06/15,4,0,2,0,6
2914,2022/06/15,6,0,0,0,6
3015,2022/06/15,7,0,0,0,7
3033,2022/06/15,4,0,0,0,4
3035,2022/06/15,8,0,1,0,9
4446,2022/06/15,13,6,8,1,21
12136,2022/06/15,33,24,20,5,53
12516,2022/06/15,3,0,2,0,5
12518,2022/06/15,-3,0,0,0,-3
12523,2022/06/15,5,4,3,0,8
16062,2022/06/15,4,0,0,0,4
16063,2022/06/15,5,0,1,0,6
19322,2022/06/15,5,0,0,0,5
19516,2022/06/15,11,8,8,0,19
19520,2022/06/15,8,0,1,0,9
75,2022/06/16,44,32,19,3,63
76,2022/06/16,54,32,19,1,73
99,2022/06/16,3,0,0,0,3
117,2022/06/16,4,4,1,0,5
118,2022/06/16,-2,0,1,0,-1
119,2022/06/16,2,0,0,0,2
120,2022/06/16,3,0,3,0,6
149,2022/06/16,9,0,1,0,10
184,2022/06/16,12,9,4,0,16
195,2022/06/16,34,27,24,0,58
218,2022/06/16,26,21,16,3,42
296,2022/06/16,9,6,6,0,15
300,2022/06/16,16,8,2,0,18
304,2022/06/16,10,6,2,0,12
317,2022/06/16,10,16,16,0,26
343,2022/06/16,5,4,1,0,6
353,2022/06/16,9,0,1,0,10
373,2022/06/16,8,8,4,0,12
374,2022/06/16,7,4,0,0,7
388,2022/06/16,4,21,17,5,21
419,2022/06/16,8,8,8,0,16
420,2022/06/16,12,8,8,0,20
462,2022/06/16,4,8,4,0,8
519,2022/06/16,18,6,8,0,26
525,2022/06/16,8,0,0,0,8
596,2022/06/16,12,4,3,0,15
597,2022/06/16,18,12,5,0,23
598,2022/06/16,11,0,0,0,11
1035,2022/06/16,10,6,5,0,15
1084,2022/06/16,8,5,7,0,15
1111,2022/06/16,11,0,1,0,12
1112,2022/06/16,10,0,1,0,11
1113,2022/06/16,9,0,0,0,9
1114,2022/06/16,6,0,0,0,6
1115,2022/06/16,7,0,3,0,10
1117,2022/06/16,9,0,1,0,10
1118,2022/06/16,7,0,0,0,7
1119,2022/06/16,10,0,0,0,10
1692,2022/06/16,27,8,6,0,33
1693,2022/06/16,8,8,3,0,11
1747,2022/06/16,26,15,11,1,37
1772,2022/06/16,9,0,1,0,10
1773,2022/06/16,5,0,0,0,5
1774,2022/06/16,5,0,2,0,7
1782,2022/06/16,27,24,6,14,33
1795,2022/06/16,29,7,5,3,34
1914,2022/06/16,11,0,0,0,11
1915,2022/06/16,10,0,0,0,10
1923,2022/06/16,11,0,0,0,11
1934,2022/06/16,4,0,1,0,5
1963,2022/06/16,5,8,10,0,15
1984,2022/06/16,12,0,3,0,15
2135,2022/06/16,3,0,1,0,4
2136,2022/06/16,6,0,0,0,6
2148,2022/06/16,9,4,3,0,12
2183,2022/06/16,5,6,5,0,10
2193,2022/06/16,24,18,14,4,38
2237,2022/06/16,6,0,1,0,7
2358,2022/06/16,6,8,4,0,10
2361,2022/06/16,20,7,5,0,25
2445,2022/06/16,15,6,2,0,17
2449,2022/06/16,12,8,8,0,20
2451,2022/06/16,3,10,1,0,4
2476,2022/06/16,8,0,1,0,9
2507,2022/06/16,23,12,16,0,39
2525,2022/06/16,5,0,2,0,7
2562,2022/06/16,-1,0,3,0,2
2582,2022/06/16,5,0,0,0,5
2586,2022/06/16,32,16,10,5,42
2631,2022/06/16,7,6,2,0,9
2685,2022/06/16,6,4,3,0,9
2730,2022/06/16,7,0,1,0,8
2731,2022/06/16,10,0,2,0,12
2732,2022/06/16,9,0,2,0,11
2734,2022/06/16,5,4,3,0,8
2735,2022/06/16,6,0,0,0,6
2761,2022/06/16,19,15,15,0,34
2788,2022/06/16,20,16,9,6,29
2812,2022/06/16,8,0,2,0,10
2813,2022/06/16,9,0,3,0,12
2814,2022/06/16,6,0,3,0,9
2913,2022/06/16,8,6,4,0,12
2914,2022/06/16,6,0,0,0,6
3033,2022/06/16,4,0,0,0,4
3035,2022/06/16,7,0,1,0,8
4446,2022/06/16,13,9,4,1,17
12136,2022/06/16,29,21,13,6,42
12516,2022/06/16,5,4,2,0,7
12518,2022/06/16,7,10,4,0,11
12523,2022/06/16,6,4,3,0,9
16062,2022/06/16,10,6,2,0,12
16063,2022/06/16,4,0,2,0,6
19516,2022/06/16,11,8,6,0,17
19520,2022/06/16,7,0,0,0,7
75,2022/06/17,50,28,40,0,90
76,2022/06/17,62,28,29,4,91
99,2022/06/17,3,0,0,0,3
117,2022/06/17,3,0,1,0,4
118,2022/06/17,4,4,1,0,5
119,2022/06/17,1,0,0,0,1
120,2022/06/17,0,0,0,0,0
149,2022/06/17,8,0,0,0,8
184,2022/06/17,20,12,10,0,30
195,2022/06/17,10,24,1,0,11
218,2022/06/17,25,18,17,6,42
296,2022/06/17,9,6,1,0,10
300,2022/06/17,14,0,4,0,18
304,2022/06/17,8,0,0,0,8
317,2022/06/17,10,16,7,0,17
343,2022/06/17,8,4,2,0,10
353,2022/06/17,8,0,1,0,9
373,2022/06/17,4,0,4,0,8
374,2022/06/17,7,0,4,0,11
388,2022/06/17,9,27,17,0,26
419,2022/06/17,8,8,8,0,16
420,2022/06/17,12,8,3,0,15
462,2022/06/17,8,8,4,0,12
519,2022/06/17,10,0,0,0,10
525,2022/06/17,13,5,3,0,16
596,2022/06/17,21,12,3,0,24
597,2022/06/17,31,18,12,0,43
598,2022/06/17,11,0,1,0,12
1035,2022/06/17,11,6,5,0,16
1084,2022/06/17,16,15,6,0,22
1111,2022/06/17,10,0,0,0,10
1112,2022/06/17,9,0,0,0,9
1113,2022/06/17,9,0,2,0,11
1114,2022/06/17,6,0,0,0,6
1115,2022/06/17,4,0,3,0,7
1117,2022/06/17,8,0,0,0,8
1118,2022/06/17,7,0,0,0,7
1119,2022/06/17,10,0,0,0,10
1692,2022/06/17,29,8,6,0,35
1693,2022/06/17,13,8,11,0,24
1747,2022/06/17,24,10,17,1,41
1772,2022/06/17,8,0,1,0,9
1773,2022/06/17,5,0,2,0,7
1774,2022/06/17,3,0,0,0,3
1782,2022/06/17,28,21,16,3,44
1795,2022/06/17,42,21,17,1,59
1914,2022/06/17,11,0,1,0,12
1915,2022/06/17,10,0,2,0,12
1923,2022/06/17,11,0,1,0,12
1934,2022/06/17,3,0,2,1,5
1963,2022/06/17,11,16,11,0,22
1984,2022/06/17,9,0,1,2,10
2135,2022/06/17,2,0,1,0,3
2136,2022/06/17,6,0,2,0,8
2148,2022/06/17,6,0,2,0,8
2183,2022/06/17,6,6,8,0,14
2193,2022/06/17,22,18,12,1,34
2237,2022/06/17,11,6,0,0,11
2358,2022/06/17,10,8,2,0,12
2361,2022/06/17,15,0,3,0,18
2445,2022/06/17,19,6,10,0,29
2449,2022/06/17,20,16,11,0,31
2451,2022/06/17,7,5,6,0,13
2476,2022/06/17,7,0,1,0,8
2507,2022/06/17,6,0,2,0,8
2525,2022/06/17,3,0,3,0,6
2562,2022/06/17,12,16,4,0,16
2582,2022/06/17,9,4,2,0,11
2586,2022/06/17,29,12,10,1,39
2631,2022/06/17,11,6,9,0,20
2685,2022/06/17,11,8,4,0,15
2730,2022/06/17,6,0,4,0,10
2731,2022/06/17,8,0,3,0,11
2732,2022/06/17,7,0,1,0,8
2734,2022/06/17,6,4,2,0,8
2735,2022/06/17,6,0,4,0,10
2761,2022/06/17,19,15,12,0,31
2788,2022/06/17,17,12,9,5,26
2812,2022/06/17,6,0,2,0,8
2813,2022/06/17,6,0,0,0,6
2814,2022/06/17,3,0,0,0,3
2913,2022/06/17,4,0,1,0,5
2914,2022/06/17,6,0,1,0,7
3033,2022/06/17,4,0,0,0,4
3035,2022/06/17,6,0,2,0,8
4446,2022/06/17,17,9,8,0,25
12136,2022/06/17,34,24,11,9,45
12516,2022/06/17,7,4,1,0,8
12518,2022/06/17,3,0,3,0,6
12523,2022/06/17,7,4,2,0,9
16062,2022/06/17,8,0,2,0,10
16063,2022/06/17,2,0,1,0,3
19516,2022/06/17,13,8,4,0,17
19520,2022/06/17,7,0,0,0,7
75,2022/06/18,34,24,18,0,52
76,2022/06/18,57,28,20,10,77
99,2022/06/18,3,0,0,0,3
117,2022/06/18,6,4,1,0,7
118,2022/06/18,7,4,3,0,10
119,2022/06/18,5,4,1,0,6
120,2022/06/18,0,0,0,0,0
149,2022/06/18,8,0,2,0,10
184,2022/06/18,22,12,11,1,33
195,2022/06/18,36,27,26,0,62
218,2022/06/18,20,18,18,1,38
296,2022/06/18,8,0,2,0,10
300,2022/06/18,10,0,4,0,14
304,2022/06/18,14,6,2,0,16
317,2022/06/18,19,16,8,0,27
343,2022/06/18,6,0,1,0,7
353,2022/06/18,7,0,0,0,7
373,2022/06/18,16,16,6,0,22
374,2022/06/18,7,4,1,0,8
388,2022/06/18,7,15,17,12,24
419,2022/06/18,16,16,11,0,27
420,2022/06/18,17,8,7,0,24
462,2022/06/18,12,8,4,0,16
519,2022/06/18,16,6,6,0,22
525,2022/06/18,10,0,6,0,16
596,2022/06/18,18,0,3,0,21
597,2022/06/18,19,0,9,0,28
598,2022/06/18,10,0,0,1,10
1035,2022/06/18,12,6,8,0,20
1084,2022/06/18,10,0,5,0,15
1111,2022/06/18,10,0,3,0,13
1112,2022/06/18,9,0,0,0,9
1113,2022/06/18,7,0,0,0,7
1114,2022/06/18,6,0,0,0,6
1115,2022/06/18,7,6,2,0,9
1117,2022/06/18,8,0,2,0,10
1118,2022/06/18,13,6,2,0,15
1119,2022/06/18,10,0,0,0,10
1692,2022/06/18,23,0,4,0,27
1693,2022/06/18,2,0,2,0,4
1747,2022/06/18,21,15,19,0,40
1772,2022/06/18,7,0,0,0,7
1773,2022/06/18,9,6,1,0,10
1774,2022/06/18,11,8,1,0,12
1782,2022/06/18,24,15,18,16,42
1795,2022/06/18,45,21,11,1,56
1914,2022/06/18,10,0,0,0,10
1915,2022/06/18,8,0,0,0,8
1923,2022/06/18,10,0,1,0,11
1934,2022/06/18,6,6,1,0,7
1963,2022/06/18,16,16,14,0,30
1984,2022/06/18,6,0,5,0,11
2135,2022/06/18,7,6,4,0,11
2136,2022/06/18,4,0,2,0,6
2148,2022/06/18,8,4,1,0,9
2183,2022/06/18,-2,0,3,0,1
2193,2022/06/18,21,12,8,7,29
2237,2022/06/18,17,6,2,0,19
2358,2022/06/18,8,0,3,0,11
2361,2022/06/18,19,7,0,0,19
2445,2022/06/18,9,0,4,0,13
2449,2022/06/18,17,8,9,0,26
2451,2022/06/18,6,5,5,0,11
2507,2022/06/18,16,12,9,0,25
2525,2022/06/18,6,6,0,0,6
2562,2022/06/18,24,16,7,0,31
2582,2022/06/18,7,0,2,0,9
2586,2022/06/18,18,0,8,2,26
2631,2022/06/18,2,0,3,0,5
2685,2022/06/18,11,4,3,1,14
2730,2022/06/18,8,6,4,0,12
2731,2022/06/18,5,0,0,0,5
2732,2022/06/18,6,0,0,0,6
2734,2022/06/18,8,4,4,0,12
2735,2022/06/18,10,8,0,2,10
2761,2022/06/18,22,15,6,0,28
2788,2022/06/18,19,16,14,8,33
2812,2022/06/18,4,0,2,0,6
2813,2022/06/18,6,0,0,0,6
2814,2022/06/18,9,6,2,0,11
2913,2022/06/18,3,0,0,0,3
2914,2022/06/18,5,0,0,0,5
3033,2022/06/18,4,0,0,0,4
3035,2022/06/18,4,0,2,0,6
4446,2022/06/18,21,12,6,5,27
12136,2022/06/18,32,18,18,9,50
12516,2022/06/18,6,0,1,0,7
12518,2022/06/18,10,10,1,0,11
12523,2022/06/18,9,4,1,0,10
16062,2022/06/18,6,0,1,0,7
16063,2022/06/18,1,0,0,0,1
19516,2022/06/18,25,16,9,0,34
19520,2022/06/18,7,0,0,0,7
75,2022/06/19,40,24,11,6,51
76,2022/06/19,55,28,18,9,73
99,2022/06/19,3,0,1,0,4
117,2022/06/19,5,0,1,0,6
118,2022/06/19,4,0,4,0,8
119,2022/06/19,8,4,3,0,11
120,2022/06/19,4,4,2,0,6
149,2022/06/19,6,0,1,0,7
184,2022/06/19,22,12,4,0,26
195,2022/06/19,34,24,18,0,52
218,2022/06/19,19,18,10,1,29
296,2022/06/19,12,6,3,0,15
300,2022/06/19,14,8,1,0,15
304,2022/06/19,18,6,3,0,21
317,2022/06/19,27,16,20,0,47
343,2022/06/19,9,4,2,0,11
353,2022/06/19,7,0,0,0,7
373,2022/06/19,18,8,11,1,29
374,2022/06/19,14,8,2,0,16
388,2022/06/19,-7,15,6,0,-1
419,2022/06/19,21,16,15,0,36
420,2022/06/19,26,16,11,0,37
462,2022/06/19,16,8,5,0,21
519,2022/06/19,16,6,4,0,20
525,2022/06/19,4,0,0,0,4
596,2022/06/19,15,0,3,0,18
597,2022/06/19,22,12,8,0,30
598,2022/06/19,9,0,1,0,10
1035,2022/06/19,10,6,1,0,11
1084,2022/06/19,15,10,2,0,17
1111,2022/06/19,7,0,0,0,7
1112,2022/06/19,9,0,0,0,9
1113,2022/06/19,7,0,2,0,9
1114,2022/06/19,12,6,4,0,16
1115,2022/06/19,11,6,1,0,12
1118,2022/06/19,11,0,2,0,13
1119,2022/06/19,10,0,0,0,10
1692,2022/06/19,27,8,3,0,30
1693,2022/06/19,8,8,3,0,11
1747,2022/06/19,22,20,9,0,31
1772,2022/06/19,7,0,0,0,7
1773,2022/06/19,8,0,1,0,9
1774,2022/06/19,10,0,0,0,10
1782,2022/06/19,8,18,7,0,15
1795,2022/06/19,33,0,7,0,40
1914,2022/06/19,10,0,0,0,10
1915,2022/06/19,8,0,0,0,8
1923,2022/06/19,9,0,2,0,11
1934,2022/06/19,5,0,2,0,7
1963,2022/06/19,18,16,18,0,36
1984,2022/06/19,7,6,1,0,8
2135,2022/06/19,3,0,1,0,4
2136,2022/06/19,2,0,0,0,2
2148,2022/06/19,15,8,3,0,18
2183,2022/06/19,1,6,3,0,4
2193,2022/06/19,18,12,10,3,28
2237,2022/06/19,15,0,4,0,19
2358,2022/06/19,21,16,4,0,25
2361,2022/06/19,19,0,2,0,21
2445,2022/06/19,11,6,3,0,14
2449,2022/06/19,24,16,11,0,35
2451,2022/06/19,21,20,2,1,23
2476,2022/06/19,6,0,0,0,6
2507,2022/06/19,19,12,3,0,22
2525,2022/06/19,6,0,0,0,6
2562,2022/06/19,33,16,9,0,42
2582,2022/06/19,5,0,0,0,5
2586,2022/06/19,16,8,8,4,24
2631,2022/06/19,5,6,2,0,7
2685,2022/06/19,11,4,2,0,13
2730,2022/06/19,4,0,2,0,6
2731,2022/06/19,5,0,0,0,5
2732,2022/06/19,6,0,0,0,6
2734,2022/06/19,4,0,2,0,6
2735,2022/06/19,8,0,0,0,8
2761,2022/06/19,31,15,7,0,38
2788,2022/06/19,5,8,2,1,7
2812,2022/06/19,8,6,2,0,10
2813,2022/06/19,12,6,2,0,14
2814,2022/06/19,7,0,3,0,10
2913,2022/06/19,3,0,1,0,4
2914,2022/06/19,5,0,0,0,5
3015,2022/06/19,7,0,2,0,9
3033,2022/06/19,4,0,1,0,5
3035,2022/06/19,2,0,1,0,3
4446,2022/06/19,19,9,7,0,26
12136,2022/06/19,23,18,6,4,29
12516,2022/06/19,13,8,3,0,16
12518,2022/06/19,19,10,1,0,20
12523,2022/06/19,16,8,3,0,19
16062,2022/06/19,5,0,1,0,6
16063,2022/06/19,7,6,2,0,9
19322,2022/06/19,5,0,1,0,6
19516,2022/06/19,24,8,10,0,34
19520,2022/06/19,7,0,0,0,7
75,2022/06/20,51,28,35,6,86
76,2022/06/20,48,20,31,0,79
99,2022/06/20,14,12,0,0,14
117,2022/06/20,8,4,2,0,10
118,2022/06/20,4,4,3,0,7
119,2022/06/20,5,0,2,0,7
120,2022/06/20,2,0,2,0,4
149,2022/06/20,5,0,0,0,5
184,2022/06/20,24,6,6,4,30
195,2022/06/20,43,27,20,5,63
218,2022/06/20,29,21,17,7,46
296,2022/06/20,15,6,4,0,19
300,2022/06/20,13,0,2,0,15
304,2022/06/20,15,0,3,0,18
317,2022/06/20,31,24,16,0,47
343,2022/06/20,7,0,2,0,9
353,2022/06/20,7,0,0,0,7
373,2022/06/20,22,16,14,0,36
374,2022/06/20,12,0,4,0,16
388,2022/06/20,2,15,23,0,25
419,2022/06/20,22,16,17,0,39
420,2022/06/20,31,16,7,0,38
462,2022/06/20,19,8,5,1,24
519,2022/06/20,24,12,6,0,30
525,2022/06/20,4,0,0,0,4
596,2022/06/20,12,0,3,0,15
597,2022/06/20,20,6,5,6,25
598,2022/06/20,8,0,2,0,10
1035,2022/06/20,15,6,3,0,18
1084,2022/06/20,18,5,7,0,25
1111,2022/06/20,7,0,0,0,7
1112,2022/06/20,9,0,1,0,10
1113,2022/06/20,5,0,0,0,5
1114,2022/06/20,8,0,0,0,8
1115,2022/06/20,10,0,2,0,12
1118,2022/06/20,9,0,0,0,9
1692,2022/06/20,32,8,9,0,41
1693,2022/06/20,5,0,2,0,7
1747,2022/06/20,28,15,10,0,38
1772,2022/06/20,7,0,1,0,8
1773,2022/06/20,7,0,0,0,7
1774,2022/06/20,10,0,0,0,10
1782,2022/06/20,19,18,16,3,35
1795,2022/06/20,26,0,8,0,34
1914,2022/06/20,10,0,1,0,11
1915,2022/06/20,8,0,0,0,8
1923,2022/06/20,7,0,0,0,7
1934,2022/06/20,9,6,0,0,9
1963,2022/06/20,16,16,16,0,32
1984,2022/06/20,6,0,0,0,6
2135,2022/06/20,8,6,0,0,8
2136,2022/06/20,8,6,0,0,8
2148,2022/06/20,12,0,1,0,13
2183,2022/06/20,4,6,1,0,5
2193,2022/06/20,14,9,7,5,21
2237,2022/06/20,11,0,1,0,12
2358,2022/06/20,17,0,6,0,23
2361,2022/06/20,17,0,7,0,24
2445,2022/06/20,14,6,3,0,17
2449,2022/06/20,29,16,10,0,39
2451,2022/06/20,18,0,13,0,31
2476,2022/06/20,6,0,0,0,6
2507,2022/06/20,22,6,9,0,31
2525,2022/06/20,12,6,0,0,12
2562,2022/06/20,40,16,10,0,50
2582,2022/06/20,5,0,0,0,5
2586,2022/06/20,16,12,14,7,30
2631,2022/06/20,9,6,3,0,12
2685,2022/06/20,13,4,5,4,18
2730,2022/06/20,8,6,0,0,8
2731,2022/06/20,11,6,0,0,11
2732,2022/06/20,6,0,0,0,6
2734,2022/06/20,2,0,0,0,2
2735,2022/06/20,8,0,1,0,9
2761,2022/06/20,39,15,14,0,53
2788,2022/06/20,14,12,13,2,27
2812,2022/06/20,6,0,0,0,6
2813,2022/06/20,10,0,1,0,11
2814,2022/06/20,4,0,0,0,4
2913,2022/06/20,8,6,1,0,9
2914,2022/06/20,5,0,0,0,5
3015,2022/06/20,5,0,1,0,6
3035,2022/06/20,7,6,1,0,8
4446,2022/06/20,18,6,7,1,25
12136,2022/06/20,31,18,13,10,44
12516,2022/06/20,10,0,0,0,10
12518,2022/06/20,18,0,2,0,20
12523,2022/06/20,13,0,2,0,15
16062,2022/06/20,10,6,0,0,10
16063,2022/06/20,5,0,0,0,5
19322,2022/06/20,4,0,0,0,4
19516,2022/06/20,30,16,11,0,41
19520,2022/06/20,7,0,1,0,8
75,2022/06/21,40,32,26,0,66
76,2022/06/21,35,36,35,0,70
99,2022/06/21,14,0,1,0,15
117,2022/06/21,6,0,1,0,7
118,2022/06/21,5,4,2,0,7
119,2022/06/21,3,0,2,0,5
120,2022/06/21,4,4,1,0,5
149,2022/06/21,5,0,0,0,5
184,2022/06/21,24,9,6,4,30
195,2022/06/21,34,27,27,0,61
218,2022/06/21,23,18,14,6,37
296,2022/06/21,17,6,4,0,21
300,2022/06/21,11,0,2,0,13
304,2022/06/21,12,0,2,0,14
317,2022/06/21,31,16,15,0,46
343,2022/06/21,5,0,1,0,6
353,2022/06/21,7,0,1,0,8
373,2022/06/21,24,16,13,0,37
374,2022/06/21,12,4,2,0,14
388,2022/06/21,10,18,18,0,28
419,2022/06/21,21,16,16,0,37
420,2022/06/21,32,8,8,0,40
462,2022/06/21,13,0,9,0,22
519,2022/06/21,18,0,3,0,21
525,2022/06/21,9,5,1,0,10
596,2022/06/21,1,0,2,0,3
597,2022/06/21,19,12,15,0,34
598,2022/06/21,6,0,2,0,8
1035,2022/06/21,18,6,6,0,24
1084,2022/06/21,13,5,6,0,19
1111,2022/06/21,7,0,1,0,8
1112,2022/06/21,8,0,0,0,8
1113,2022/06/21,5,0,2,0,7
1114,2022/06/21,8,0,2,0,10
1115,2022/06/21,8,0,1,0,9
1118,2022/06/21,9,0,1,0,10
1119,2022/06/21,10,0,1,0,11
1692,2022/06/21,23,0,4,0,27
1693,2022/06/21,11,8,8,0,19
1747,2022/06/21,29,15,13,0,42
1772,2022/06/21,6,0,0,0,6
1773,2022/06/21,7,0,1,0,8
1774,2022/06/21,10,0,3,0,13
1782,2022/06/21,27,12,20,2,47
1795,2022/06/21,22,7,13,0,35
1914,2022/06/21,9,0,0,0,9
1915,2022/06/21,8,0,0,0,8
1923,2022/06/21,7,0,1,0,8
1934,2022/06/21,9,0,3,0,12
1963,2022/06/21,16,16,18,0,34
1984,2022/06/21,6,0,0,0,6
2135,2022/06/21,8,0,0,0,8
2136,2022/06/21,8,0,2,0,10
2148,2022/06/21,15,4,1,0,16
2183,2022/06/21,9,6,2,0,11
2193,2022/06/21,14,12,12,0,26
2237,2022/06/21,10,0,1,0,11
2358,2022/06/21,19,8,4,0,23
2361,2022/06/21,17,7,2,0,19
2445,2022/06/21,17,6,3,0,20
2449,2022/06/21,27,8,10,1,37
2451,2022/06/21,12,0,9,0,21
2476,2022/06/21,6,0,0,0,6
2507,2022/06/21,25,12,8,2,33
2525,2022/06/21,12,0,1,0,13
2562,2022/06/21,38,8,15,0,53
2582,2022/06/21,9,4,2,0,11
2586,2022/06/21,16,16,9,0,25
2631,2022/06/21,12,6,3,0,15
2685,2022/06/21,15,8,2,1,17
2730,2022/06/21,8,0,1,0,9
2731,2022/06/21,11,0,0,0,11
2732,2022/06/21,6,0,1,0,7
2734,2022/06/21,6,4,0,0,6
2735,2022/06/21,15,8,2,1,17
2761,2022/06/21,72,50,6,0,78
2788,2022/06/21,15,12,9,4,24
2812,2022/06/21,6,0,0,0,6
2813,2022/06/21,9,0,0,0,9
2814,2022/06/21,4,0,0,0,4
2913,2022/06/21,7,0,1,0,8
2914,2022/06/21,5,0,0,0,5
3015,2022/06/21,4,0,0,0,4
3033,2022/06/21,3,0,0,0,3
3035,2022/06/21,6,0,1,0,7
4446,2022/06/21,19,9,8,1,27
12136,2022/06/21,17,12,10,2,27
12516,2022/06/21,14,4,2,0,16
12518,2022/06/21,16,0,3,0,19
12523,2022/06/21,11,0,2,0,13
16062,2022/06/21,10,0,1,0,11
16063,2022/06/21,5,0,0,0,5
19322,2022/06/21,4,0,1,0,5
19516,2022/06/21,27,8,13,0,40
19520,2022/06/21,6,0,2,0,8
75,2022/06/22,46,32,40,1,86
76,2022/06/22,36,36,37,0,73
99,2022/06/22,13,0,0,0,13
117,2022/06/22,5,0,0,0,5
118,2022/06/22,3,0,1,0,4
119,2022/06/22,5,4,2,0,7
120,2022/06/22,3,0,2,0,5
149,2022/06/22,11,6,2,0,13
184,2022/06/22,14,0,5,4,19
195,2022/06/22,37,30,34,2,71
218,2022/06/22,27,24,29,0,56
296,2022/06/22,19,6,5,0,24
300,2022/06/22,17,8,5,0,22
304,2022/06/22,10,0,4,0,14
317,2022/06/22,24,8,12,0,36
343,2022/06/22,4,0,2,0,6
373,2022/06/22,27,16,9,0,36
374,2022/06/22,10,0,2,0,12
388,2022/06/22,7,15,18,0,25
419,2022/06/22,21,16,14,0,35
420,2022/06/22,24,0,11,0,35
462,2022/06/22,12,8,5,0,17
519,2022/06/22,5,0,3,0,8
525,2022/06/22,5,0,0,0,5
596,2022/06/22,3,4,2,0,5
597,2022/06/22,16,12,11,0,27
598,2022/06/22,4,0,2,0,6
1035,2022/06/22,20,6,4,1,24
1084,2022/06/22,12,5,5,0,17
1111,2022/06/22,6,0,1,0,7
1112,2022/06/22,8,0,1,0,9
1113,2022/06/22,9,6,1,0,10
1114,2022/06/22,12,6,3,0,15
1115,2022/06/22,7,0,1,0,8
1118,2022/06/22,8,0,1,0,9
1119,2022/06/22,9,0,0,0,9
1692,2022/06/22,19,0,0,0,19
1693,2022/06/22,3,0,1,0,4
1747,2022/06/22,31,15,23,4,54
1772,2022/06/22,6,0,0,0,6
1773,2022/06/22,6,0,0,0,6
1774,2022/06/22,7,0,0,0,7
1782,2022/06/22,23,18,18,0,41
1795,2022/06/22,23,14,9,7,32
1914,2022/06/22,9,0,0,0,9
1915,2022/06/22,8,0,1,0,9
1934,2022/06/22,6,0,1,0,7
1963,2022/06/22,14,16,13,0,27
1984,2022/06/22,12,6,2,0,14
2135,2022/06/22,8,0,1,0,9
2136,2022/06/22,6,0,1,0,7
2148,2022/06/22,14,0,5,0,19
2183,2022/06/22,20,6,5,0,25
2193,2022/06/22,14,12,11,0,25
2237,2022/06/22,9,0,3,0,12
2358,2022/06/22,15,0,8,0,23
2361,2022/06/22,15,0,10,0,25
2445,2022/06/22,8,0,3,0,11
2449,2022/06/22,16,0,8,0,24
2451,2022/06/22,3,0,3,0,6
2476,2022/06/22,6,0,0,0,6
2507,2022/06/22,21,6,13,0,34
2525,2022/06/22,11,0,1,0,12
2562,2022/06/22,31,8,3,0,34
2582,2022/06/22,11,4,1,0,12
2586,2022/06/22,19,12,7,0,26
2631,2022/06/22,9,0,1,0,10
2685,2022/06/22,12,0,5,0,17
2730,2022/06/22,7,0,1,0,8
2731,2022/06/22,11,0,3,0,14
2732,2022/06/22,5,0,0,0,5
2734,2022/06/22,6,0,1,0,7
2735,2022/06/22,12,0,2,0,14
2761,2022/06/22,66,0,12,7,78
2788,2022/06/22,18,16,20,1,38
2812,2022/06/22,12,6,2,0,14
2813,2022/06/22,9,0,1,0,10
2814,2022/06/22,10,6,0,0,10
2913,2022/06/22,4,0,1,0,5
2914,2022/06/22,5,0,0,0,5
3015,2022/06/22,4,0,0,0,4
3033,2022/06/22,3,0,0,0,3
3035,2022/06/22,5,0,0,0,5
4446,2022/06/22,19,9,11,1,30
12136,2022/06/22,29,24,22,3,51
12516,2022/06/22,12,0,0,0,12
12518,2022/06/22,23,10,4,0,27
12523,2022/06/22,9,0,2,0,11
16062,2022/06/22,9,0,0,0,9
16063,2022/06/22,11,6,1,0,12
19322,2022/06/22,9,6,0,0,9
19516,2022/06/22,22,8,10,0,32
19520,2022/06/22,4,0,2,0,6
75,2022/06/23,37,32,31,0,68
76,2022/06/23,35,36,37,0,72
99,2022/06/23,13,0,0,0,13
117,2022/06/23,9,4,4,0,13
118,2022/06/23,6,4,2,0,8
119,2022/06/23,3,0,1,0,4
120,2022/06/23,5,4,1,0,6
149,2022/06/23,9,0,1,0,10
184,2022/06/23,8,3,6,0,14
195,2022/06/23,22,21,24,0,46
218,2022/06/23,10,12,14,0,24
296,2022/06/23,14,0,7,0,21
300,2022/06/23,14,0,3,0,17
304,2022/06/23,2,0,2,0,4
317,2022/06/23,20,8,25,0,45
343,2022/06/23,6,4,2,0,8
373,2022/06/23,18,0,20,0,38
374,2022/06/23,8,0,4,0,12
388,2022/06/23,10,21,19,0,29
419,2022/06/23,15,8,17,0,32
420,2022/06/23,13,0,9,0,22
462,2022/06/23,19,8,7,0,26
519,2022/06/23,8,6,5,0,13
525,2022/06/23,5,0,1,0,6
596,2022/06/23,1,0,1,0,2
597,2022/06/23,5,0,7,0,12
598,2022/06/23,3,0,2,0,5
1035,2022/06/23,15,0,7,0,22
1084,2022/06/23,7,0,6,0,13
1111,2022/06/23,5,0,1,0,6
1112,2022/06/23,7,0,0,0,7
1113,2022/06/23,8,0,0,0,8
1114,2022/06/23,9,0,2,0,11
1115,2022/06/23,6,0,2,0,8
1117,2022/06/23,6,0,0,0,6
1119,2022/06/23,9,0,0,0,9
1692,2022/06/23,19,0,0,0,19
1693,2022/06/23,10,8,8,0,18
1747,2022/06/23,14,10,17,0,31
1772,2022/06/23,6,0,0,0,6
1773,2022/06/23,6,0,0,0,6
1774,2022/06/23,7,0,1,0,8
1782,2022/06/23,17,12,17,0,34
1795,2022/06/23,7,0,7,0,14
1914,2022/06/23,9,0,0,0,9
1915,2022/06/23,7,0,0,0,7
1934,2022/06/23,11,6,5,0,16
1963,2022/06/23,17,16,19,0,36
1984,2022/06/23,10,0,3,1,13
2135,2022/06/23,7,0,2,0,9
2136,2022/06/23,5,0,2,0,7
2148,2022/06/23,9,0,1,0,10
2183,2022/06/23,21,6,6,3,27
2193,2022/06/23,21,18,20,0,41
2237,2022/06/23,6,0,4,0,10
2358,2022/06/23,9,0,4,0,13
2361,2022/06/23,5,0,5,0,10
2445,2022/06/23,5,0,2,2,7
2449,2022/06/23,16,8,12,0,28
2451,2022/06/23,5,5,3,0,8
2476,2022/06/23,6,0,0,0,6
2507,2022/06/23,8,0,9,0,17
2525,2022/06/23,10,0,2,0,12
2562,2022/06/23,28,0,14,0,42
2582,2022/06/23,5,0,0,0,5
2586,2022/06/23,24,12,10,0,34
2631,2022/06/23,8,0,3,0,11
2685,2022/06/23,7,0,4,0,11
2730,2022/06/23,6,0,0,0,6
2731,2022/06/23,8,0,1,0,9
2732,2022/06/23,5,0,1,0,6
2734,2022/06/23,7,4,1,0,8
2735,2022/06/23,16,0,0,0,16
2761,2022/06/23,47,0,26,2,73
2788,2022/06/23,10,12,8,1,18
2812,2022/06/23,10,0,0,0,10
2813,2022/06/23,8,0,1,0,9
2814,2022/06/23,10,0,5,0,15
2913,2022/06/23,9,6,5,0,14
2914,2022/06/23,5,0,0,0,5
3015,2022/06/23,12,8,0,0,12
3033,2022/06/23,3,0,0,0,3
3035,2022/06/23,5,0,0,0,5
4446,2022/06/23,16,9,12,0,28
12136,2022/06/23,22,18,23,0,45
12516,2022/06/23,14,0,3,2,17
12518,2022/06/23,22,0,3,0,25
12523,2022/06/23,6,0,2,0,8
16062,2022/06/23,9,0,0,0,9
16063,2022/06/23,10,0,0,0,10
19322,2022/06/23,9,0,0,0,9
19516,2022/06/23,12,0,4,0,16
19520,2022/06/23,2,0,0,0,2
75,2022/06/24,46,40,39,0,85
76,2022/06/24,34,36,33,0,67
99,2022/06/24,13,0,1,0,14
117,2022/06/24,5,0,3,0,8
118,2022/06/24,8,4,7,0,15
119,2022/06/24,6,4,1,0,7
120,2022/06/24,4,0,0,0,4
149,2022/06/24,8,0,1,0,9
184,2022/06/24,17,15,13,2,30
195,2022/06/24,28,30,29,0,57
218,2022/06/24,17,21,16,0,33
296,2022/06/24,7,0,2,0,9
300,2022/06/24,11,0,1,0,12
304,2022/06/24,6,6,2,0,8
317,2022/06/24,3,8,7,0,10
343,2022/06/24,4,0,3,0,7
373,2022/06/24,6,8,0,0,6
374,2022/06/24,8,4,4,0,12
388,2022/06/24,15,24,17,0,32
419,2022/06/24,-2,0,0,0,-2
420,2022/06/24,4,0,0,0,4
462,2022/06/24,12,0,5,0,17
519,2022/06/24,9,6,7,1,16
525,2022/06/24,4,0,3,0,7
596,2022/06/24,12,12,3,0,15
597,2022/06/24,16,18,7,0,23
598,2022/06/24,7,6,1,0,8
1035,2022/06/24,14,6,11,0,25
1084,2022/06/24,16,15,8,0,24
1111,2022/06/24,4,0,2,0,6
1112,2022/06/24,7,0,1,0,8
1113,2022/06/24,8,0,1,0,9
1114,2022/06/24,7,0,1,0,8
1115,2022/06/24,10,6,2,0,12
1117,2022/06/24,6,0,0,0,6
1118,2022/06/24,7,0,0,0,7
1119,2022/06/24,9,0,0,0,9
1692,2022/06/24,27,8,8,0,35
1693,2022/06/24,10,8,6,0,16
1747,2022/06/24,17,20,14,0,31
1772,2022/06/24,6,0,2,0,8
1773,2022/06/24,12,6,1,0,13
1774,2022/06/24,14,8,2,0,16
1782,2022/06/24,18,18,14,0,32
1795,2022/06/24,13,14,11,0,24
1914,2022/06/24,9,0,0,0,9
1915,2022/06/24,7,0,0,0,7
1923,2022/06/24,6,0,0,0,6
1934,2022/06/24,6,0,3,1,9
1963,2022/06/24,14,16,13,0,27
1984,2022/06/24,6,0,4,0,10
2135,2022/06/24,5,0,3,0,8
2136,2022/06/24,3,0,1,0,4
2148,2022/06/24,8,0,1,0,9
2183,2022/06/24,18,6,9,0,27
2193,2022/06/24,16,15,12,1,28
2237,2022/06/24,2,0,1,0,3
2358,2022/06/24,13,8,6,0,19
2361,2022/06/24,7,7,3,0,10
2445,2022/06/24,7,6,2,2,9
2449,2022/06/24,12,8,6,0,18
2451,2022/06/24,12,10,6,0,18
2476,2022/06/24,6,0,0,0,6
2507,2022/06/24,11,12,12,0,23
2525,2022/06/24,8,0,0,0,8
2562,2022/06/24,22,8,4,0,26
2582,2022/06/24,5,0,0,0,5
2586,2022/06/24,30,16,13,6,43
2631,2022/06/24,11,6,5,0,16
2685,2022/06/24,7,4,5,0,12
2730,2022/06/24,12,6,0,0,12
2731,2022/06/24,7,0,2,0,9
2732,2022/06/24,4,0,0,0,4
2734,2022/06/24,6,0,4,0,10
2735,2022/06/24,16,0,1,0,17
2761,2022/06/24,19,0,11,0,30
2788,2022/06/24,12,12,13,0,25
2812,2022/06/24,10,0,0,0,10
2814,2022/06/24,11,6,2,0,13
2913,2022/06/24,4,0,1,0,5
2914,2022/06/24,5,0,1,0,6
3015,2022/06/24,12,0,0,0,12
3033,2022/06/24,3,0,0,0,3
3035,2022/06/24,11,6,0,0,11
4446,2022/06/24,10,6,8,0,18
12136,2022/06/24,17,18,13,1,30
12516,2022/06/24,9,0,0,0,9
12518,2022/06/24,19,0,0,0,19
12523,2022/06/24,4,0,2,0,6
16062,2022/06/24,9,0,2,0,11
16063,2022/06/24,10,0,1,0,11
19322,2022/06/24,9,0,1,0,10
19516,2022/06/24,8,0,2,0,10
19520,2022/06/24,10,8,1,0,11
75,2022/06/25,31,24,21,0,52
76,2022/06/25,25,24,25,0,50
99,2022/06/25,12,0,0,0,12
117,2022/06/25,2,0,1,0,3
118,2022/06/25,1,0,1,0,2
119,2022/06/25,5,0,2,0,7
120,2022/06/25,8,4,0,0,8
184,2022/06/25,8,6,9,0,17
195,2022/06/25,26,27,28,0,54
218,2022/06/25,19,18,19,1,38
296,2022/06/25,11,6,4,0,15
300,2022/06/25,10,0,4,0,14
304,2022/06/25,4,0,2,0,6
317,2022/06/25,12,16,5,0,17
343,2022/06/25,5,4,3,0,8
373,2022/06/25,14,8,6,0,20
374,2022/06/25,4,0,2,0,6
388,2022/06/25,13,15,21,3,34
419,2022/06/25,23,16,8,0,31
420,2022/06/25,12,8,3,0,15
462,2022/06/25,15,8,3,0,18
519,2022/06/25,13,12,12,0,25
525,2022/06/25,6,5,3,0,9
596,2022/06/25,9,0,6,0,15
597,2022/06/25,9,0,12,0,21
598,2022/06/25,6,0,2,0,8
1035,2022/06/25,9,6,8,0,17
1084,2022/06/25,8,0,5,0,13
1111,2022/06/25,2,0,2,0,4
1112,2022/06/25,6,0,0,0,6
1113,2022/06/25,7,0,1,0,8
1114,2022/06/25,6,0,0,0,6
1115,2022/06/25,8,0,3,0,11
1117,2022/06/25,6,0,0,0,6
1118,2022/06/25,7,0,0,0,7
1119,2022/06/25,9,0,1,0,10
1692,2022/06/25,19,0,0,0,19
1693,2022/06/25,12,8,6,0,18
1747,2022/06/25,18,15,18,0,36
1772,2022/06/25,4,0,0,0,4
1773,2022/06/25,11,0,2,0,13
1774,2022/06/25,12,0,2,0,14
1782,2022/06/25,22,18,12,0,34
1795,2022/06/25,24,21,14,0,38
1914,2022/06/25,9,0,0,0,9
1915,2022/06/25,7,0,1,0,8
1923,2022/06/25,6,0,0,0,6
1934,2022/06/25,2,0,1,0,3
1963,2022/06/25,17,16,17,0,34
1984,2022/06/25,8,6,5,0,13
2135,2022/06/25,2,0,0,0,2
2136,2022/06/25,2,0,1,0,3
2148,2022/06/25,7,0,1,0,8
2183,2022/06/25,9,0,5,2,14
2193,2022/06/25,12,9,10,2,22
2237,2022/06/25,1,0,1,0,2
2358,2022/06/25,7,0,7,0,14
2361,2022/06/25,4,0,3,0,7
2445,2022/06/25,9,6,9,0,18
2449,2022/06/25,14,8,10,0,24
2451,2022/06/25,11,5,1,0,12
2507,2022/06/25,11,12,11,0,22
2525,2022/06/25,8,0,1,0,9
2562,2022/06/25,26,8,4,0,30
2582,2022/06/25,5,0,2,0,7
2586,2022/06/25,19,8,10,0,29
2631,2022/06/25,12,6,5,0,17
2685,2022/06/25,6,4,4,0,10
2730,2022/06/25,12,0,2,0,14
2731,2022/06/25,5,0,3,0,8
2732,2022/06/25,4,0,1,0,5
2734,2022/06/25,2,0,2,0,4
2735,2022/06/25,15,0,1,0,16
2761,2022/06/25,8,0,8,1,16
2788,2022/06/25,15,16,13,0,28
2812,2022/06/25,10,0,2,0,12
2814,2022/06/25,9,0,4,0,13
2913,2022/06/25,3,0,2,0,5
2914,2022/06/25,4,0,1,0,5
3015,2022/06/25,12,0,2,0,14
3033,2022/06/25,3,0,0,0,3
3035,2022/06/25,11,0,1,0,12
4446,2022/06/25,11,9,8,0,19
12136,2022/06/25,21,18,19,2,40
12516,2022/06/25,9,0,5,0,14
12518,2022/06/25,19,0,1,0,20
12523,2022/06/25,6,4,0,0,6
16062,2022/06/25,7,0,2,0,9
16063,2022/06/25,9,0,2,0,11
19322,2022/06/25,8,0,0,0,8
19516,2022/06/25,6,0,0,0,6
19520,2022/06/25,9,0,1,0,10
75,2022/06/26,26,16,18,0,44
76,2022/06/26,16,16,17,0,33
99,2022/06/26,12,0,0,0,12
117,2022/06/26,1,0,0,1,1
118,2022/06/26,0,0,0,0,0
119,2022/06/26,3,0,0,0,3
120,2022/06/26,8,0,0,1,8
149,2022/06/26,7,0,0,0,7
184,2022/06/26,5,6,6,0,11
195,2022/06/26,16,18,14,0,30
218,2022/06/26,14,15,17,0,31
296,2022/06/26,7,0,6,0,13
300,2022/06/26,6,0,2,2,8
304,2022/06/26,8,6,1,0,9
317,2022/06/26,23,16,16,0,39
343,2022/06/26,2,0,2,0,4
373,2022/06/26,8,0,6,0,14
374,2022/06/26,10,8,4,0,14
388,2022/06/26,1,12,11,0,12
419,2022/06/26,31,16,15,0,46
420,2022/06/26,25,16,8,0,33
462,2022/06/26,12,0,3,1,15
519,2022/06/26,7,6,3,0,10
525,2022/06/26,3,0,3,0,6
596,2022/06/26,3,0,2,0,5
597,2022/06/26,9,12,10,0,19
598,2022/06/26,4,0,0,0,4
1035,2022/06/26,7,6,7,0,14
1084,2022/06/26,8,5,2,0,10
1111,2022/06/26,6,6,1,0,7
1112,2022/06/26,6,0,0,0,6
1113,2022/06/26,6,0,1,0,7
1114,2022/06/26,12,6,1,0,13
1115,2022/06/26,5,0,2,0,7
1118,2022/06/26,7,0,0,0,7
1119,2022/06/26,8,0,1,0,9
1692,2022/06/26,27,8,5,0,32
1693,2022/06/26,6,0,5,0,11
1747,2022/06/26,10,10,7,0,17
1772,2022/06/26,4,0,0,0,4
1773,2022/06/26,9,0,1,0,10
1774,2022/06/26,10,0,3,0,13
1782,2022/06/26,22,12,9,3,31
1795,2022/06/26,10,0,9,0,19
1914,2022/06/26,9,0,2,0,11
1915,2022/06/26,6,0,2,0,8
1923,2022/06/26,6,0,0,0,6
1934,2022/06/26,1,0,0,0,1
1963,2022/06/26,16,16,9,0,25
1984,2022/06/26,9,6,3,0,12
2135,2022/06/26,8,6,1,0,9
2136,2022/06/26,7,6,0,0,7
2148,2022/06/26,14,8,0,0,14
2183,2022/06/26,2,0,2,0,4
2193,2022/06/26,9,9,9,0,18
2237,2022/06/26,6,6,4,0,10
2358,2022/06/26,16,16,5,0,21
2361,2022/06/26,8,7,4,0,12
2445,2022/06/26,6,6,6,0,12
2449,2022/06/26,20,16,6,0,26
2451,2022/06/26,20,10,3,0,23
2476,2022/06/26,6,0,2,0,8
2507,2022/06/26,6,6,5,0,11
2525,2022/06/26,7,0,2,0,9
2562,2022/06/26,30,8,11,4,41
2582,2022/06/26,7,4,0,0,7
2586,2022/06/26,9,0,5,0,14
2631,2022/06/26,7,0,6,0,13
2685,2022/06/26,6,4,4,0,10
2730,2022/06/26,10,0,1,0,11
2731,2022/06/26,2,0,0,0,2
2732,2022/06/26,3,0,2,0,5
2734,2022/06/26,8,8,3,0,11
2735,2022/06/26,14,0,1,3,15
2761,2022/06/26,9,10,8,0,17
2788,2022/06/26,14,12,7,1,21
2812,2022/06/26,8,0,1,0,9
2814,2022/06/26,11,6,2,0,13
2913,2022/06/26,1,0,1,0,2
2914,2022/06/26,3,0,0,0,3
3015,2022/06/26,10,0,2,0,12
3033,2022/06/26,3,0,0,0,3
3035,2022/06/26,10,0,6,0,16
4446,2022/06/26,12,9,3,0,15
12136,2022/06/26,18,18,16,0,34
12516,2022/06/26,4,0,0,0,4
12518,2022/06/26,18,0,1,0,19
12523,2022/06/26,10,4,4,0,14
16062,2022/06/26,5,0,1,0,6
16063,2022/06/26,7,0,2,0,9
19322,2022/06/26,8,0,0,0,8
19516,2022/06/26,22,16,11,0,33
19520,2022/06/26,8,0,1,0,9
75,2022/06/27,40,32,33,0,73
76,2022/06/27,31,32,33,0,64
99,2022/06/27,12,0,2,0,14
117,2022/06/27,4,4,0,0,4
118,2022/06/27,4,4,3,0,7
119,2022/06/27,7,4,0,0,7
120,2022/06/27,7,0,0,0,7
149,2022/06/27,7,0,0,0,7
184,2022/06/27,8,9,6,0,14
195,2022/06/27,23,21,22,3,45
218,2022/06/27,17,21,20,2,37
296,2022/06/27,7,6,3,0,10
300,2022/06/27,10,8,1,0,11
304,2022/06/27,7,0,1,0,8
317,2022/06/27,23,16,17,0,40
343,2022/06/27,4,4,1,0,5
373,2022/06/27,18,16,6,0,24
374,2022/06/27,6,0,4,0,10
388,2022/06/27,11,21,22,0,33
419,2022/06/27,32,16,11,0,43
420,2022/06/27,25,8,6,0,31
462,2022/06/27,16,8,4,0,20
519,2022/06/27,10,6,5,0,15
525,2022/06/27,5,5,1,0,6
596,2022/06/27,5,4,4,0,9
597,2022/06/27,11,12,8,0,19
598,2022/06/27,10,6,1,0,11
1035,2022/06/27,0,0,0,0,0
1084,2022/06/27,16,10,9,0,25
1111,2022/06/27,5,0,2,0,7
1112,2022/06/27,6,0,0,0,6
1113,2022/06/27,5,0,1,0,6
1114,2022/06/27,11,0,1,0,12
1115,2022/06/27,3,0,2,0,5
1118,2022/06/27,7,0,0,0,7
1119,2022/06/27,7,0,0,0,7
1692,2022/06/27,22,0,1,0,23
1693,2022/06/27,9,8,3,1,12
1747,2022/06/27,18,15,14,0,32
1772,2022/06/27,12,8,0,0,12
1773,2022/06/27,8,0,0,0,8
1774,2022/06/27,7,0,5,0,12
1782,2022/06/27,24,15,22,0,46
1795,2022/06/27,15,14,13,0,28
1914,2022/06/27,7,0,1,0,8
1915,2022/06/27,4,0,0,0,4
1923,2022/06/27,6,0,0,0,6
1934,2022/06/27,7,6,1,0,8
1963,2022/06/27,23,16,14,0,37
1984,2022/06/27,6,0,4,0,10
2135,2022/06/27,7,0,0,0,7
2136,2022/06/27,7,0,1,0,8
2148,2022/06/27,14,0,4,0,18
2183,2022/06/27,6,6,5,0,11
2193,2022/06/27,12,12,13,0,25
2237,2022/06/27,2,0,1,0,3
2358,2022/06/27,11,0,6,0,17
2361,2022/06/27,11,7,4,0,15
2445,2022/06/27,6,6,4,0,10
2449,2022/06/27,30,16,6,0,36
2451,2022/06/27,17,0,10,0,27
2476,2022/06/27,4,0,0,0,4
2507,2022/06/27,13,12,8,0,21
2525,2022/06/27,5,0,0,0,5
2562,2022/06/27,23,8,3,0,26
2582,2022/06/27,7,0,1,0,8
2586,2022/06/27,16,12,14,5,30
2631,2022/06/27,7,6,7,0,14
2685,2022/06/27,6,4,4,0,10
2730,2022/06/27,9,0,3,0,12
2731,2022/06/27,8,6,2,0,10
2732,2022/06/27,1,0,3,0,4
2734,2022/06/27,5,0,1,0,6
2735,2022/06/27,10,0,3,0,13
2761,2022/06/27,16,15,14,0,30
2788,2022/06/27,22,16,14,0,36
2812,2022/06/27,7,0,0,0,7
2814,2022/06/27,9,0,0,0,9
2913,2022/06/27,6,6,2,0,8
2914,2022/06/27,9,6,0,0,9
3015,2022/06/27,8,0,2,0,10
3035,2022/06/27,4,0,0,0,4
4446,2022/06/27,21,12,13,0,34
12136,2022/06/27,20,18,12,3,32
12516,2022/06/27,4,0,4,0,8
12518,2022/06/27,17,0,1,0,18
12523,2022/06/27,6,0,0,0,6
16062,2022/06/27,4,0,0,0,4
16063,2022/06/27,5,0,1,0,6
19322,2022/06/27,8,0,0,0,8
19516,2022/06/27,11,0,5,0,16
19520,2022/06/27,7,0,1,0,8
75,2022/06/28,39,32,30,0,69
76,2022/06/28,30,32,31,0,61
99,2022/06/28,10,0,1,0,11
117,2022/06/28,8,4,1,0,9
118,2022/06/28,5,4,1,0,6
119,2022/06/28,7,0,1,2,8
120,2022/06/28,7,0,3,2,10
149,2022/06/28,7,0,0,0,7
184,2022/06/28,8,6,9,0,17
195,2022/06/28,25,27,28,0,53
218,2022/06/28,11,15,19,0,30
296,2022/06/28,10,6,3,0,13
300,2022/06/28,9,0,2,0,11
304,2022/06/28,12,6,1,0,13
317,2022/06/28,30,24,5,0,35
343,2022/06/28,3,0,2,0,5
373,2022/06/28,28,16,4,0,32
374,2022/06/28,6,4,0,0,6
388,2022/06/28,7,18,16,0,23
419,2022/06/28,37,16,11,0,48
420,2022/06/28,27,8,1,0,28
462,2022/06/28,12,0,3,0,15
519,2022/06/28,11,6,7,0,18
525,2022/06/28,4,0,1,0,5
596,2022/06/28,5,4,3,0,8
597,2022/06/28,9,6,5,0,14
598,2022/06/28,9,0,2,0,11
1035,2022/06/28,6,6,3,0,9
1084,2022/06/28,17,10,7,0,24
1111,2022/06/28,9,6,0,0,9
1112,2022/06/28,6,0,1,0,7
1113,2022/06/28,10,6,2,0,12
1114,2022/06/28,10,0,2,0,12
1115,2022/06/28,7,6,1,0,8
1118,2022/06/28,7,0,0,0,7
1119,2022/06/28,7,0,1,0,8
1692,2022/06/28,21,0,2,0,23
1693,2022/06/28,5,0,0,0,5
1747,2022/06/28,19,15,16,0,35
1772,2022/06/28,12,0,1,0,13
1773,2022/06/28,8,0,0,0,8
1774,2022/06/28,2,0,0,0,2
1782,2022/06/28,24,21,18,0,42
1795,2022/06/28,16,14,13,0,29
1914,2022/06/28,6,0,0,0,6
1915,2022/06/28,4,0,1,0,5
1923,2022/06/28,6,0,0,0,6
1934,2022/06/28,6,0,1,0,7
1963,2022/06/28,26,16,13,0,39
1984,2022/06/28,2,0,2,0,4
2135,2022/06/28,7,0,0,0,7
2136,2022/06/28,6,0,0,0,6
2148,2022/06/28,10,0,2,0,12
2183,2022/06/28,7,6,5,0,12
2193,2022/06/28,11,12,11,0,22
2237,2022/06/28,7,6,1,0,8
2358,2022/06/28,5,0,5,0,10
2361,2022/06/28,7,0,3,0,10
2445,2022/06/28,8,6,5,0,13
2449,2022/06/28,32,8,7,0,39
2451,2022/06/28,8,0,3,0,11
2475,2022/06/28,8,0,1,0,9
2476,2022/06/28,4,0,1,0,5
2507,2022/06/28,11,6,7,0,18
2525,2022/06/28,5,0,1,0,6
2562,2022/06/28,28,8,6,9,34
2582,2022/06/28,10,4,1,0,11
2586,2022/06/28,9,12,11,0,20
2631,2022/06/28,0,0,0,0,0
2685,2022/06/28,6,4,3,0,9
2730,2022/06/28,6,0,0,0,6
2731,2022/06/28,6,0,1,0,7
2732,2022/06/28,6,8,1,0,7
2734,2022/06/28,4,0,4,0,8
2735,2022/06/28,7,0,3,3,10
2761,2022/06/28,17,15,6,0,23
2788,2022/06/28,20,12,14,3,34
2812,2022/06/28,7,0,0,0,7
2814,2022/06/28,9,0,3,0,12
2913,2022/06/28,4,0,0,0,4
2914,2022/06/28,9,0,0,0,9
3015,2022/06/28,6,0,1,0,7
3033,2022/06/28,9,6,1,0,10
3035,2022/06/28,4,0,1,0,5
4446,2022/06/28,17,9,14,0,31
12136,2022/06/28,20,15,21,0,41
12516,2022/06/28,4,4,2,0,6
12518,2022/06/28,16,0,1,0,17
12523,2022/06/28,10,4,3,0,13
16062,2022/06/28,10,6,1,0,11
16063,2022/06/28,10,6,4,0,14
19322,2022/06/28,8,0,0,0,8
19516,2022/06/28,22,16,1,0,23
19520,2022/06/28,6,0,3,0,9
75,2022/06/29,41,32,28,1,69
76,2022/06/29,31,32,28,0,59
99,2022/06/29,9,0,0,0,9
117,2022/06/29,7,0,0,0,7
118,2022/06/29,8,4,4,0,12
119,2022/06/29,4,0,1,0,5
120,2022/06/29,6,4,1,0,7
149,2022/06/29,7,0,0,0,7
184,2022/06/29,8,9,5,0,13
195,2022/06/29,30,33,28,0,58
218,2022/06/29,19,27,25,0,44
296,2022/06/29,13,6,3,0,16
300,2022/06/29,7,0,4,0,11
304,2022/06/29,17,6,2,0,19
317,2022/06/29,41,16,6,0,47
343,2022/06/29,5,4,2,0,7
373,2022/06/29,32,8,8,0,40
374,2022/06/29,10,4,4,0,14
388,2022/06/29,8,18,19,0,27
419,2022/06/29,42,16,7,0,49
420,2022/06/29,34,8,5,0,39
462,2022/06/29,17,8,4,0,21
519,2022/06/29,10,6,5,0,15
525,2022/06/29,-1,0,1,0,0
596,2022/06/29,6,4,2,0,8
597,2022/06/29,16,12,7,0,23
598,2022/06/29,7,0,1,0,8
1035,2022/06/29,9,6,5,0,14
1084,2022/06/29,15,5,5,0,20
1111,2022/06/29,9,0,0,0,9
1113,2022/06/29,8,0,1,0,9
1114,2022/06/29,8,0,2,0,10
1115,2022/06/29,6,0,1,0,7
1118,2022/06/29,0,0,0,0,0
1119,2022/06/29,6,0,0,0,6
1692,2022/06/29,27,8,5,0,32
1693,2022/06/29,13,8,3,0,16
1747,2022/06/29,23,20,14,0,37
1772,2022/06/29,11,0,0,0,11
1773,2022/06/29,8,0,1,0,9
1774,2022/06/29,10,8,0,0,10
1782,2022/06/29,21,15,16,0,37
1795,2022/06/29,10,7,8,0,18
1914,2022/06/29,6,0,1,0,7
1915,2022/06/29,9,6,1,0,10
1934,2022/06/29,11,6,3,0,14
1963,2022/06/29,28,16,8,0,36
1984,2022/06/29,6,6,1,0,7
2135,2022/06/29,7,0,2,0,9
2136,2022/06/29,6,0,1,0,7
2148,2022/06/29,8,0,0,0,8
2183,2022/06/29,8,6,2,0,10
2193,2022/06/29,15,15,14,0,29
2237,2022/06/29,6,0,4,0,10
2358,2022/06/29,8,8,4,0,12
2361,2022/06/29,11,7,2,0,13
2445,2022/06/29,9,6,6,0,15
2449,2022/06/29,33,8,6,0,39
2451,2022/06/29,4,0,3,0,7
2475,2022/06/29,7,0,0,0,7
2476,2022/06/29,9,6,0,0,9
2507,2022/06/29,16,12,14,0,30
2525,2022/06/29,10,6,2,0,12
2562,2022/06/29,21,8,6,0,27
2582,2022/06/29,9,0,3,0,12
2586,2022/06/29,10,12,10,0,20
2631,2022/06/29,0,0,0,0,0
2685,2022/06/29,7,4,4,0,11
2730,2022/06/29,6,0,1,0,7
2731,2022/06/29,5,0,1,0,6
2732,2022/06/29,5,0,0,0,5
2734,2022/06/29,4,4,1,0,5
2735,2022/06/29,1,0,2,0,3
2761,2022/06/29,26,15,14,0,40
2788,2022/06/29,23,20,10,1,33
2812,2022/06/29,7,0,1,0,8
2813,2022/06/29,7,0,0,0,7
2814,2022/06/29,12,6,0,0,12
2913,2022/06/29,4,0,0,0,4
2914,2022/06/29,9,0,2,0,11
3015,2022/06/29,5,0,2,0,7
3033,2022/06/29,8,0,0,0,8
3035,2022/06/29,9,6,1,0,10
4446,2022/06/29,12,9,10,0,22
12136,2022/06/29,23,24,18,0,41
12516,2022/06/29,6,4,1,0,7
12518,2022/06/29,15,0,2,0,17
12523,2022/06/29,7,0,0,0,7
16062,2022/06/29,9,0,1,0,10
16063,2022/06/29,6,0,0,0,6
19322,2022/06/29,8,0,0,0,8
19516,2022/06/29,29,8,5,0,34
19520,2022/06/29,3,0,1,0,4
75,2022/06/30,44,32,33,0,77
76,2022/06/30,39,36,40,0,79
99,2022/06/30,9,0,1,0,10
117,2022/06/30,11,4,5,0,16
118,2022/06/30,4,0,1,0,5
119,2022/06/30,7,4,0,0,7
120,2022/06/30,5,0,0,2,5
149,2022/06/30,7,0,0,0,7
184,2022/06/30,12,9,14,0,26
195,2022/06/30,29,27,33,0,62
218,2022/06/30,12,18,21,0,33
296,2022/06/30,16,6,4,0,20
300,2022/06/30,11,8,4,0,15
304,2022/06/30,15,0,4,0,19
317,2022/06/30,51,16,9,0,60
343,2022/06/30,7,4,1,0,8
373,2022/06/30,40,16,6,0,46
374,2022/06/30,10,4,3,0,13
388,2022/06/30,9,18,20,0,29
419,2022/06/30,51,16,6,0,57
420,2022/06/30,29,0,7,0,36
462,2022/06/30,21,8,6,0,27
519,2022/06/30,11,6,7,0,18
525,2022/06/30,3,5,1,0,4
596,2022/06/30,8,4,8,0,16
597,2022/06/30,21,12,12,0,33
598,2022/06/30,12,6,2,0,14
1035,2022/06/30,16,12,5,0,21
1084,2022/06/30,15,5,15,0,30
1111,2022/06/30,9,0,0,0,9
1113,2022/06/30,7,0,2,0,9
1114,2022/06/30,12,6,4,0,16
1115,2022/06/30,11,6,0,0,11
1117,2022/06/30,6,0,1,0,7
1119,2022/06/30,6,0,1,0,7
1692,2022/06/30,22,0,1,0,23
1693,2022/06/30,18,8,5,0,23
1747,2022/06/30,24,15,25,0,49
1772,2022/06/30,11,0,0,0,11
1773,2022/06/30,7,0,0,0,7
1774,2022/06/30,10,0,2,0,12
1782,2022/06/30,17,12,16,0,33
1795,2022/06/30,16,14,14,0,30
1914,2022/06/30,5,0,1,0,6
1915,2022/06/30,8,0,1,0,9
1934,2022/06/30,8,0,6,0,14
1963,2022/06/30,36,16,7,0,43
1984,2022/06/30,5,0,1,0,6
2135,2022/06/30,5,0,2,0,7
2136,2022/06/30,5,0,3,0,8
2148,2022/06/30,8,0,1,0,9
2183,2022/06/30,12,6,5,0,17
2193,2022/06/30,16,15,16,0,32
2237,2022/06/30,8,6,3,0,11
2358,2022/06/30,4,0,3,0,7
2361,2022/06/30,9,0,4,0,13
2445,2022/06/30,9,6,6,0,15
2449,2022/06/30,27,0,0,0,27
2451,2022/06/30,6,5,3,0,9
2475,2022/06/30,7,0,0,0,7
2476,2022/06/30,9,0,1,0,10
2507,2022/06/30,14,12,10,0,24
2525,2022/06/30,8,0,2,0,10
2562,2022/06/30,31,16,10,0,41
2582,2022/06/30,6,0,2,0,8
2586,2022/06/30,12,12,10,0,22
2631,2022/06/30,6,6,4,0,10
2685,2022/06/30,7,4,4,0,11
2723,2022/06/30,6,0,2,0,8
2730,2022/06/30,5,0,0,0,5
2731,2022/06/30,10,6,1,0,11
2732,2022/06/30,13,8,0,0,13
2734,2022/06/30,3,0,3,0,6
2735,2022/06/30,-1,0,0,0,-1
2761,2022/06/30,27,15,13,0,40
2788,2022/06/30,24,12,20,1,44
2812,2022/06/30,6,0,0,0,6
2813,2022/06/30,7,0,0,0,7
2814,2022/06/30,12,0,5,0,17
2913,2022/06/30,10,6,4,0,14
2914,2022/06/30,7,0,0,0,7
3015,2022/06/30,11,8,0,0,11
3033,2022/06/30,8,0,2,0,10
3035,2022/06/30,8,0,1,0,9
4446,2022/06/30,8,6,6,0,14
12136,2022/06/30,29,24,28,1,57
12516,2022/06/30,5,0,3,0,8
12518,2022/06/30,13,0,4,0,17
12523,2022/06/30,11,4,4,0,15
16062,2022/06/30,8,0,0,0,8
16063,2022/06/30,6,0,0,0,6
19322,2022/06/30,8,0,1,0,9
19516,2022/06/30,32,8,3,0,35
19520,2022/06/30,2,0,0,0,2
75,2022/07/01,51,40,36,1,87
76,2022/07/01,35,36,34,0,69
99,2022/07/01,8,0,0,0,8
117,2022/07/01,6,0,0,0,6
118,2022/07/01,7,4,1,0,8
119,2022/07/01,7,0,1,0,8
120,2022/07/01,3,0,1,0,4
149,2022/07/01,7,0,0,0,7
184,2022/07/01,10,12,9,0,19
195,2022/07/01,26,30,30,0,56
218,2022/07/01,12,21,17,0,29
296,2022/07/01,12,0,2,0,14
300,2022/07/01,15,8,5,0,20
304,2022/07/01,11,0,3,0,14
317,2022/07/01,58,16,9,0,67
343,2022/07/01,6,0,1,0,7
373,2022/07/01,42,8,11,1,53
374,2022/07/01,11,4,4,0,15
388,2022/07/01,9,21,22,0,31
419,2022/07/01,61,16,10,0,71
420,2022/07/01,30,8,4,0,34
462,2022/07/01,15,0,5,0,20
519,2022/07/01,16,12,7,0,23
525,2022/07/01,2,0,1,0,3
596,2022/07/01,8,8,6,0,14
597,2022/07/01,27,18,11,0,38
598,2022/07/01,10,0,5,0,15
1035,2022/07/01,17,6,13,0,30
1084,2022/07/01,15,15,6,0,21
1111,2022/07/01,9,0,1,0,10
1113,2022/07/01,5,0,1,0,6
1114,2022/07/01,8,0,2,0,10
1115,2022/07/01,11,0,2,0,13
1117,2022/07/01,5,0,0,0,5
1118,2022/07/01,6,6,1,0,7
1119,2022/07/01,5,0,1,0,6
1692,2022/07/01,29,8,2,0,31
1693,2022/07/01,21,8,9,0,30
1747,2022/07/01,19,20,20,0,39
1772,2022/07/01,11,0,0,0,11
1773,2022/07/01,7,0,2,0,9
1774,2022/07/01,16,8,4,0,20
1782,2022/07/01,22,21,22,0,44
1795,2022/07/01,16,14,12,0,28
1914,2022/07/01,4,0,0,0,4
1915,2022/07/01,7,0,1,0,8
1923,2022/07/01,6,6,1,0,7
1934,2022/07/01,8,6,6,0,14
1963,2022/07/01,45,16,14,0,59
1984,2022/07/01,10,6,0,0,10
2135,2022/07/01,9,6,6,0,15
2136,2022/07/01,8,6,2,0,10
2148,2022/07/01,11,4,0,0,11
2183,2022/07/01,13,6,4,0,17
2193,2022/07/01,15,15,11,0,26
2237,2022/07/01,5,0,2,0,7
2358,2022/07/01,9,8,3,0,12
2361,2022/07/01,12,7,2,0,14
2445,2022/07/01,9,6,4,1,13
2449,2022/07/01,35,8,11,0,46
2451,2022/07/01,13,10,6,0,19
2475,2022/07/01,7,0,0,0,7
2476,2022/07/01,8,0,1,0,9
2507,2022/07/01,16,12,8,0,24
2525,2022/07/01,6,0,4,0,10
2562,2022/07/01,29,8,3,0,32
2582,2022/07/01,4,0,3,0,7
2586,2022/07/01,18,16,16,0,34
2631,2022/07/01,8,6,5,0,13
2685,2022/07/01,11,8,4,0,15
2730,2022/07/01,5,0,3,0,8
2731,2022/07/01,9,0,2,0,11
2732,2022/07/01,13,0,0,0,13
2734,2022/07/01,4,4,3,0,7
2735,2022/07/01,7,8,3,0,10
2761,2022/07/01,29,15,14,0,43
2788,2022/07/01,15,12,12,2,27
2812,2022/07/01,6,0,0,0,6
2814,2022/07/01,7,0,0,0,7
2913,2022/07/01,6,0,2,0,8
2914,2022/07/01,7,0,0,0,7
3015,2022/07/01,11,0,1,0,12
3033,2022/07/01,6,0,1,0,7
3035,2022/07/01,7,0,2,0,9
4446,2022/07/01,14,12,12,0,26
12136,2022/07/01,15,15,14,0,29
12516,2022/07/01,6,4,0,0,6
12518,2022/07/01,9,0,2,0,11
12523,2022/07/01,7,0,5,0,12
16062,2022/07/01,8,0,1,0,9
16063,2022/07/01,12,6,6,0,18
19322,2022/07/01,7,0,0,0,7
19516,2022/07/01,37,8,4,1,41
19520,2022/07/01,10,8,1,0,11
75,2022/07/02,38,24,28,0,66
76,2022/07/02,29,28,25,0,54
99,2022/07/02,8,0,1,0,9
117,2022/07/02,6,0,0,1,6
118,2022/07/02,10,4,5,0,15
119,2022/07/02,6,0,2,3,8
120,2022/07/02,6,4,2,0,8
184,2022/07/02,13,12,12,0,25
195,2022/07/02,23,27,23,0,46
218,2022/07/02,16,21,10,0,26
296,2022/07/02,16,6,4,0,20
300,2022/07/02,10,0,5,0,15
304,2022/07/02,8,0,7,0,15
317,2022/07/02,49,0,9,0,58
343,2022/07/02,9,4,5,0,14
373,2022/07/02,38,8,11,0,49
374,2022/07/02,7,0,2,0,9
388,2022/07/02,8,21,12,0,20
419,2022/07/02,51,0,9,0,60
420,2022/07/02,26,0,4,0,30
462,2022/07/02,18,8,7,0,25
519,2022/07/02,21,12,3,0,24
525,2022/07/02,6,5,1,0,7
596,2022/07/02,2,0,2,0,4
597,2022/07/02,16,0,12,0,28
598,2022/07/02,5,0,1,0,6
1035,2022/07/02,10,6,7,0,17
1084,2022/07/02,9,0,4,0,13
1111,2022/07/02,8,0,0,0,8
1113,2022/07/02,4,0,0,0,4
1114,2022/07/02,6,0,0,0,6
1115,2022/07/02,9,0,1,0,10
1117,2022/07/02,5,0,1,0,6
1118,2022/07/02,11,6,3,0,14
1119,2022/07/02,4,0,0,0,4
1692,2022/07/02,27,0,6,0,33
1693,2022/07/02,12,0,5,0,17
1747,2022/07/02,14,15,14,0,28
1772,2022/07/02,11,0,0,0,11
1773,2022/07/02,5,0,0,0,5
1774,2022/07/02,12,0,3,0,15
1782,2022/07/02,15,15,9,0,24
1795,2022/07/02,25,21,13,0,38
1914,2022/07/02,10,6,4,0,14
1915,2022/07/02,6,0,3,0,9
1923,2022/07/02,11,6,2,0,13
1934,2022/07/02,2,0,0,0,2
1963,2022/07/02,47,16,16,0,63
1984,2022/07/02,16,6,3,0,19
2135,2022/07/02,3,0,1,0,4
2136,2022/07/02,6,0,2,0,8
2148,2022/07/02,15,4,7,0,22
2183,2022/07/02,15,6,4,0,19
2193,2022/07/02,13,9,12,0,25
2237,2022/07/02,9,6,3,0,12
2358,2022/07/02,14,8,5,0,19
2361,2022/07/02,10,0,2,0,12
2445,2022/07/02,10,6,3,0,13
2449,2022/07/02,24,0,15,0,39
2451,2022/07/02,12,5,1,0,13
2475,2022/07/02,7,0,0,0,7
2476,2022/07/02,7,0,0,0,7
2507,2022/07/02,20,12,8,0,28
2525,2022/07/02,2,0,0,0,2
2562,2022/07/02,34,8,6,0,40
2582,2022/07/02,1,0,0,0,1
2586,2022/07/02,14,12,11,3,25
2631,2022/07/02,9,6,4,0,13
2685,2022/07/02,11,4,11,0,22
2730,2022/07/02,2,0,2,0,4
2731,2022/07/02,7,0,1,0,8
2732,2022/07/02,13,0,0,0,13
2734,2022/07/02,1,0,1,0,2
2735,2022/07/02,4,0,1,0,5
2761,2022/07/02,20,5,5,5,25
2788,2022/07/02,17,16,9,0,26
2812,2022/07/02,6,0,0,0,6
2814,2022/07/02,13,6,0,0,13
2913,2022/07/02,4,0,2,2,6
2914,2022/07/02,7,0,0,0,7
3015,2022/07/02,10,0,0,0,10
3035,2022/07/02,5,0,0,0,5
4446,2022/07/02,14,12,5,0,19
12136,2022/07/02,22,21,11,2,33
12516,2022/07/02,10,4,3,0,13
12518,2022/07/02,7,0,1,0,8
12523,2022/07/02,6,4,1,0,7
16062,2022/07/02,7,0,2,0,9
16063,2022/07/02,6,0,0,0,6
19322,2022/07/02,7,0,1,0,8
19516,2022/07/02,32,0,12,0,44
19520,2022/07/02,9,0,2,0,11
75,2022/07/03,30,20,15,3,45
76,2022/07/03,24,20,23,0,47
99,2022/07/03,7,0,0,0,7
117,2022/07/03,5,0,1,1,6
118,2022/07/03,5,0,3,0,8
119,2022/07/03,5,4,0,0,5
120,2022/07/03,4,0,4,0,8
149,2022/07/03,7,0,3,0,10
184,2022/07/03,7,6,7,0,14
195,2022/07/03,18,18,19,0,37
218,2022/07/03,22,18,13,9,35
296,2022/07/03,12,0,5,0,17
300,2022/07/03,5,0,4,0,9
304,2022/07/03,1,0,2,0,3
317,2022/07/03,56,16,21,0,77
343,2022/07/03,4,0,1,0,5
373,2022/07/03,27,0,6,0,33
374,2022/07/03,13,8,3,0,16
388,2022/07/03,8,12,12,6,20
419,2022/07/03,42,0,16,0,58
420,2022/07/03,22,0,6,0,28
462,2022/07/03,11,0,6,0,17
519,2022/07/03,24,6,4,0,28
525,2022/07/03,5,0,1,0,6
596,2022/07/03,4,4,0,0,4
597,2022/07/03,10,6,8,4,18
598,2022/07/03,4,0,2,0,6
1035,2022/07/03,9,6,2,0,11
1084,2022/07/03,5,0,3,0,8
1111,2022/07/03,8,0,0,0,8
1113,2022/07/03,10,6,0,0,10
1114,2022/07/03,12,6,4,0,16
1115,2022/07/03,8,0,1,0,9
1117,2022/07/03,4,0,0,0,4
1118,2022/07/03,8,0,1,0,9
1119,2022/07/03,4,0,0,0,4
1692,2022/07/03,21,0,2,0,23
1693,2022/07/03,15,8,12,0,27
1747,2022/07/03,10,10,7,0,17
1772,2022/07/03,11,0,0,0,11
1773,2022/07/03,5,0,0,0,5
1774,2022/07/03,9,0,1,0,10
1782,2022/07/03,24,18,7,0,31
1795,2022/07/03,12,0,9,0,21
1914,2022/07/03,6,0,0,0,6
1915,2022/07/03,3,0,1,0,4
1923,2022/07/03,9,0,1,0,10
1934,2022/07/03,2,0,0,1,2
1963,2022/07/03,47,16,18,0,65
1984,2022/07/03,13,0,2,0,15
2135,2022/07/03,2,0,0,0,2
2136,2022/07/03,4,0,1,0,5
2148,2022/07/03,8,0,5,0,13
2183,2022/07/03,11,0,1,0,12
2193,2022/07/03,13,12,7,0,20
2237,2022/07/03,6,0,1,0,7
2358,2022/07/03,17,8,4,0,21
2361,2022/07/03,15,7,3,0,18
2445,2022/07/03,13,6,5,0,18
2449,2022/07/03,17,8,12,0,29
2451,2022/07/03,21,10,0,0,21
2475,2022/07/03,7,0,0,0,7
2476,2022/07/03,7,0,2,0,9
2507,2022/07/03,18,6,11,0,29
2525,2022/07/03,8,6,0,0,8
2562,2022/07/03,28,0,9,0,37
2582,2022/07/03,5,4,3,0,8
2586,2022/07/03,12,12,9,0,21
2631,2022/07/03,11,6,4,0,15
2685,2022/07/03,4,4,1,0,5
2723,2022/07/03,12,8,0,0,12
2730,2022/07/03,0,0,3,0,3
2731,2022/07/03,6,0,1,0,7
2732,2022/07/03,13,0,1,0,14
2734,2022/07/03,8,8,0,0,8
2735,2022/07/03,3,0,0,0,3
2761,2022/07/03,20,10,10,0,30
2788,2022/07/03,16,8,11,3,27
2812,2022/07/03,6,0,0,0,6
2814,2022/07/03,13,0,1,0,14
2913,2022/07/03,0,0,0,0,0
2914,2022/07/03,7,0,0,0,7
3015,2022/07/03,10,0,2,0,12
3035,2022/07/03,5,0,1,0,6
4446,2022/07/03,18,9,5,0,23
12136,2022/07/03,24,15,10,9,34
12516,2022/07/03,11,4,2,0,13
12518,2022/07/03,6,0,0,0,6
12523,2022/07/03,5,0,1,0,6
16062,2022/07/03,5,0,0,0,5
16063,2022/07/03,6,0,0,0,6
19322,2022/07/03,6,0,1,0,7
19516,2022/07/03,28,8,11,0,39
19520,2022/07/03,7,0,1,0,8
75,2022/07/04,30,28,35,0,65
76,2022/07/04,29,36,31,0,60
99,2022/07/04,7,0,1,0,8
117,2022/07/04,7,4,0,0,7
118,2022/07/04,6,4,1,0,7
119,2022/07/04,5,0,1,0,6
120,2022/07/04,0,0,0,0,0
149,2022/07/04,4,0,0,0,4
184,2022/07/04,9,9,8,0,17
195,2022/07/04,25,30,33,0,58
218,2022/07/04,18,21,21,2,39
296,2022/07/04,13,6,1,0,14
300,2022/07/04,9,8,1,0,10
304,2022/07/04,6,6,5,0,11
317,2022/07/04,51,16,14,0,65
343,2022/07/04,3,0,0,0,3
373,2022/07/04,21,0,3,6,24
374,2022/07/04,10,0,5,0,15
388,2022/07/04,20,21,21,0,41
419,2022/07/04,42,16,16,0,58
420,2022/07/04,24,8,5,0,29
462,2022/07/04,5,0,3,0,8
519,2022/07/04,26,6,7,0,33
525,2022/07/04,9,5,0,0,9
596,2022/07/04,7,4,7,0,14
597,2022/07/04,9,12,7,0,16
598,2022/07/04,7,6,4,1,11
1035,2022/07/04,13,6,2,0,15
1084,2022/07/04,10,10,7,0,17
1111,2022/07/04,8,0,1,0,9
1113,2022/07/04,10,0,0,0,10
1114,2022/07/04,8,0,0,0,8
1115,2022/07/04,7,0,2,0,9
1117,2022/07/04,4,0,0,0,4
1118,2022/07/04,7,0,0,0,7
1119,2022/07/04,10,6,0,0,10
1692,2022/07/04,27,8,4,0,31
1693,2022/07/04,11,8,6,0,17
1747,2022/07/04,23,20,8,0,31
1772,2022/07/04,11,0,2,0,13
1773,2022/07/04,11,6,4,0,15
1774,2022/07/04,8,0,3,0,11
1782,2022/07/04,35,18,21,1,56
1795,2022/07/04,17,14,10,0,27
1914,2022/07/04,6,0,0,0,6
1915,2022/07/04,8,6,0,0,8
1923,2022/07/04,8,0,1,0,9
1934,2022/07/04,7,6,2,0,9
1963,2022/07/04,37,8,15,0,52
1984,2022/07/04,17,6,2,0,19
2135,2022/07/04,8,6,1,0,9
2136,2022/07/04,9,6,2,0,11
2148,2022/07/04,3,0,2,0,5
2183,2022/07/04,16,6,1,0,17
2193,2022/07/04,21,15,7,4,28
2237,2022/07/04,11,6,1,0,12
2358,2022/07/04,13,0,3,0,16
2361,2022/07/04,12,0,2,0,14
2445,2022/07/04,14,6,0,0,14
2449,2022/07/04,13,8,9,0,22
2451,2022/07/04,21,0,4,0,25
2475,2022/07/04,7,0,0,0,7
2476,2022/07/04,5,0,0,0,5
2507,2022/07/04,3,6,3,0,6
2525,2022/07/04,8,0,1,0,9
2562,2022/07/04,27,8,4,0,31
2582,2022/07/04,2,0,1,0,3
2586,2022/07/04,15,12,6,4,21
2631,2022/07/04,13,6,1,0,14
2685,2022/07/04,3,4,4,0,7
2723,2022/07/04,12,0,0,0,12
2730,2022/07/04,-3,0,1,0,-2
2731,2022/07/04,11,6,2,0,13
2732,2022/07/04,12,0,1,0,13
2734,2022/07/04,8,0,3,0,11
2735,2022/07/04,11,8,1,0,12
2761,2022/07/04,20,10,9,1,29
2788,2022/07/04,14,16,14,1,28
2812,2022/07/04,12,6,1,0,13
2814,2022/07/04,12,0,0,0,12
2913,2022/07/04,6,6,1,0,7
2914,2022/07/04,7,0,0,0,7
3015,2022/07/04,8,0,1,0,9
3035,2022/07/04,10,6,1,0,11
4446,2022/07/04,22,9,13,4,35
12136,2022/07/04,26,24,21,4,47
12516,2022/07/04,9,0,3,0,12
12518,2022/07/04,16,10,1,0,17
12523,2022/07/04,4,0,3,0,7
16062,2022/07/04,5,0,1,0,6
16063,2022/07/04,12,6,1,0,13
19322,2022/07/04,5,0,0,0,5
19516,2022/07/04,17,0,5,0,22
19520,2022/07/04,6,0,0,0,6
75,2022/07/05,27,32,27,0,54
76,2022/07/05,33,36,32,0,65
99,2022/07/05,6,0,0,0,6
117,2022/07/05,7,0,3,1,10
118,2022/07/05,5,0,6,0,11
119,2022/07/05,4,0,2,0,6
120,2022/07/05,4,4,2,0,6
149,2022/07/05,4,0,0,0,4
184,2022/07/05,10,9,8,0,18
195,2022/07/05,22,30,27,0,49
218,2022/07/05,18,21,16,4,34
296,2022/07/05,12,0,2,0,14
300,2022/07/05,8,0,2,0,10
304,2022/07/05,1,0,0,0,1
317,2022/07/05,46,8,10,0,56
343,2022/07/05,3,0,3,0,6
373,2022/07/05,20,8,4,3,24
374,2022/07/05,5,0,1,0,6
388,2022/07/05,20,21,24,0,44
419,2022/07/05,34,8,14,0,48
420,2022/07/05,19,0,14,0,33
462,2022/07/05,10,8,4,0,14
519,2022/07/05,25,6,2,0,27
525,2022/07/05,9,0,2,3,11
596,2022/07/05,4,4,4,0,8
597,2022/07/05,14,12,7,0,21
598,2022/07/05,2,0,1,0,3
1035,2022/07/05,17,6,2,0,19
1084,2022/07/05,8,5,8,0,16
1111,2022/07/05,7,0,0,0,7
1113,2022/07/05,10,0,0,0,10
1114,2022/07/05,8,0,2,0,10
1115,2022/07/05,5,0,2,0,7
1117,2022/07/05,4,0,0,0,4
1118,2022/07/05,13,6,0,0,13
1119,2022/07/05,10,0,1,0,11
1692,2022/07/05,23,0,2,0,25
1693,2022/07/05,5,0,5,0,10
1747,2022/07/05,30,15,16,0,46
1772,2022/07/05,9,0,2,0,11
1773,2022/07/05,7,0,0,0,7
1774,2022/07/05,5,0,1,0,6
1782,2022/07/05,31,18,20,6,51
1795,2022/07/05,21,14,12,0,33
1914,2022/07/05,6,0,1,0,7
1915,2022/07/05,8,0,0,0,8
1923,2022/07/05,7,0,0,0,7
1934,2022/07/05,5,0,4,0,9
1963,2022/07/05,38,16,13,0,51
1984,2022/07/05,15,0,1,7,16
2135,2022/07/05,7,0,2,0,9
2136,2022/07/05,7,0,0,0,7
2148,2022/07/05,1,0,0,0,1
2183,2022/07/05,15,0,3,3,18
2193,2022/07/05,22,12,9,5,31
2237,2022/07/05,10,0,2,0,12
2358,2022/07/05,18,8,3,0,21
2361,2022/07/05,17,7,3,1,20
2445,2022/07/05,20,6,3,7,23
2449,2022/07/05,4,0,0,0,4
2451,2022/07/05,17,0,5,0,22
2475,2022/07/05,7,0,0,0,7
2476,2022/07/05,5,0,2,0,7
2507,2022/07/05,6,6,5,0,11
2525,2022/07/05,7,0,0,0,7
2562,2022/07/05,31,8,12,0,43
2582,2022/07/05,5,4,1,0,6
2586,2022/07/05,21,16,15,0,36
2631,2022/07/05,18,6,6,0,24
2685,2022/07/05,-1,0,0,0,-1
2723,2022/07/05,12,0,0,0,12
2730,2022/07/05,-4,0,0,0,-4
2731,2022/07/05,9,0,0,0,9
2732,2022/07/05,11,0,1,0,12
2734,2022/07/05,9,4,2,0,11
2735,2022/07/05,10,0,1,0,11
2761,2022/07/05,25,15,5,0,30
2788,2022/07/05,11,12,12,0,23
2812,2022/07/05,11,0,0,0,11
2814,2022/07/05,12,0,0,0,12
2913,2022/07/05,5,0,2,0,7
2914,2022/07/05,7,0,1,0,8
3015,2022/07/05,7,0,0,0,7
3035,2022/07/05,9,0,1,0,10
4446,2022/07/05,20,15,10,0,30
12136,2022/07/05,20,18,7,9,27
12516,2022/07/05,10,4,0,0,10
12518,2022/07/05,15,0,2,0,17
12523,2022/07/05,5,4,1,0,6
16062,2022/07/05,10,6,0,0,10
16063,2022/07/05,11,0,0,0,11
19322,2022/07/05,5,0,0,0,5
19516,2022/07/05,20,8,4,0,24
19520,2022/07/05,6,0,1,0,7
75,2022/07/06,28,28,31,0,59
76,2022/07/06,34,32,29,1,63
99,2022/07/06,6,0,1,0,7
117,2022/07/06,3,0,3,0,6
118,2022/07/06,3,4,1,0,4
119,2022/07/06,6,4,3,0,9
120,2022/07/06,2,0,2,0,4
149,2022/07/06,4,0,0,0,4
184,2022/07/06,11,9,6,0,17
195,2022/07/06,25,30,21,0,46
218,2022/07/06,22,24,30,0,52
296,2022/07/06,16,6,4,1,20
300,2022/07/06,14,8,4,0,18
304,2022/07/06,7,6,5,0,12
317,2022/07/06,35,0,8,1,43
343,2022/07/06,4,4,3,0,7
373,2022/07/06,13,0,4,4,17
374,2022/07/06,8,4,3,0,11
388,2022/07/06,14,18,12,0,26
419,2022/07/06,20,0,13,0,33
420,2022/07/06,13,8,8,0,21
462,2022/07/06,14,8,3,0,17
519,2022/07/06,23,0,2,1,25
525,2022/07/06,4,0,1,0,5
596,2022/07/06,4,4,3,0,7
597,2022/07/06,19,12,7,0,26
598,2022/07/06,1,0,1,0,2
1035,2022/07/06,21,6,4,0,25
1084,2022/07/06,10,10,8,1,18
1111,2022/07/06,7,0,1,0,8
1113,2022/07/06,10,0,0,0,10
1114,2022/07/06,12,6,1,0,13
1115,2022/07/06,3,0,0,0,3
1117,2022/07/06,4,0,1,0,5
1118,2022/07/06,13,0,1,0,14
1119,2022/07/06,9,0,0,0,9
1692,2022/07/06,21,0,2,0,23
1693,2022/07/06,0,0,2,0,2
1747,2022/07/06,29,15,14,1,43
1772,2022/07/06,7,0,0,0,7
1773,2022/07/06,7,0,0,0,7
1774,2022/07/06,12,8,1,0,13
1782,2022/07/06,14,9,14,0,28
1795,2022/07/06,23,14,16,0,39
1914,2022/07/06,5,0,0,0,5
1915,2022/07/06,8,0,0,0,8
1923,2022/07/06,7,0,2,0,9
1934,2022/07/06,7,6,5,0,12
1963,2022/07/06,25,0,12,4,37
1984,2022/07/06,7,0,2,2,9
2135,2022/07/06,5,0,1,0,6
2136,2022/07/06,7,0,0,0,7
2148,2022/07/06,5,4,1,0,6
2183,2022/07/06,15,6,1,5,16
2193,2022/07/06,26,18,16,0,42
2237,2022/07/06,8,0,0,0,8
2358,2022/07/06,15,0,5,0,20
2361,2022/07/06,13,0,4,1,17
2445,2022/07/06,10,0,5,0,15
2449,2022/07/06,20,16,11,0,31
2451,2022/07/06,12,0,4,2,16
2475,2022/07/06,7,0,1,0,8
2476,2022/07/06,3,0,0,0,3
2507,2022/07/06,13,12,6,0,19
2525,2022/07/06,7,0,1,0,8
2562,2022/07/06,19,0,8,8,27
2582,2022/07/06,4,0,1,0,5
2586,2022/07/06,22,16,14,0,36
2631,2022/07/06,12,0,3,0,15
2685,2022/07/06,7,8,0,0,7
2723,2022/07/06,12,0,0,0,12
2730,2022/07/06,-4,0,0,0,-4
2731,2022/07/06,9,0,1,0,10
2732,2022/07/06,10,0,0,0,10
2734,2022/07/06,7,0,2,0,9
2735,2022/07/06,9,0,1,0,10
2761,2022/07/06,30,10,19,2,49
2788,2022/07/06,7,8,10,0,17
2812,2022/07/06,11,0,2,0,13
2813,2022/07/06,7,0,1,0,8
2814,2022/07/06,12,0,0,0,12
2913,2022/07/06,3,0,1,0,4
2914,2022/07/06,6,0,0,0,6
3015,2022/07/06,7,0,1,0,8
3035,2022/07/06,8,0,1,0,9
4446,2022/07/06,16,6,8,0,24
12136,2022/07/06,15,12,11,2,26
12516,2022/07/06,10,0,0,0,10
12518,2022/07/06,13,0,2,0,15
12523,2022/07/06,8,4,2,0,10
16062,2022/07/06,10,0,0,0,10
16063,2022/07/06,11,0,1,0,12
19322,2022/07/06,5,0,0,0,5
19516,2022/07/06,16,0,1,0,17
19520,2022/07/06,5,0,1,0,6
75,2022/07/07,33,36,31,0,64
76,2022/07/07,44,40,34,8,78
99,2022/07/07,5,0,1,0,6
117,2022/07/07,4,4,1,0,5
118,2022/07/07,2,0,0,0,2
119,2022/07/07,3,0,1,0,4
120,2022/07/07,4,4,1,0,5
149,2022/07/07,10,6,4,0,14
184,2022/07/07,20,15,11,0,31
195,2022/07/07,37,33,26,9,63
218,2022/07/07,16,24,17,4,33
296,2022/07/07,11,0,8,0,19
300,2022/07/07,10,0,3,0,13
304,2022/07/07,8,6,4,0,12
317,2022/07/07,26,0,14,0,40
343,2022/07/07,5,4,5,0,10
373,2022/07/07,13,8,10,0,23
374,2022/07/07,9,4,6,0,15
388,2022/07/07,23,21,19,8,42
419,2022/07/07,7,0,2,0,9
420,2022/07/07,5,0,2,0,7
462,2022/07/07,19,8,5,0,24
519,2022/07/07,20,0,3,3,23
525,2022/07/07,3,0,0,3,3
596,2022/07/07,9,8,7,0,16
597,2022/07/07,24,12,17,0,41
598,2022/07/07,6,6,1,0,7
1035,2022/07/07,17,0,9,0,26
1084,2022/07/07,11,10,3,0,14
1111,2022/07/07,6,0,3,0,9
1113,2022/07/07,10,0,0,0,10
1114,2022/07/07,11,0,3,0,14
1115,2022/07/07,9,6,1,0,10
1117,2022/07/07,3,0,0,0,3
1118,2022/07/07,12,0,2,0,14
1119,2022/07/07,9,0,0,0,9
1692,2022/07/07,19,0,0,0,19
1693,2022/07/07,6,8,7,0,13
1747,2022/07/07,34,20,28,0,62
1772,2022/07/07,7,0,0,0,7
1773,2022/07/07,13,6,0,0,13
1774,2022/07/07,11,0,1,0,12
1782,2022/07/07,12,12,11,0,23
1795,2022/07/07,21,14,16,0,37
1914,2022/07/07,5,0,0,0,5
1915,2022/07/07,8,0,1,0,9
1923,2022/07/07,8,6,3,3,11
1934,2022/07/07,2,0,2,0,4
1963,2022/07/07,17,8,16,0,33
1984,2022/07/07,3,0,0,0,3
2135,2022/07/07,4,0,1,0,5
2136,2022/07/07,7,0,0,0,7
2148,2022/07/07,8,4,3,0,11
2183,2022/07/07,9,0,2,0,11
2193,2022/07/07,28,18,20,3,48
2237,2022/07/07,8,0,1,0,9
2358,2022/07/07,10,0,7,0,17
2361,2022/07/07,8,0,7,0,15
2445,2022/07/07,11,6,2,0,13
2449,2022/07/07,17,8,12,0,29
2451,2022/07/07,16,10,6,0,22
2475,2022/07/07,6,0,0,0,6
2476,2022/07/07,3,0,0,0,3
2507,2022/07/07,19,12,16,0,35
2525,2022/07/07,11,6,2,1,13
2562,2022/07/07,11,8,11,1,22
2582,2022/07/07,7,4,2,0,9
2586,2022/07/07,16,8,14,0,30
2602,2022/07/07,0,0,1,0,1
2631,2022/07/07,15,6,7,0,22
2685,2022/07/07,11,4,4,0,15
2723,2022/07/07,12,0,0,0,12
2730,2022/07/07,-4,0,1,0,-3
2731,2022/07/07,8,0,0,0,8
2732,2022/07/07,10,0,0,0,10
2734,2022/07/07,5,0,1,0,6
2735,2022/07/07,16,8,3,0,19
2761,2022/07/07,24,15,14,0,38
2788,2022/07/07,17,20,12,0,29
2812,2022/07/07,9,0,1,0,10
2813,2022/07/07,6,0,0,0,6
2814,2022/07/07,12,0,1,0,13
2913,2022/07/07,8,6,2,0,10
2914,2022/07/07,6,0,0,0,6
3015,2022/07/07,6,0,0,0,6
3033,2022/07/07,5,0,0,0,5
3035,2022/07/07,7,0,0,0,7
4446,2022/07/07,11,3,9,0,20
12136,2022/07/07,32,30,17,5,49
12516,2022/07/07,10,0,1,0,11
12518,2022/07/07,11,0,1,0,12
12523,2022/07/07,10,4,3,0,13
16062,2022/07/07,10,0,0,0,10
16063,2022/07/07,10,0,0,0,10
19322,2022/07/07,5,0,1,0,6
19516,2022/07/07,23,8,12,0,35
19520,2022/07/07,4,0,0,0,4
75,2022/07/08,38,36,35,1,73
76,2022/07/08,38,36,41,0,79
99,2022/07/08,4,0,0,0,4
117,2022/07/08,3,0,0,0,3
118,2022/07/08,6,4,3,0,9
119,2022/07/08,6,4,1,0,7
120,2022/07/08,3,0,2,0,5
149,2022/07/08,6,0,1,0,7
184,2022/07/08,21,12,14,0,35
195,2022/07/08,35,33,30,2,65
218,2022/07/08,16,21,22,0,38
296,2022/07/08,9,6,3,0,12
300,2022/07/08,7,0,2,0,9
304,2022/07/08,4,0,3,0,7
317,2022/07/08,20,8,6,0,26
343,2022/07/08,0,0,0,0,0
373,2022/07/08,19,16,5,0,24
374,2022/07/08,7,4,3,0,10
388,2022/07/08,17,21,19,0,36
419,2022/07/08,21,16,6,0,27
420,2022/07/08,11,8,4,0,15
462,2022/07/08,14,0,4,0,18
519,2022/07/08,20,6,3,0,23
525,2022/07/08,0,0,0,0,0
596,2022/07/08,10,8,4,0,14
597,2022/07/08,31,24,13,0,44
598,2022/07/08,5,0,1,0,6
1035,2022/07/08,14,6,3,0,17
1084,2022/07/08,23,15,6,0,29
1111,2022/07/08,3,0,1,0,4
1113,2022/07/08,10,0,1,0,11
1114,2022/07/08,8,0,0,0,8
1115,2022/07/08,8,0,2,0,10
1117,2022/07/08,11,8,2,0,13
1118,2022/07/08,10,0,5,0,15
1119,2022/07/08,9,0,1,0,10
1692,2022/07/08,19,0,0,0,19
1693,2022/07/08,7,8,0,0,7
1747,2022/07/08,16,10,16,0,32
1772,2022/07/08,7,0,0,0,7
1773,2022/07/08,13,0,0,0,13
1774,2022/07/08,10,0,1,0,11
1782,2022/07/08,25,24,23,0,48
1795,2022/07/08,19,14,4,0,23
1914,2022/07/08,11,6,2,0,13
1915,2022/07/08,7,0,0,0,7
1923,2022/07/08,5,0,3,0,8
1934,2022/07/08,6,6,2,0,8
1963,2022/07/08,17,16,7,0,24
1984,2022/07/08,3,0,1,2,4
2135,2022/07/08,9,6,2,0,11
2136,2022/07/08,7,0,1,0,8
2148,2022/07/08,5,0,2,0,7
2183,2022/07/08,7,0,2,0,9
2193,2022/07/08,11,6,6,0,17
2237,2022/07/08,13,6,7,0,20
2358,2022/07/08,11,8,2,0,13
2361,2022/07/08,8,7,8,0,16
2445,2022/07/08,9,0,4,3,13
2449,2022/07/08,21,16,4,0,25
2451,2022/07/08,10,0,5,0,15
2475,2022/07/08,6,0,0,0,6
2476,2022/07/08,9,6,1,0,10
2507,2022/07/08,15,12,15,0,30
2525,2022/07/08,9,0,2,0,11
2562,2022/07/08,7,8,3,0,10
2582,2022/07/08,9,4,3,0,12
2586,2022/07/08,18,16,11,0,29
2602,2022/07/08,7,8,2,0,9
2631,2022/07/08,8,0,3,0,11
2685,2022/07/08,11,4,4,0,15
2730,2022/07/08,-5,0,0,0,-5
2731,2022/07/08,8,0,1,0,9
2732,2022/07/08,10,0,1,0,11
2734,2022/07/08,8,4,1,0,9
2735,2022/07/08,13,0,0,0,13
2761,2022/07/08,20,10,10,0,30
2788,2022/07/08,21,16,20,4,41
2812,2022/07/08,8,0,1,0,9
2813,2022/07/08,6,0,0,0,6
2814,2022/07/08,11,0,2,0,13
2913,2022/07/08,6,0,1,0,7
2914,2022/07/08,6,0,1,0,7
3015,2022/07/08,6,0,1,0,7
3033,2022/07/08,5,0,0,0,5
3035,2022/07/08,7,0,0,0,7
4446,2022/07/08,17,15,11,0,28
12136,2022/07/08,34,24,26,1,60
12516,2022/07/08,9,0,3,0,12
12518,2022/07/08,10,0,0,0,10
12523,2022/07/08,11,4,4,0,15
16062,2022/07/08,10,0,1,0,11
16063,2022/07/08,10,0,0,0,10
19322,2022/07/08,4,0,0,0,4
19516,2022/07/08,19,8,3,0,22
19520,2022/07/08,12,8,1,0,13
75,2022/07/09,30,28,17,2,47
76,2022/07/09,21,24,22,0,43
99,2022/07/09,4,0,1,0,5
117,2022/07/09,7,4,3,0,10
118,2022/07/09,7,4,4,0,11
119,2022/07/09,5,0,2,0,7
120,2022/07/09,5,4,1,0,6
149,2022/07/09,5,0,0,0,5
184,2022/07/09,22,15,10,0,32
195,2022/07/09,27,24,24,5,51
218,2022/07/09,6,12,13,0,19
296,2022/07/09,6,0,4,0,10
300,2022/07/09,13,8,3,0,16
304,2022/07/09,7,6,2,0,9
317,2022/07/09,30,16,18,0,48
343,2022/07/09,4,4,4,0,8
373,2022/07/09,22,8,5,0,27
374,2022/07/09,4,0,1,0,5
388,2022/07/09,19,21,18,1,37
419,2022/07/09,23,8,10,0,33
420,2022/07/09,15,8,8,0,23
462,2022/07/09,18,8,6,0,24
519,2022/07/09,23,6,9,0,32
525,2022/07/09,5,5,2,3,7
596,2022/07/09,6,0,6,0,12
597,2022/07/09,18,0,8,0,26
598,2022/07/09,10,6,2,0,12
1035,2022/07/09,17,6,11,0,28
1084,2022/07/09,17,0,6,0,23
1111,2022/07/09,2,0,2,0,4
1113,2022/07/09,9,0,0,0,9
1114,2022/07/09,8,0,2,0,10
1115,2022/07/09,6,0,2,0,8
1117,2022/07/09,9,0,1,0,10
1118,2022/07/09,5,0,1,0,6
1119,2022/07/09,8,0,0,0,8
1692,2022/07/09,27,8,3,0,30
1693,2022/07/09,15,8,9,0,24
1747,2022/07/09,15,15,11,0,26
1772,2022/07/09,7,0,0,0,7
1773,2022/07/09,13,0,2,0,15
1774,2022/07/09,9,0,4,0,13
1782,2022/07/09,20,18,14,0,34
1795,2022/07/09,36,21,11,0,47
1914,2022/07/09,9,0,1,0,10
1915,2022/07/09,7,0,2,0,9
1923,2022/07/09,2,0,0,0,2
1934,2022/07/09,10,6,1,0,11
1963,2022/07/09,26,16,15,0,41
1984,2022/07/09,6,6,1,0,7
2135,2022/07/09,7,0,3,0,10
2136,2022/07/09,6,0,1,0,7
2148,2022/07/09,7,4,1,0,8
2183,2022/07/09,11,6,4,0,15
2193,2022/07/09,11,6,6,0,17
2237,2022/07/09,6,0,3,0,9
2358,2022/07/09,9,0,5,0,14
2361,2022/07/09,9,7,3,0,12
2445,2022/07/09,8,6,5,1,13
2449,2022/07/09,25,8,17,0,42
2451,2022/07/09,10,5,3,0,13
2475,2022/07/09,6,0,1,0,7
2476,2022/07/09,8,0,1,0,9
2507,2022/07/09,6,6,8,0,14
2525,2022/07/09,7,0,1,0,8
2562,2022/07/09,12,8,4,0,16
2582,2022/07/09,6,0,2,0,8
2586,2022/07/09,19,12,10,0,29
2602,2022/07/09,5,0,0,0,5
2631,2022/07/09,11,6,2,0,13
2685,2022/07/09,15,8,1,0,16
2730,2022/07/09,0,0,1,0,1
2731,2022/07/09,7,0,0,0,7
2732,2022/07/09,9,0,1,0,10
2734,2022/07/09,7,0,0,0,7
2735,2022/07/09,13,0,3,0,16
2761,2022/07/09,15,5,12,0,27
2788,2022/07/09,9,12,10,0,19
2812,2022/07/09,7,0,0,0,7
2813,2022/07/09,6,0,0,0,6
2814,2022/07/09,9,0,1,0,10
2913,2022/07/09,5,0,3,0,8
2914,2022/07/09,5,0,0,0,5
3015,2022/07/09,5,0,0,0,5
3035,2022/07/09,7,0,1,0,8
4446,2022/07/09,18,12,6,0,24
12136,2022/07/09,19,12,14,2,33
12516,2022/07/09,6,0,0,0,6
12518,2022/07/09,10,0,3,0,13
12523,2022/07/09,7,0,3,0,10
16062,2022/07/09,9,0,2,0,11
16063,2022/07/09,10,0,5,0,15
19322,2022/07/09,4,0,1,0,5
19516,2022/07/09,24,8,3,0,27
19520,2022/07/09,11,0,0,0,11
75,2022/07/10,31,20,15,12,46
76,2022/07/10,27,28,15,6,42
99,2022/07/10,3,0,1,0,4
117,2022/07/10,4,0,3,0,7
118,2022/07/10,7,4,0,0,7
119,2022/07/10,7,4,1,1,8
120,2022/07/10,4,0,1,0,5
149,2022/07/10,11,6,0,0,11
184,2022/07/10,12,0,5,0,17
195,2022/07/10,16,18,18,0,34
218,2022/07/10,11,18,9,0,20
296,2022/07/10,8,6,1,0,9
300,2022/07/10,10,0,3,0,13
304,2022/07/10,11,6,3,0,14
317,2022/07/10,28,16,16,0,44
343,2022/07/10,0,0,0,0,0
373,2022/07/10,25,8,4,0,29
374,2022/07/10,11,8,2,0,13
388,2022/07/10,6,6,8,0,14
419,2022/07/10,29,16,15,0,44
420,2022/07/10,23,16,9,0,32
462,2022/07/10,12,0,2,0,14
519,2022/07/10,14,0,5,0,19
525,2022/07/10,0,0,0,0,0
596,2022/07/10,4,4,3,0,7
597,2022/07/10,16,6,3,3,19
598,2022/07/10,8,0,2,0,10
1035,2022/07/10,6,0,2,0,8
1084,2022/07/10,16,5,11,0,27
1111,2022/07/10,6,6,0,0,6
1113,2022/07/10,9,0,1,0,10
1114,2022/07/10,6,0,0,0,6
1115,2022/07/10,4,0,2,0,6
1117,2022/07/10,8,0,0,0,8
1118,2022/07/10,4,0,2,0,6
1119,2022/07/10,8,0,1,0,9
1692,2022/07/10,24,0,3,0,27
1693,2022/07/10,14,8,7,0,21
1747,2022/07/10,19,15,13,0,32
1772,2022/07/10,7,0,0,0,7
1773,2022/07/10,11,0,2,0,13
1774,2022/07/10,5,0,0,0,5
1782,2022/07/10,15,9,3,2,18
1795,2022/07/10,25,0,4,0,29
1914,2022/07/10,8,0,0,0,8
1915,2022/07/10,5,0,0,0,5
1923,2022/07/10,8,6,0,0,8
1934,2022/07/10,9,0,1,0,10
1963,2022/07/10,27,16,12,0,39
1984,2022/07/10,5,0,2,0,7
2135,2022/07/10,4,0,3,0,7
2136,2022/07/10,5,0,0,0,5
2148,2022/07/10,10,4,0,0,10
2183,2022/07/10,13,6,3,0,16
2193,2022/07/10,14,9,10,0,24
2237,2022/07/10,3,0,2,0,5
2358,2022/07/10,12,8,5,0,17
2361,2022/07/10,4,0,0,0,4
2445,2022/07/10,8,6,3,0,11
2449,2022/07/10,16,8,6,0,22
2451,2022/07/10,22,15,3,0,25
2475,2022/07/10,5,0,0,0,5
2476,2022/07/10,7,0,2,0,9
2507,2022/07/10,-2,0,2,0,0
2525,2022/07/10,6,0,5,0,11
2562,2022/07/10,24,16,7,0,31
2582,2022/07/10,4,0,1,0,5
2586,2022/07/10,17,8,6,4,23
2602,2022/07/10,5,0,2,0,7
2631,2022/07/10,9,0,1,0,10
2685,2022/07/10,14,0,2,0,16
2723,2022/07/10,12,0,1,0,13
2731,2022/07/10,13,6,1,0,14
2732,2022/07/10,8,0,0,0,8
2734,2022/07/10,15,8,0,0,15
2735,2022/07/10,10,0,0,0,10
2761,2022/07/10,18,15,5,0,23
2788,2022/07/10,11,12,10,2,21
2812,2022/07/10,7,0,1,0,8
2813,2022/07/10,6,0,0,0,6
2814,2022/07/10,8,0,0,0,8
2913,2022/07/10,8,6,0,0,8
2914,2022/07/10,5,0,1,0,6
3015,2022/07/10,5,0,1,0,6
3035,2022/07/10,6,0,2,0,8
4446,2022/07/10,18,6,7,2,25
12136,2022/07/10,18,15,4,2,22
12516,2022/07/10,10,4,1,0,11
12518,2022/07/10,7,0,2,0,9
12523,2022/07/10,8,4,3,0,11
16062,2022/07/10,7,0,0,0,7
16063,2022/07/10,11,6,0,0,11
19322,2022/07/10,3,0,0,0,3
19516,2022/07/10,29,8,10,0,39
19520,2022/07/10,11,0,0,0,11
75,2022/07/11,40,36,25,1,65
76,2022/07/11,42,36,33,8,75
99,2022/07/11,2,0,0,0,2
117,2022/07/11,1,0,1,0,2
118,2022/07/11,7,0,6,0,13
119,2022/07/11,5,0,0,0,5
120,2022/07/11,7,4,0,0,7
149,2022/07/11,11,0,0,0,11
184,2022/07/11,13,6,5,0,18
195,2022/07/11,28,30,30,0,58
218,2022/07/11,26,24,15,6,41
296,2022/07/11,13,6,4,0,17
300,2022/07/11,15,8,5,0,20
304,2022/07/11,14,6,4,0,18
317,2022/07/11,28,16,21,2,49
343,2022/07/11,4,4,1,0,5
373,2022/07/11,21,0,9,1,30
374,2022/07/11,9,0,2,0,11
388,2022/07/11,22,24,11,2,33
419,2022/07/11,30,16,19,0,49
420,2022/07/11,14,0,10,0,24
462,2022/07/11,18,8,5,0,23
519,2022/07/11,15,6,7,0,22
525,2022/07/11,0,0,0,0,0
596,2022/07/11,5,4,3,0,8
597,2022/07/11,16,6,5,3,21
598,2022/07/11,12,6,0,0,12
1035,2022/07/11,10,6,1,0,11
1084,2022/07/11,10,5,3,2,13
1111,2022/07/11,6,0,0,0,6
1113,2022/07/11,8,0,0,0,8
1114,2022/07/11,6,0,0,0,6
1115,2022/07/11,8,6,1,0,9
1117,2022/07/11,8,0,0,0,8
1118,2022/07/11,8,6,0,0,8
1119,2022/07/11,7,0,0,0,7
1692,2022/07/11,21,0,2,0,23
1693,2022/07/11,15,8,14,0,29
1747,2022/07/11,31,25,16,0,47
1772,2022/07/11,7,0,0,0,7
1773,2022/07/11,9,0,1,0,10
1774,2022/07/11,5,0,1,0,6
1782,2022/07/11,28,18,5,3,33
1795,2022/07/11,28,7,6,0,34
1914,2022/07/11,8,0,0,0,8
1915,2022/07/11,5,0,0,0,5
1923,2022/07/11,8,0,0,0,8
1934,2022/07/11,14,5,2,0,16
1963,2022/07/11,31,16,19,1,50
1984,2022/07/11,9,6,0,0,9
2135,2022/07/11,1,0,0,0,1
2136,2022/07/11,5,0,0,0,5
2148,2022/07/11,10,0,2,0,12
2183,2022/07/11,10,0,0,0,10
2193,2022/07/11,19,15,3,0,22
2237,2022/07/11,7,6,2,0,9
2358,2022/07/11,7,0,6,0,13
2361,2022/07/11,11,7,3,0,14
2445,2022/07/11,11,6,2,0,13
2449,2022/07/11,26,16,12,0,38
2451,2022/07/11,19,0,5,0,24
2475,2022/07/11,5,0,0,0,5
2476,2022/07/11,5,0,0,0,5
2507,2022/07/11,8,12,2,0,10
2525,2022/07/11,1,0,1,0,2
2562,2022/07/11,25,8,7,0,32
2582,2022/07/11,3,0,1,0,4
2586,2022/07/11,23,16,12,2,35
2602,2022/07/11,11,8,3,0,14
2631,2022/07/11,14,6,3,0,17
2685,2022/07/11,16,4,5,0,21
2723,2022/07/11,11,0,0,0,11
2731,2022/07/11,12,0,0,0,12
2732,2022/07/11,8,0,0,0,8
2734,2022/07/11,15,0,1,0,16
2735,2022/07/11,10,0,1,3,11
2761,2022/07/11,28,15,11,0,39
2788,2022/07/11,11,12,6,1,17
2812,2022/07/11,6,0,1,0,7
2813,2022/07/11,6,0,0,0,6
2814,2022/07/11,8,0,1,0,9
2913,2022/07/11,8,0,0,0,8
2914,2022/07/11,4,0,0,0,4
3015,2022/07/11,4,0,0,0,4
3035,2022/07/11,4,0,0,0,4
4446,2022/07/11,21,12,5,5,26
12136,2022/07/11,33,21,12,6,45
12516,2022/07/11,9,0,1,0,10
12518,2022/07/11,5,0,1,0,6
12523,2022/07/11,5,0,2,0,7
16062,2022/07/11,7,0,0,0,7
16063,2022/07/11,11,0,0,0,11
19322,2022/07/11,3,0,0,0,3
19516,2022/07/11,19,0,8,0,27
19520,2022/07/11,11,0,0,0,11
75,2022/07/12,54,40,29,10,83
76,2022/07/12,37,36,26,9,63
99,2022/07/12,14,12,3,0,17
117,2022/07/12,4,4,1,0,5
118,2022/07/12,5,4,0,0,5
119,2022/07/12,5,0,2,0,7
120,2022/07/12,7,0,1,0,8
149,2022/07/12,11,0,1,0,12
184,2022/07/12,17,9,6,0,23
195,2022/07/12,28,30,21,1,49
218,2022/07/12,23,18,21,7,44
296,2022/07/12,15,6,4,0,19
300,2022/07/12,10,0,2,0,12
304,2022/07/12,10,0,0,0,10
317,2022/07/12,21,16,19,0,40
343,2022/07/12,7,4,1,0,8
373,2022/07/12,27,16,10,0,37
374,2022/07/12,15,8,3,0,18
388,2022/07/12,33,24,15,13,48
419,2022/07/12,27,16,12,0,39
420,2022/07/12,12,8,9,0,21
462,2022/07/12,13,0,5,0,18
519,2022/07/12,8,0,1,0,9
525,2022/07/12,5,5,3,0,8
596,2022/07/12,2,0,0,0,2
597,2022/07/12,20,12,7,3,27
598,2022/07/12,12,0,0,0,12
1035,2022/07/12,15,6,3,0,18
1084,2022/07/12,10,5,5,0,15
1111,2022/07/12,12,6,0,0,12
1113,2022/07/12,8,0,0,0,8
1114,2022/07/12,12,6,1,0,13
1115,2022/07/12,7,0,0,0,7
1117,2022/07/12,8,0,0,0,8
1118,2022/07/12,14,6,0,0,14
1119,2022/07/12,7,0,2,0,9
1692,2022/07/12,27,8,6,0,33
1693,2022/07/12,1,0,3,0,4
1747,2022/07/12,25,10,20,0,45
1772,2022/07/12,7,0,1,0,8
1773,2022/07/12,8,0,2,0,10
1774,2022/07/12,12,8,1,0,13
1782,2022/07/12,38,18,10,4,48
1795,2022/07/12,36,14,13,1,49
1914,2022/07/12,8,0,0,0,8
1915,2022/07/12,11,6,0,0,11
1923,2022/07/12,8,0,1,0,9
1934,2022/07/12,11,0,8,0,19
1963,2022/07/12,27,16,12,0,39
1984,2022/07/12,15,6,0,0,15
2135,2022/07/12,7,6,0,0,7
2136,2022/07/12,11,6,0,0,11
2148,2022/07/12,12,4,2,0,14
2183,2022/07/12,16,6,3,0,19
2193,2022/07/12,28,12,13,5,41
2237,2022/07/12,5,0,0,0,5
2358,2022/07/12,9,8,4,0,13
2361,2022/07/12,15,7,3,0,18
2445,2022/07/12,15,6,5,0,20
2449,2022/07/12,14,0,9,0,23
2451,2022/07/12,14,0,4,0,18
2475,2022/07/12,5,0,0,0,5
2476,2022/07/12,5,0,0,0,5
2507,2022/07/12,18,12,7,0,25
2525,2022/07/12,6,6,0,0,6
2562,2022/07/12,26,8,9,0,35
2582,2022/07/12,6,4,2,0,8
2586,2022/07/12,21,12,11,5,32
2602,2022/07/12,8,0,0,0,8
2631,2022/07/12,17,6,0,0,17
2685,2022/07/12,15,4,6,2,21
2723,2022/07/12,11,0,0,0,11
2731,2022/07/12,12,0,1,0,13
2732,2022/07/12,8,0,0,0,8
2734,2022/07/12,14,0,3,0,17
2735,2022/07/12,6,0,1,0,7
2761,2022/07/12,27,10,6,0,33
2788,2022/07/12,20,16,14,5,34
2812,2022/07/12,5,0,0,0,5
2813,2022/07/12,6,0,0,0,6
2814,2022/07/12,7,0,0,0,7
2913,2022/07/12,8,0,1,0,9
2914,2022/07/12,4,0,0,0,4
3015,2022/07/12,4,0,0,0,4
3035,2022/07/12,4,0,0,0,4
4446,2022/07/12,14,3,3,1,17
12136,2022/07/12,36,21,15,8,51
12516,2022/07/12,8,0,0,0,8
12518,2022/07/12,4,0,2,0,6
12523,2022/07/12,7,4,1,0,8
16062,2022/07/12,7,0,1,0,8
16063,2022/07/12,11,0,0,0,11
19322,2022/07/12,9,6,0,0,9
19516,2022/07/12,19,8,6,0,25
19520,2022/07/12,11,0,0,0,11
75,2022/07/13,43,28,32,5,75
76,2022/07/13,34,32,38,1,72
99,2022/07/13,11,0,0,0,11
117,2022/07/13,3,0,2,0,5
118,2022/07/13,5,0,2,0,7
119,2022/07/13,7,4,0,0,7
120,2022/07/13,6,0,1,0,7
149,2022/07/13,10,0,1,0,11
184,2022/07/13,17,6,8,0,25
195,2022/07/13,33,27,29,2,62
218,2022/07/13,19,24,22,1,41
296,2022/07/13,17,6,4,0,21
300,2022/07/13,8,0,0,0,8
304,2022/07/13,16,6,3,0,19
317,2022/07/13,18,16,15,0,33
343,2022/07/13,6,0,7,0,13
373,2022/07/13,17,0,7,0,24
374,2022/07/13,12,0,4,0,16
388,2022/07/13,23,18,25,3,48
419,2022/07/13,31,16,18,0,49
420,2022/07/13,11,8,8,0,19
462,2022/07/13,16,8,5,1,21
519,2022/07/13,13,6,7,0,20
525,2022/07/13,2,0,1,0,3
596,2022/07/13,6,4,5,0,11
597,2022/07/13,16,6,10,0,26
598,2022/07/13,12,0,0,0,12
1035,2022/07/13,18,6,3,2,21
1084,2022/07/13,5,0,3,0,8
1111,2022/07/13,12,0,2,0,14
1112,2022/07/13,5,0,1,0,6
1113,2022/07/13,8,0,0,0,8
1114,2022/07/13,11,0,1,0,12
1115,2022/07/13,7,0,0,0,7
1117,2022/07/13,8,0,0,0,8
1118,2022/07/13,14,0,1,0,15
1119,2022/07/13,5,0,0,0,5
1692,2022/07/13,21,0,2,0,23
1693,2022/07/13,6,8,8,0,14
1747,2022/07/13,15,10,10,0,25
1772,2022/07/13,6,0,0,0,6
1773,2022/07/13,6,0,0,0,6
1774,2022/07/13,11,0,0,0,11
1782,2022/07/13,36,12,17,2,53
1795,2022/07/13,36,14,11,0,47
1914,2022/07/13,8,0,0,0,8
1915,2022/07/13,11,0,0,0,11
1923,2022/07/13,7,0,2,0,9
1934,2022/07/13,3,0,2,0,5
1963,2022/07/13,23,8,21,0,44
1984,2022/07/13,15,0,2,1,17
2135,2022/07/13,13,6,1,0,14
2136,2022/07/13,11,0,0,0,11
2148,2022/07/13,10,0,3,0,13
2183,2022/07/13,13,0,0,1,13
2193,2022/07/13,19,9,9,4,28
2237,2022/07/13,11,6,2,0,13
2358,2022/07/13,13,8,5,0,18
2361,2022/07/13,19,7,5,0,24
2445,2022/07/13,16,6,4,3,20
2449,2022/07/13,21,16,7,0,28
2451,2022/07/13,10,0,4,2,14
2475,2022/07/13,5,0,0,0,5
2476,2022/07/13,11,6,0,0,11
2507,2022/07/13,23,12,11,0,34
2525,2022/07/13,6,0,0,0,6
2562,2022/07/13,25,8,9,0,34
2582,2022/07/13,8,4,1,0,9
2586,2022/07/13,9,4,5,0,14
2602,2022/07/13,8,0,1,0,9
2631,2022/07/13,17,0,0,5,17
2685,2022/07/13,7,0,0,0,7
2723,2022/07/13,11,0,0,0,11
2731,2022/07/13,11,0,0,0,11
2732,2022/07/13,8,0,0,0,8
2734,2022/07/13,11,0,5,0,16
2735,2022/07/13,5,0,1,0,6
2761,2022/07/13,31,10,9,0,40
2788,2022/07/13,13,12,13,1,26
2812,2022/07/13,5,0,0,0,5
2813,2022/07/13,6,0,1,0,7
2814,2022/07/13,7,0,2,0,9
2913,2022/07/13,7,0,4,1,11
2914,2022/07/13,10,6,0,0,10
3015,2022/07/13,4,0,1,0,5
3035,2022/07/13,10,6,0,0,10
4446,2022/07/13,19,9,11,3,30
12136,2022/07/13,28,15,18,4,46
12516,2022/07/13,8,0,1,0,9
12518,2022/07/13,12,10,7,0,19
12523,2022/07/13,10,4,0,0,10
16062,2022/07/13,6,0,0,0,6
16063,2022/07/13,11,0,0,0,11
19322,2022/07/13,9,0,0,0,9
19516,2022/07/13,21,8,10,0,31
19520,2022/07/13,11,0,1,0,12
75,2022/07/14,38,32,34,0,72
76,2022/07/14,27,32,31,1,58
99,2022/07/14,11,0,0,0,11
117,2022/07/14,5,4,3,0,8
118,2022/07/14,7,4,3,0,10
119,2022/07/14,7,0,1,0,8
120,2022/07/14,9,4,1,2,10
149,2022/07/14,9,0,0,0,9
184,2022/07/14,18,9,11,2,29
195,2022/07/14,29,27,31,4,60
218,2022/07/14,11,15,18,0,29
296,2022/07/14,13,0,0,0,13
300,2022/07/14,8,0,7,0,15
304,2022/07/14,13,0,0,0,13
317,2022/07/14,11,8,18,0,29
343,2022/07/14,3,4,1,0,4
373,2022/07/14,18,8,10,0,28
374,2022/07/14,12,4,3,0,15
388,2022/07/14,13,18,18,0,31
419,2022/07/14,21,8,11,0,32
420,2022/07/14,3,0,0,0,3
462,2022/07/14,18,8,5,0,23
519,2022/07/14,12,6,3,0,15
525,2022/07/14,1,0,0,1,1
596,2022/07/14,9,8,3,0,12
597,2022/07/14,18,12,16,0,34
598,2022/07/14,12,0,2,0,14
1035,2022/07/14,19,6,8,0,27
1084,2022/07/14,12,10,7,0,19
1111,2022/07/14,10,0,1,0,11
1112,2022/07/14,4,0,0,0,4
1113,2022/07/14,8,0,0,0,8
1114,2022/07/14,10,0,2,0,12
1115,2022/07/14,7,0,1,0,8
1117,2022/07/14,8,0,0,0,8
1118,2022/07/14,13,0,1,0,14
1692,2022/07/14,19,0,0,0,19
1693,2022/07/14,-2,0,0,0,-2
1747,2022/07/14,20,15,19,1,39
1772,2022/07/14,6,0,0,0,6
1773,2022/07/14,6,0,0,0,6
1774,2022/07/14,11,0,3,0,14
1782,2022/07/14,32,15,23,6,55
1795,2022/07/14,25,0,15,0,40
1914,2022/07/14,8,0,0,0,8
1915,2022/07/14,11,0,0,0,11
1923,2022/07/14,5,0,1,0,6
1934,2022/07/14,6,5,3,0,9
1963,2022/07/14,18,16,11,0,29
1984,2022/07/14,12,0,2,0,14
2135,2022/07/14,12,0,4,0,16
2136,2022/07/14,11,0,1,0,12
2148,2022/07/14,7,0,1,0,8
2183,2022/07/14,12,0,2,0,14
2193,2022/07/14,24,18,8,3,32
2237,2022/07/14,9,0,2,0,11
2358,2022/07/14,8,0,5,0,13
2361,2022/07/14,14,0,4,0,18
2445,2022/07/14,9,0,3,0,12
2449,2022/07/14,22,8,7,0,29
2451,2022/07/14,9,5,5,0,14
2475,2022/07/14,5,0,1,0,6
2476,2022/07/14,11,0,1,0,12
2507,2022/07/14,24,12,9,0,33
2525,2022/07/14,6,0,2,0,8
2562,2022/07/14,24,8,8,0,32
2582,2022/07/14,0,0,0,0,0
2586,2022/07/14,16,12,18,0,34
2602,2022/07/14,7,0,0,0,7
2631,2022/07/14,18,6,1,0,19
2685,2022/07/14,7,0,0,0,7
2723,2022/07/14,11,0,0,0,11
2731,2022/07/14,11,0,1,0,12
2732,2022/07/14,8,0,1,0,9
2734,2022/07/14,6,0,1,0,7
2735,2022/07/14,4,0,1,0,5
2761,2022/07/14,37,15,10,4,47
2788,2022/07/14,15,16,14,5,29
2812,2022/07/14,5,0,1,0,6
2813,2022/07/14,5,0,0,0,5
2814,2022/07/14,5,0,0,0,5
2913,2022/07/14,8,6,3,0,11
2914,2022/07/14,10,0,0,0,10
3015,2022/07/14,3,0,2,0,5
3033,2022/07/14,5,0,1,0,6
3035,2022/07/14,10,0,0,0,10
4446,2022/07/14,14,9,12,0,26
12136,2022/07/14,15,9,11,0,26
12516,2022/07/14,7,0,1,0,8
12518,2022/07/14,5,0,1,0,6
12523,2022/07/14,14,4,4,0,18
16062,2022/07/14,6,0,0,0,6
16063,2022/07/14,11,0,0,0,11
19322,2022/07/14,9,0,0,0,9
19516,2022/07/14,11,0,4,0,15
19520,2022/07/14,10,0,1,0,11
75,2022/07/15,32,28,34,0,66
76,2022/07/15,31,36,31,0,62
99,2022/07/15,11,0,1,0,12
117,2022/07/15,6,4,0,0,6
118,2022/07/15,8,4,3,0,11
119,2022/07/15,6,0,2,2,8
120,2022/07/15,6,0,2,0,8
149,2022/07/15,9,0,0,0,9
184,2022/07/15,20,15,10,0,30
195,2022/07/15,24,30,32,0,56
218,2022/07/15,14,21,22,0,36
296,2022/07/15,13,0,3,0,16
300,2022/07/15,9,8,0,0,9
304,2022/07/15,19,6,5,0,24
317,2022/07/15,9,16,7,0,16
343,2022/07/15,6,4,3,0,9
373,2022/07/15,16,8,4,0,20
374,2022/07/15,9,0,5,0,14
388,2022/07/15,4,9,10,0,14
419,2022/07/15,26,16,11,0,37
420,2022/07/15,11,8,5,0,16
462,2022/07/15,13,0,3,0,16
519,2022/07/15,15,6,8,0,23
525,2022/07/15,5,5,3,0,8
596,2022/07/15,14,8,6,1,20
597,2022/07/15,26,24,18,2,44
598,2022/07/15,10,0,1,0,11
1035,2022/07/15,11,0,3,1,14
1084,2022/07/15,20,15,9,0,29
1111,2022/07/15,9,0,0,0,9
1112,2022/07/15,4,0,0,0,4
1113,2022/07/15,8,0,1,0,9
1114,2022/07/15,8,0,2,0,10
1115,2022/07/15,6,0,3,0,9
1117,2022/07/15,8,0,1,0,9
1118,2022/07/15,12,0,0,0,12
1692,2022/07/15,19,0,0,0,19
1693,2022/07/15,6,8,4,0,10
1747,2022/07/15,20,20,19,0,39
1772,2022/07/15,6,0,0,0,6
1773,2022/07/15,12,6,3,0,15
1774,2022/07/15,8,0,2,0,10
1782,2022/07/15,15,12,14,0,29
1795,2022/07/15,17,7,9,2,26
1914,2022/07/15,8,0,0,0,8
1915,2022/07/15,11,0,3,0,14
1923,2022/07/15,10,6,1,0,11
1934,2022/07/15,3,0,1,0,4
1963,2022/07/15,23,16,8,0,31
1984,2022/07/15,10,0,5,0,15
2135,2022/07/15,8,0,2,0,10
2136,2022/07/15,10,0,0,0,10
2148,2022/07/15,6,0,4,0,10
2183,2022/07/15,10,0,5,0,15
2193,2022/07/15,16,3,15,1,31
2237,2022/07/15,7,0,3,0,10
2358,2022/07/15,11,8,5,0,16
2361,2022/07/15,10,0,3,0,13
2445,2022/07/15,12,6,6,0,18
2449,2022/07/15,23,8,5,0,28
2451,2022/07/15,9,5,4,0,13
2475,2022/07/15,4,0,0,0,4
2476,2022/07/15,10,0,1,0,11
2507,2022/07/15,21,6,6,0,27
2525,2022/07/15,4,0,1,0,5
2562,2022/07/15,16,0,10,0,26
2582,2022/07/15,0,0,0,0,0
2586,2022/07/15,14,16,18,0,32
2602,2022/07/15,7,0,1,0,8
2631,2022/07/15,17,0,3,0,20
2685,2022/07/15,11,4,5,0,16
2723,2022/07/15,11,0,1,0,12
2731,2022/07/15,10,0,2,0,12
2732,2022/07/15,7,0,0,0,7
2734,2022/07/15,5,0,1,0,6
2735,2022/07/15,11,8,2,1,13
2761,2022/07/15,33,10,12,4,45
2788,2022/07/15,12,16,11,0,23
2812,2022/07/15,10,6,3,0,13
2814,2022/07/15,5,0,1,0,6
2913,2022/07/15,5,0,5,0,10
2914,2022/07/15,10,0,0,0,10
3015,2022/07/15,1,0,1,0,2
3033,2022/07/15,4,0,0,0,4
3035,2022/07/15,10,0,2,0,12
4446,2022/07/15,11,9,9,0,20
12136,2022/07/15,28,24,19,0,47
12516,2022/07/15,6,0,0,0,6
12518,2022/07/15,4,0,3,0,7
12523,2022/07/15,10,0,6,0,16
16062,2022/07/15,6,0,0,0,6
16063,2022/07/15,11,0,3,0,14
19322,2022/07/15,9,0,0,0,9
19516,2022/07/15,15,8,7,0,22
19520,2022/07/15,9,0,0,0,9
75,2022/07/16,18,20,23,0,41
76,2022/07/16,25,24,37,0,62
99,2022/07/16,10,0,0,0,10
117,2022/07/16,6,0,1,0,7
118,2022/07/16,5,0,3,0,8
119,2022/07/16,2,0,2,0,4
120,2022/07/16,4,0,2,0,6
149,2022/07/16,9,0,0,0,9
184,2022/07/16,16,6,11,0,27
195,2022/07/16,16,24,29,0,45
218,2022/07/16,7,15,20,0,27
296,2022/07/16,16,6,6,0,22
300,2022/07/16,9,0,1,0,10
304,2022/07/16,14,0,1,0,15
317,2022/07/16,18,16,5,0,23
343,2022/07/16,3,0,1,0,4
373,2022/07/16,12,0,0,2,12
374,2022/07/16,4,0,3,0,7
388,2022/07/16,12,18,18,0,30
419,2022/07/16,15,0,5,0,20
420,2022/07/16,14,8,3,0,17
462,2022/07/16,10,0,5,0,15
519,2022/07/16,13,6,6,0,19
525,2022/07/16,2,0,3,0,5
596,2022/07/16,7,0,7,0,14
597,2022/07/16,6,0,10,0,16
598,2022/07/16,9,0,1,0,10
1035,2022/07/16,13,6,7,0,20
1084,2022/07/16,11,0,10,0,21
1111,2022/07/16,9,0,4,0,13
1112,2022/07/16,10,6,0,0,10
1113,2022/07/16,7,0,1,0,8
1114,2022/07/16,6,0,0,0,6
1115,2022/07/16,9,6,2,0,11
1117,2022/07/16,7,0,0,0,7
1118,2022/07/16,12,0,0,0,12
1119,2022/07/16,5,0,0,0,5
1692,2022/07/16,27,8,2,0,29
1693,2022/07/16,10,8,1,0,11
1747,2022/07/16,16,15,18,0,34
1772,2022/07/16,6,0,1,0,7
1773,2022/07/16,9,0,1,0,10
1774,2022/07/16,6,0,2,0,8
1782,2022/07/16,16,15,20,0,36
1795,2022/07/16,27,21,14,0,41
1914,2022/07/16,8,0,1,0,9
1915,2022/07/16,8,0,4,0,12
1923,2022/07/16,9,0,2,0,11
1934,2022/07/16,7,5,4,0,11
1963,2022/07/16,23,8,11,0,34
1984,2022/07/16,5,0,1,0,6
2135,2022/07/16,6,0,4,0,10
2136,2022/07/16,10,0,2,0,12
2148,2022/07/16,2,0,1,0,3
2183,2022/07/16,11,6,4,0,15
2193,2022/07/16,9,9,8,0,17
2237,2022/07/16,10,6,3,0,13
2358,2022/07/16,6,0,3,0,9
2361,2022/07/16,14,7,8,0,22
2445,2022/07/16,6,0,5,0,11
2449,2022/07/16,26,8,5,0,31
2451,2022/07/16,10,5,8,0,18
2475,2022/07/16,4,0,0,0,4
2476,2022/07/16,9,0,1,0,10
2507,2022/07/16,15,0,19,0,34
2525,2022/07/16,9,6,1,0,10
2562,2022/07/16,6,0,7,0,13
2582,2022/07/16,4,4,4,0,8
2586,2022/07/16,8,12,15,0,23
2602,2022/07/16,6,0,0,0,6
2631,2022/07/16,14,0,5,0,19
2685,2022/07/16,14,8,6,0,20
2723,2022/07/16,10,0,1,0,11
2731,2022/07/16,8,0,4,0,12
2732,2022/07/16,7,0,0,0,7
2734,2022/07/16,4,0,0,0,4
2735,2022/07/16,8,0,5,0,13
2761,2022/07/16,22,5,17,1,39
2788,2022/07/16,13,12,22,1,35
2812,2022/07/16,7,0,0,0,7
2814,2022/07/16,10,6,1,0,11
2913,2022/07/16,0,0,0,0,0
2914,2022/07/16,10,0,1,0,11
3015,2022/07/16,8,8,1,0,9
3033,2022/07/16,4,0,1,0,5
3035,2022/07/16,8,0,0,0,8
4446,2022/07/16,8,6,7,0,15
12136,2022/07/16,24,15,24,0,48
12516,2022/07/16,6,0,3,0,9
12518,2022/07/16,1,0,0,0,1
12523,2022/07/16,4,0,3,0,7
16062,2022/07/16,12,6,0,0,12
16063,2022/07/16,8,0,0,0,8
19322,2022/07/16,9,0,1,0,10
19516,2022/07/16,16,8,5,0,21
19520,2022/07/16,9,0,0,0,9
75,2022/07/17,15,20,14,0,29
76,2022/07/17,3,16,7,0,10
99,2022/07/17,10,0,0,0,10
117,2022/07/17,5,0,2,0,7
118,2022/07/17,6,4,5,0,11
119,2022/07/17,4,4,1,0,5
120,2022/07/17,2,0,2,0,4
149,2022/07/17,9,0,0,0,9
184,2022/07/17,8,3,5,0,13
195,2022/07/17,5,18,15,0,20
218,2022/07/17,-1,12,5,0,4
296,2022/07/17,10,0,5,0,15
300,2022/07/17,8,0,3,0,11
304,2022/07/17,13,0,5,0,18
317,2022/07/17,29,16,11,0,40
343,2022/07/17,6,4,3,0,9
373,2022/07/17,18,8,11,0,29
374,2022/07/17,13,12,5,0,18
388,2022/07/17,12,18,16,0,28
419,2022/07/17,26,16,15,0,41
420,2022/07/17,27,16,13,0,40
462,2022/07/17,13,8,6,0,19
519,2022/07/17,13,6,6,0,19
525,2022/07/17,4,5,0,0,4
596,2022/07/17,4,4,1,0,5
597,2022/07/17,2,6,5,0,7
598,2022/07/17,8,0,2,0,10
1035,2022/07/17,6,0,3,0,9
1084,2022/07/17,6,5,4,0,10
1111,2022/07/17,5,0,1,0,6
1112,2022/07/17,10,0,2,0,12
1113,2022/07/17,6,0,0,0,6
1114,2022/07/17,6,0,0,0,6
1115,2022/07/17,7,0,0,0,7
1117,2022/07/17,7,0,1,0,8
1118,2022/07/17,12,0,3,0,15
1119,2022/07/17,5,0,0,0,5
1692,2022/07/17,25,0,5,0,30
1693,2022/07/17,17,8,8,0,25
1747,2022/07/17,13,15,13,0,26
1772,2022/07/17,5,0,0,0,5
1773,2022/07/17,8,0,0,0,8
1774,2022/07/17,4,0,1,0,5
1782,2022/07/17,5,9,4,0,9
1795,2022/07/17,13,0,9,0,22
1914,2022/07/17,7,0,0,0,7
1915,2022/07/17,4,0,0,0,4
1923,2022/07/17,7,0,3,0,10
1934,2022/07/17,3,0,1,0,4
1963,2022/07/17,28,16,21,0,49
1984,2022/07/17,4,0,3,6,7
2135,2022/07/17,8,6,4,0,12
2136,2022/07/17,8,0,1,0,9
2148,2022/07/17,9,8,1,0,10
2183,2022/07/17,7,0,5,0,12
2193,2022/07/17,13,12,8,0,21
2237,2022/07/17,7,0,2,0,9
2358,2022/07/17,19,16,1,0,20
2361,2022/07/17,6,0,1,0,7
2445,2022/07/17,7,6,3,0,10
2449,2022/07/17,29,8,6,0,35
2451,2022/07/17,12,10,5,0,17
2475,2022/07/17,4,0,1,0,5
2476,2022/07/17,8,0,3,0,11
2507,2022/07/17,8,12,13,0,21
2525,2022/07/17,8,0,1,0,9
2562,2022/07/17,15,16,9,1,24
2582,2022/07/17,0,0,1,0,1
2586,2022/07/17,-3,4,0,0,-3
2602,2022/07/17,6,0,2,0,8
2631,2022/07/17,9,0,2,5,11
2685,2022/07/17,8,0,1,0,9
2723,2022/07/17,9,0,1,0,10
2731,2022/07/17,4,0,1,0,5
2732,2022/07/17,7,0,0,0,7
2734,2022/07/17,12,8,0,0,12
2735,2022/07/17,3,0,2,0,5
2761,2022/07/17,4,0,0,0,4
2788,2022/07/17,2,12,5,0,7
2812,2022/07/17,7,0,0,0,7
2814,2022/07/17,9,0,0,0,9
2913,2022/07/17,6,6,0,0,6
2914,2022/07/17,9,0,0,0,9
3015,2022/07/17,7,0,1,0,8
3033,2022/07/17,3,0,0,0,3
3035,2022/07/17,8,0,1,0,9
4446,2022/07/17,7,6,4,1,11
12136,2022/07/17,12,12,8,0,20
12516,2022/07/17,7,4,1,0,8
12518,2022/07/17,11,10,1,0,12
12523,2022/07/17,5,4,1,0,6
16062,2022/07/17,12,0,1,0,13
16063,2022/07/17,8,0,1,0,9
19322,2022/07/17,8,0,0,0,8
19516,2022/07/17,19,8,4,0,23
19520,2022/07/17,9,0,0,0,9
75,2022/07/18,33,32,36,0,69
76,2022/07/18,32,36,34,0,66
99,2022/07/18,10,0,0,0,10
117,2022/07/18,11,8,1,0,12
118,2022/07/18,9,8,2,0,11
119,2022/07/18,3,0,0,0,3
120,2022/07/18,4,4,0,0,4
149,2022/07/18,9,0,0,0,9
184,2022/07/18,12,9,4,0,16
195,2022/07/18,22,30,26,0,48
218,2022/07/18,18,24,13,0,31
296,2022/07/18,5,0,4,0,9
300,2022/07/18,13,8,1,0,14
304,2022/07/18,8,0,6,0,14
317,2022/07/18,42,24,19,0,61
343,2022/07/18,3,0,4,0,7
373,2022/07/18,15,8,7,1,22
374,2022/07/18,8,0,2,0,10
388,2022/07/18,17,21,19,0,36
419,2022/07/18,27,16,15,0,42
420,2022/07/18,14,0,4,0,18
462,2022/07/18,7,0,4,1,11
519,2022/07/18,7,0,0,0,7
525,2022/07/18,4,0,1,0,5
596,2022/07/18,7,4,4,0,11
597,2022/07/18,3,6,8,0,11
598,2022/07/18,6,0,0,0,6
1035,2022/07/18,9,6,6,0,15
1084,2022/07/18,2,0,1,0,3
1111,2022/07/18,4,0,1,0,5
1112,2022/07/18,8,0,0,0,8
1113,2022/07/18,6,0,0,0,6
1114,2022/07/18,12,6,1,0,13
1115,2022/07/18,7,0,0,0,7
1117,2022/07/18,6,0,0,0,6
1118,2022/07/18,9,0,1,0,10
1119,2022/07/18,11,6,0,0,11
1692,2022/07/18,20,0,1,0,21
1693,2022/07/18,17,8,12,0,29
1747,2022/07/18,15,15,8,0,23
1772,2022/07/18,5,0,0,0,5
1773,2022/07/18,14,6,0,0,14
1774,2022/07/18,11,8,1,0,12
1782,2022/07/18,22,21,11,0,33
1795,2022/07/18,12,7,6,0,18
1914,2022/07/18,7,0,0,0,7
1915,2022/07/18,4,0,0,0,4
1923,2022/07/18,4,0,0,0,4
1934,2022/07/18,7,5,2,0,9
1963,2022/07/18,23,16,17,0,40
1984,2022/07/18,-5,0,0,0,-5
2135,2022/07/18,4,0,2,0,6
2136,2022/07/18,7,0,0,0,7
2148,2022/07/18,8,0,4,0,12
2183,2022/07/18,8,6,1,0,9
2193,2022/07/18,14,9,5,0,19
2237,2022/07/18,5,0,1,0,6
2358,2022/07/18,18,0,7,0,25
2361,2022/07/18,5,0,0,2,5
2445,2022/07/18,4,0,1,0,5
2449,2022/07/18,31,8,11,0,42
2451,2022/07/18,7,0,4,0,11
2475,2022/07/18,3,0,0,1,3
2476,2022/07/18,5,0,1,0,6
2507,2022/07/18,1,6,3,0,4
2525,2022/07/18,7,0,0,0,7
2562,2022/07/18,13,8,7,0,20
2582,2022/07/18,-1,0,0,0,-1
2586,2022/07/18,13,16,15,0,28
2602,2022/07/18,12,8,3,0,15
2631,2022/07/18,2,0,2,0,4
2685,2022/07/18,7,0,0,0,7
2723,2022/07/18,8,0,0,0,8
2731,2022/07/18,3,0,1,0,4
2732,2022/07/18,7,0,0,0,7
2734,2022/07/18,12,0,1,0,13
2735,2022/07/18,1,0,2,0,3
2761,2022/07/18,14,10,12,0,26
2788,2022/07/18,13,16,16,0,29
2812,2022/07/18,7,0,0,0,7
2814,2022/07/18,9,0,0,0,9
2913,2022/07/18,6,0,0,0,6
2914,2022/07/18,9,0,0,0,9
3015,2022/07/18,6,0,0,0,6
3035,2022/07/18,7,0,0,0,7
4446,2022/07/18,14,12,10,0,24
12136,2022/07/18,22,18,16,0,38
12516,2022/07/18,6,0,2,0,8
12518,2022/07/18,10,0,2,0,12
12523,2022/07/18,4,0,2,0,6
16062,2022/07/18,11,0,0,0,11
16063,2022/07/18,13,6,0,0,13
19322,2022/07/18,8,0,0,0,8
19516,2022/07/18,23,8,8,0,31
19520,2022/07/18,9,0,0,0,9
75,2022/07/19,30,32,23,0,53
76,2022/07/19,35,36,33,2,68
99,2022/07/19,10,0,0,0,10
117,2022/07/19,10,0,0,0,10
118,2022/07/19,7,0,3,0,10
119,2022/07/19,7,4,3,0,10
120,2022/07/19,4,0,2,0,6
149,2022/07/19,9,0,0,0,9
184,2022/07/19,17,9,5,0,22
195,2022/07/19,24,30,26,0,50
218,2022/07/19,26,21,16,9,42
296,2022/07/19,7,6,2,0,9
300,2022/07/19,12,0,2,0,14
304,2022/07/19,8,6,1,0,9
317,2022/07/19,39,16,8,1,47
343,2022/07/19,7,8,1,0,8
373,2022/07/19,23,16,6,0,29
374,2022/07/19,6,0,0,0,6
388,2022/07/19,14,15,11,2,25
419,2022/07/19,28,16,9,0,37
420,2022/07/19,18,8,9,0,27
462,2022/07/19,10,8,4,0,14
519,2022/07/19,13,6,3,0,16
525,2022/07/19,3,0,1,0,4
596,2022/07/19,7,4,2,0,9
597,2022/07/19,7,12,4,0,11
598,2022/07/19,6,0,1,3,7
1035,2022/07/19,9,6,7,0,16
1084,2022/07/19,11,10,7,0,18
1111,2022/07/19,9,6,0,0,9
1112,2022/07/19,8,0,0,0,8
1113,2022/07/19,12,6,1,0,13
1114,2022/07/19,11,0,3,0,14
1115,2022/07/19,13,6,1,0,14
1117,2022/07/19,6,0,1,0,7
1118,2022/07/19,8,0,0,0,8
1119,2022/07/19,11,0,0,0,11
1692,2022/07/19,19,0,0,0,19
1693,2022/07/19,5,0,5,0,10
1747,2022/07/19,22,15,10,0,32
1772,2022/07/19,5,0,0,0,5
1773,2022/07/19,14,0,0,0,14
1774,2022/07/19,10,0,5,0,15
1782,2022/07/19,32,21,10,0,42
1795,2022/07/19,20,14,11,0,31
1914,2022/07/19,7,0,0,0,7
1915,2022/07/19,10,6,0,0,10
1923,2022/07/19,10,6,0,0,10
1934,2022/07/19,5,0,1,0,6
1963,2022/07/19,22,16,12,0,34
1984,2022/07/19,1,6,1,0,2
2135,2022/07/19,8,6,1,0,9
2136,2022/07/19,7,0,0,0,7
2148,2022/07/19,4,0,2,0,6
2183,2022/07/19,7,0,5,0,12
2193,2022/07/19,24,15,12,1,36
2237,2022/07/19,10,6,4,0,14
2358,2022/07/19,11,0,7,0,18
2361,2022/07/19,10,7,4,0,14
2445,2022/07/19,9,6,0,2,9
2449,2022/07/19,28,8,13,4,41
2451,2022/07/19,3,0,1,0,4
2475,2022/07/19,8,6,0,0,8
2476,2022/07/19,4,0,1,0,5
2507,2022/07/19,4,6,7,0,11
2525,2022/07/19,7,0,1,0,8
2562,2022/07/19,22,16,8,0,30
2582,2022/07/19,3,4,2,0,5
2586,2022/07/19,10,12,5,0,15
2602,2022/07/19,9,0,2,0,11
2631,2022/07/19,0,0,0,0,0
2685,2022/07/19,11,4,2,0,13
2723,2022/07/19,8,0,0,0,8
2731,2022/07/19,8,6,1,0,9
2732,2022/07/19,7,0,2,0,9
2734,2022/07/19,11,0,2,0,13
2735,2022/07/19,-1,0,0,0,-1
2761,2022/07/19,17,15,13,0,30
2788,2022/07/19,9,12,7,0,16
2812,2022/07/19,7,0,0,0,7
2814,2022/07/19,9,0,0,0,9
2913,2022/07/19,12,6,0,0,12
2914,2022/07/19,9,0,0,0,9
3015,2022/07/19,6,0,1,0,7
3035,2022/07/19,7,0,1,0,8
4446,2022/07/19,13,9,10,0,23
12136,2022/07/19,24,18,11,1,35
12516,2022/07/19,4,0,2,0,6
12518,2022/07/19,8,0,2,0,10
12523,2022/07/19,6,4,1,0,7
16062,2022/07/19,11,0,0,0,11
16063,2022/07/19,13,0,0,0,13
19322,2022/07/19,8,0,0,0,8
19516,2022/07/19,23,8,5,0,28
19520,2022/07/19,9,0,1,0,10
75,2022/07/20,42,36,29,2,71
76,2022/07/20,39,40,24,4,63
99,2022/07/20,10,0,1,0,11
117,2022/07/20,10,0,1,1,11
118,2022/07/20,4,0,2,0,6
119,2022/07/20,4,0,2,0,6
120,2022/07/20,6,4,0,0,6
149,2022/07/20,9,0,0,0,9
184,2022/07/20,21,9,5,0,26
195,2022/07/20,31,33,29,0,60
218,2022/07/20,22,21,20,3,42
296,2022/07/20,11,6,4,0,15
300,2022/07/20,10,0,1,0,11
304,2022/07/20,7,0,1,0,8
317,2022/07/20,41,8,12,0,53
343,2022/07/20,6,0,2,0,8
373,2022/07/20,25,8,4,0,29
374,2022/07/20,10,4,5,0,15
388,2022/07/20,24,24,15,3,39
419,2022/07/20,35,16,15,0,50
420,2022/07/20,17,8,5,0,22
462,2022/07/20,14,8,6,0,20
519,2022/07/20,16,6,1,0,17
525,2022/07/20,7,5,0,0,7
596,2022/07/20,13,8,2,0,15
597,2022/07/20,21,18,7,0,28
598,2022/07/20,8,6,5,0,13
1035,2022/07/20,8,6,2,0,10
1084,2022/07/20,9,5,9,0,18
1111,2022/07/20,9,0,0,0,9
1112,2022/07/20,8,0,0,0,8
1113,2022/07/20,11,0,0,0,11
1114,2022/07/20,8,0,1,0,9
1115,2022/07/20,12,0,3,0,15
1117,2022/07/20,5,0,0,0,5
1118,2022/07/20,8,0,1,0,9
1119,2022/07/20,11,0,0,0,11
1692,2022/07/20,19,0,0,0,19
1693,2022/07/20,8,8,6,0,14
1747,2022/07/20,32,20,16,0,48
1772,2022/07/20,5,0,0,0,5
1773,2022/07/20,14,0,0,0,14
1774,2022/07/20,5,0,0,0,5
1782,2022/07/20,37,15,18,6,55
1795,2022/07/20,22,14,12,0,34
1914,2022/07/20,7,0,0,0,7
1915,2022/07/20,10,0,1,0,11
1923,2022/07/20,10,0,0,0,10
1934,2022/07/20,9,5,2,0,11
1963,2022/07/20,26,16,18,0,44
1984,2022/07/20,0,0,2,0,2
2135,2022/07/20,7,0,1,0,8
2136,2022/07/20,7,0,0,0,7
2148,2022/07/20,6,4,4,0,10
2183,2022/07/20,2,0,1,0,3
2193,2022/07/20,23,12,9,4,32
2237,2022/07/20,6,0,0,0,6
2358,2022/07/20,12,8,7,0,19
2361,2022/07/20,13,7,10,0,23
2445,2022/07/20,13,6,0,0,13
2449,2022/07/20,11,0,7,0,18
2451,2022/07/20,2,0,2,0,4
2475,2022/07/20,8,0,0,0,8
2476,2022/07/20,9,6,2,0,11
2507,2022/07/20,15,18,8,0,23
2525,2022/07/20,6,0,1,0,7
2562,2022/07/20,22,8,14,1,36
2582,2022/07/20,1,0,1,0,2
2586,2022/07/20,17,12,16,0,33
2602,2022/07/20,7,0,1,0,8
2631,2022/07/20,6,6,3,0,9
2685,2022/07/20,17,8,10,0,27
2723,2022/07/20,8,0,0,0,8
2731,2022/07/20,7,0,1,0,8
2732,2022/07/20,5,0,0,0,5
2734,2022/07/20,9,0,0,0,9
2735,2022/07/20,8,8,1,0,9
2761,2022/07/20,14,10,10,0,24
2788,2022/07/20,14,12,12,6,26
2812,2022/07/20,7,0,0,0,7
2814,2022/07/20,9,0,1,0,10
2913,2022/07/20,12,0,0,0,12
2914,2022/07/20,9,0,0,0,9
3015,2022/07/20,5,0,0,0,5
3033,2022/07/20,9,0,0,0,9
3035,2022/07/20,6,0,0,0,6
4446,2022/07/20,15,12,9,0,24
12136,2022/07/20,36,24,18,5,54
12516,2022/07/20,6,4,0,0,6
12518,2022/07/20,16,10,4,0,20
12523,2022/07/20,9,4,3,0,12
16062,2022/07/20,11,0,1,0,12
16063,2022/07/20,13,0,1,0,14
19322,2022/07/20,8,0,1,0,9
19516,2022/07/20,26,8,6,0,32
19520,2022/07/20,8,0,2,0,10
75,2022/07/21,46,36,35,6,81
76,2022/07/21,55,40,38,8,93
99,2022/07/21,9,0,1,0,10
117,2022/07/21,8,0,0,0,8
118,2022/07/21,9,8,3,0,12
119,2022/07/21,2,0,2,0,4
120,2022/07/21,6,0,5,0,11
149,2022/07/21,9,0,0,0,9
184,2022/07/21,22,9,7,0,29
195,2022/07/21,43,33,26,5,69
218,2022/07/21,25,21,20,0,45
296,2022/07/21,13,6,3,0,16
300,2022/07/21,17,8,6,0,23
304,2022/07/21,12,6,5,0,17
317,2022/07/21,45,16,7,1,52
343,2022/07/21,12,8,2,0,14
373,2022/07/21,29,8,4,0,33
374,2022/07/21,9,4,4,0,13
388,2022/07/21,32,21,24,8,56
419,2022/07/21,28,8,6,0,34
420,2022/07/21,20,8,10,0,30
462,2022/07/21,16,8,9,0,25
519,2022/07/21,21,6,1,0,22
525,2022/07/21,7,0,1,0,8
596,2022/07/21,11,0,2,2,13
597,2022/07/21,29,12,9,0,38
598,2022/07/21,3,0,0,0,3
1035,2022/07/21,6,0,1,0,7
1084,2022/07/21,9,10,9,0,18
1111,2022/07/21,9,0,1,0,10
1112,2022/07/21,8,0,0,0,8
1113,2022/07/21,11,0,0,0,11
1114,2022/07/21,7,0,1,0,8
1115,2022/07/21,9,0,2,0,11
1117,2022/07/21,5,0,1,0,6
1118,2022/07/21,7,0,1,0,8
1692,2022/07/21,27,8,5,0,32
1693,2022/07/21,10,8,4,0,14
1747,2022/07/21,23,15,23,0,46
1772,2022/07/21,5,0,0,0,5
1773,2022/07/21,14,0,2,0,16
1774,2022/07/21,5,0,2,0,7
1782,2022/07/21,35,21,11,0,46
1795,2022/07/21,21,14,11,0,32
1914,2022/07/21,7,0,0,0,7
1915,2022/07/21,9,0,0,0,9
1923,2022/07/21,10,0,0,0,10
1934,2022/07/21,11,5,6,0,17
1963,2022/07/21,24,16,14,0,38
1984,2022/07/21,-2,0,0,0,-2
2135,2022/07/21,12,6,1,0,13
2136,2022/07/21,7,0,0,0,7
2148,2022/07/21,2,0,0,0,2
2183,2022/07/21,7,6,2,0,9
2193,2022/07/21,18,12,13,2,31
2237,2022/07/21,6,0,0,0,6
2358,2022/07/21,5,0,4,0,9
2361,2022/07/21,3,0,1,0,4
2445,2022/07/21,19,6,3,2,22
2449,2022/07/21,12,8,5,0,17
2451,2022/07/21,10,10,7,0,17
2475,2022/07/21,8,0,0,0,8
2476,2022/07/21,7,0,1,0,8
2507,2022/07/21,24,12,13,0,37
2525,2022/07/21,5,0,0,0,5
2562,2022/07/21,15,8,3,0,18
2582,2022/07/21,4,4,0,0,4
2586,2022/07/21,28,20,7,0,35
2602,2022/07/21,6,0,0,0,6
2631,2022/07/21,3,0,2,0,5
2685,2022/07/21,6,4,4,0,10
2723,2022/07/21,8,0,0,0,8
2731,2022/07/21,6,0,0,0,6
2732,2022/07/21,5,0,1,0,6
2734,2022/07/21,9,0,0,0,9
2735,2022/07/21,7,0,2,0,9
2761,2022/07/21,14,15,6,0,20
2788,2022/07/21,31,16,12,3,43
2812,2022/07/21,7,0,2,0,9
2814,2022/07/21,8,0,2,0,10
2913,2022/07/21,12,0,1,0,13
2914,2022/07/21,9,0,0,0,9
3015,2022/07/21,5,0,0,0,5
3033,2022/07/21,9,0,0,0,9
3035,2022/07/21,6,0,0,0,6
4446,2022/07/21,14,9,5,0,19
12136,2022/07/21,31,21,14,8,45
12516,2022/07/21,6,0,0,0,6
12518,2022/07/21,12,0,5,0,17
12523,2022/07/21,10,4,4,0,14
16062,2022/07/21,10,0,0,0,10
16063,2022/07/21,12,0,0,0,12
19322,2022/07/21,7,0,0,0,7
19516,2022/07/21,28,8,8,0,36
19520,2022/07/21,6,0,1,0,7
75,2022/07/22,41,36,37,0,78
76,2022/07/22,45,36,41,0,86
99,2022/07/22,8,0,1,0,9
117,2022/07/22,8,0,3,0,11
118,2022/07/22,6,0,1,0,7
119,2022/07/22,0,0,0,0,0
120,2022/07/22,1,0,1,0,2
149,2022/07/22,9,0,1,0,10
184,2022/07/22,21,6,5,6,26
195,2022/07/22,44,33,30,0,74
218,2022/07/22,26,21,23,0,49
296,2022/07/22,10,0,5,0,15
300,2022/07/22,11,0,0,0,11
304,2022/07/22,7,0,2,0,9
317,2022/07/22,45,8,6,0,51
343,2022/07/22,10,0,2,0,12
373,2022/07/22,33,8,4,0,37
374,2022/07/22,9,4,3,0,12
388,2022/07/22,18,18,16,1,34
419,2022/07/22,30,8,6,0,36
420,2022/07/22,10,0,5,0,15
462,2022/07/22,7,0,4,0,11
519,2022/07/22,26,6,9,0,35
525,2022/07/22,11,5,2,0,13
596,2022/07/22,15,8,2,0,17
597,2022/07/22,44,24,8,0,52
598,2022/07/22,3,0,1,0,4
1035,2022/07/22,17,12,5,0,22
1084,2022/07/22,15,15,6,0,21
1111,2022/07/22,8,0,3,0,11
1112,2022/07/22,8,0,0,0,8
1113,2022/07/22,11,0,0,0,11
1114,2022/07/22,6,0,0,0,6
1115,2022/07/22,7,0,3,0,10
1117,2022/07/22,4,0,0,0,4
1118,2022/07/22,6,0,2,0,8
1692,2022/07/22,30,8,6,0,36
1693,2022/07/22,14,8,6,0,20
1747,2022/07/22,15,15,15,0,30
1772,2022/07/22,5,0,1,0,6
1773,2022/07/22,12,0,1,0,13
1774,2022/07/22,11,8,0,0,11
1782,2022/07/22,36,12,25,9,61
1795,2022/07/22,23,14,15,0,38
1914,2022/07/22,7,0,1,0,8
1915,2022/07/22,9,0,3,0,12
1923,2022/07/22,10,0,2,0,12
1934,2022/07/22,5,0,3,0,8
1963,2022/07/22,26,16,7,0,33
1984,2022/07/22,9,6,3,0,12
2135,2022/07/22,11,0,0,0,11
2136,2022/07/22,7,0,2,0,9
2148,2022/07/22,6,4,0,0,6
2183,2022/07/22,11,6,7,0,18
2193,2022/07/22,9,6,7,0,16
2237,2022/07/22,6,0,2,0,8
2358,2022/07/22,9,8,3,0,12
2361,2022/07/22,8,7,6,0,14
2445,2022/07/22,20,6,13,0,33
2449,2022/07/22,15,8,9,0,24
2451,2022/07/22,8,5,5,0,13
2475,2022/07/22,8,0,1,0,9
2476,2022/07/22,6,0,4,0,10
2507,2022/07/22,23,12,7,0,30
2525,2022/07/22,5,0,1,0,6
2562,2022/07/22,20,8,6,0,26
2582,2022/07/22,4,0,0,0,4
2586,2022/07/22,37,16,11,0,48
2602,2022/07/22,6,0,2,0,8
2631,2022/07/22,7,6,4,0,11
2685,2022/07/22,0,0,5,0,5
2723,2022/07/22,8,0,0,0,8
2731,2022/07/22,6,0,0,0,6
2732,2022/07/22,4,0,1,0,5
2734,2022/07/22,9,0,0,0,9
2735,2022/07/22,5,0,2,0,7
2761,2022/07/22,18,10,12,0,30
2788,2022/07/22,28,12,12,0,40
2812,2022/07/22,5,0,0,0,5
2814,2022/07/22,6,0,3,0,9
2913,2022/07/22,17,6,3,0,20
2914,2022/07/22,9,0,1,0,10
3015,2022/07/22,13,8,2,0,15
3033,2022/07/22,9,0,0,0,9
3035,2022/07/22,6,0,1,0,7
4446,2022/07/22,18,9,10,1,28
12136,2022/07/22,15,6,14,0,29
12516,2022/07/22,6,0,0,0,6
12518,2022/07/22,7,0,2,0,9
12523,2022/07/22,6,0,3,0,9
16062,2022/07/22,10,0,2,0,12
16063,2022/07/22,12,0,2,0,14
19322,2022/07/22,7,0,1,0,8
19516,2022/07/22,20,0,5,0,25
19520,2022/07/22,5,0,0,0,5
75,2022/07/23,24,20,22,0,46
76,2022/07/23,36,32,25,0,61
99,2022/07/23,7,0,0,0,7
117,2022/07/23,5,0,1,3,6
118,2022/07/23,5,0,2,0,7
119,2022/07/23,4,4,1,0,5
120,2022/07/23,4,4,0,0,4
149,2022/07/23,8,0,0,0,8
184,2022/07/23,16,6,9,4,25
195,2022/07/23,41,27,27,3,68
218,2022/07/23,18,15,13,0,31
296,2022/07/23,11,6,1,0,12
300,2022/07/23,11,0,3,0,14
304,2022/07/23,11,6,1,0,12
317,2022/07/23,39,0,8,0,47
343,2022/07/23,8,0,2,0,10
373,2022/07/23,29,0,2,0,31
374,2022/07/23,6,0,4,0,10
388,2022/07/23,13,12,13,0,26
419,2022/07/23,40,16,12,0,52
420,2022/07/23,13,8,5,0,18
462,2022/07/23,11,8,4,0,15
519,2022/07/23,17,0,1,0,18
525,2022/07/23,9,0,1,3,10
596,2022/07/23,13,0,0,1,13
597,2022/07/23,25,0,11,5,36
598,2022/07/23,2,0,0,0,2
1035,2022/07/23,18,6,2,0,20
1084,2022/07/23,9,0,6,0,15
1111,2022/07/23,5,0,3,0,8
1112,2022/07/23,8,0,2,0,10
1113,2022/07/23,11,0,2,0,13
1114,2022/07/23,6,0,0,0,6
1115,2022/07/23,4,0,2,0,6
1117,2022/07/23,4,0,1,0,5
1118,2022/07/23,4,0,3,0,7
1119,2022/07/23,11,0,1,0,12
1692,2022/07/23,24,0,4,0,28
1693,2022/07/23,8,0,1,0,9
1747,2022/07/23,5,5,11,2,16
1772,2022/07/23,4,0,0,0,4
1773,2022/07/23,11,0,2,0,13
1774,2022/07/23,11,0,3,0,14
1782,2022/07/23,14,12,11,0,25
1795,2022/07/23,22,14,8,0,30
1914,2022/07/23,6,0,0,0,6
1915,2022/07/23,6,0,3,0,9
1923,2022/07/23,8,0,4,0,12
1934,2022/07/23,2,0,2,0,4
1963,2022/07/23,35,16,16,0,51
1984,2022/07/23,12,6,2,0,14
2135,2022/07/23,11,0,2,0,13
2136,2022/07/23,5,0,1,0,6
2148,2022/07/23,10,4,2,0,12
2183,2022/07/23,10,6,5,0,15
2193,2022/07/23,11,9,8,0,19
2237,2022/07/23,10,6,2,0,12
2358,2022/07/23,14,8,3,0,17
2361,2022/07/23,2,0,0,0,2
2445,2022/07/23,7,0,4,0,11
2449,2022/07/23,22,16,5,0,27
2451,2022/07/23,13,10,1,0,14
2475,2022/07/23,7,0,0,0,7
2476,2022/07/23,2,0,1,0,3
2507,2022/07/23,28,12,10,0,38
2525,2022/07/23,4,0,4,0,8
2562,2022/07/23,14,0,3,0,17
2582,2022/07/23,8,4,0,0,8
2586,2022/07/23,42,16,15,0,57
2602,2022/07/23,12,8,1,0,13
2631,2022/07/23,9,6,2,0,11
2685,2022/07/23,-5,0,3,0,-2
2723,2022/07/23,8,0,1,0,9
2731,2022/07/23,6,0,1,0,7
2732,2022/07/23,3,0,0,0,3
2734,2022/07/23,13,4,1,0,14
2735,2022/07/23,11,8,4,0,15
2761,2022/07/23,21,15,14,0,35
2788,2022/07/23,32,16,13,1,45
2812,2022/07/23,5,0,1,0,6
2814,2022/07/23,3,0,0,0,3
2913,2022/07/23,14,0,1,5,15
2914,2022/07/23,8,0,0,0,8
3015,2022/07/23,11,0,1,0,12
3033,2022/07/23,9,0,0,0,9
3035,2022/07/23,5,0,1,0,6
4446,2022/07/23,16,9,8,2,24
12136,2022/07/23,19,18,17,0,36
12516,2022/07/23,10,4,0,0,10
12518,2022/07/23,5,0,0,0,5
12523,2022/07/23,3,0,1,0,4
16062,2022/07/23,8,0,1,0,9
16063,2022/07/23,10,0,3,0,13
19322,2022/07/23,6,0,0,0,6
19516,2022/07/23,23,8,2,0,25
19520,2022/07/23,5,0,0,0,5
75,2022/07/24,18,16,19,0,37
76,2022/07/24,19,8,16,0,35
99,2022/07/24,7,0,1,0,8
117,2022/07/24,1,0,2,0,3
118,2022/07/24,11,8,3,0,14
119,2022/07/24,7,4,3,0,10
120,2022/07/24,4,0,2,0,6
149,2022/07/24,8,0,0,0,8
184,2022/07/24,6,3,5,0,11
195,2022/07/24,20,9,15,2,35
218,2022/07/24,20,15,15,0,35
296,2022/07/24,16,6,3,0,19
300,2022/07/24,8,0,1,0,9
304,2022/07/24,10,0,7,0,17
317,2022/07/24,39,8,7,0,46
343,2022/07/24,6,0,2,1,8
373,2022/07/24,35,8,5,0,40
374,2022/07/24,14,12,2,0,16
388,2022/07/24,15,15,10,0,25
419,2022/07/24,36,8,22,0,58
420,2022/07/24,16,8,9,0,25
462,2022/07/24,7,0,6,0,13
519,2022/07/24,22,6,3,0,25
525,2022/07/24,5,0,2,0,7
596,2022/07/24,16,4,4,5,20
597,2022/07/24,9,0,6,5,15
598,2022/07/24,8,6,3,0,11
1035,2022/07/24,22,6,4,0,26
1084,2022/07/24,8,5,2,0,10
1111,2022/07/24,2,0,4,0,6
1112,2022/07/24,6,0,1,0,7
1113,2022/07/24,9,0,0,0,9
1114,2022/07/24,12,6,4,0,16
1115,2022/07/24,8,6,3,0,11
1117,2022/07/24,11,8,1,0,12
1118,2022/07/24,7,6,3,0,10
1119,2022/07/24,10,0,1,0,11
1692,2022/07/24,20,0,1,0,21
1693,2022/07/24,15,8,5,0,20
1747,2022/07/24,7,15,10,0,17
1772,2022/07/24,4,0,1,0,5
1773,2022/07/24,9,0,1,0,10
1774,2022/07/24,8,0,1,0,9
1782,2022/07/24,18,15,16,0,34
1795,2022/07/24,14,0,10,0,24
1914,2022/07/24,6,0,0,0,6
1915,2022/07/24,3,0,0,0,3
1923,2022/07/24,4,0,2,0,6
1934,2022/07/24,5,5,2,0,7
1963,2022/07/24,35,16,21,0,56
1984,2022/07/24,10,0,1,0,11
2135,2022/07/24,15,6,2,0,17
2136,2022/07/24,4,0,0,0,4
2148,2022/07/24,16,8,1,0,17
2183,2022/07/24,11,6,3,0,14
2193,2022/07/24,15,12,5,0,20
2237,2022/07/24,8,0,4,0,12
2358,2022/07/24,27,16,5,0,32
2361,2022/07/24,9,7,1,0,10
2445,2022/07/24,3,0,4,0,7
2449,2022/07/24,25,8,8,0,33
2451,2022/07/24,27,15,14,0,41
2475,2022/07/24,7,0,2,0,9
2476,2022/07/24,1,0,0,0,1
2507,2022/07/24,18,0,9,0,27
2525,2022/07/24,0,0,2,0,2
2562,2022/07/24,27,16,12,0,39
2582,2022/07/24,12,4,0,0,12
2586,2022/07/24,27,0,9,6,36
2602,2022/07/24,11,0,2,0,13
2631,2022/07/24,13,6,0,0,13
2685,2022/07/24,-4,4,4,0,0
2723,2022/07/24,7,0,0,0,7
2731,2022/07/24,5,0,1,0,6
2732,2022/07/24,3,0,0,0,3
2734,2022/07/24,12,0,1,0,13
2735,2022/07/24,7,0,1,0,8
2761,2022/07/24,22,15,17,0,39
2788,2022/07/24,22,4,11,1,33
2812,2022/07/24,4,0,0,0,4
2814,2022/07/24,3,0,0,0,3
2913,2022/07/24,8,0,3,1,11
2914,2022/07/24,8,0,0,0,8
3015,2022/07/24,10,0,1,0,11
3033,2022/07/24,9,0,0,0,9
3035,2022/07/24,4,0,0,0,4
4446,2022/07/24,9,3,5,0,14
12136,2022/07/24,17,15,15,0,32
12516,2022/07/24,14,4,3,0,17
12518,2022/07/24,5,0,1,0,6
12523,2022/07/24,10,8,2,0,12
16062,2022/07/24,7,0,0,0,7
16063,2022/07/24,7,0,1,0,8
19322,2022/07/24,6,0,0,0,6
19516,2022/07/24,21,0,5,0,26
19520,2022/07/24,13,8,2,0,15
75,2022/07/25,39,40,36,0,75
76,2022/07/25,43,40,47,0,90
99,2022/07/25,6,0,0,0,6
117,2022/07/25,-1,0,-2,0,-3
118,2022/07/25,8,0,3,0,11
119,2022/07/25,4,0,1,0,5
120,2022/07/25,6,4,3,0,9
149,2022/07/25,8,0,0,0,8
184,2022/07/25,7,6,9,0,16
195,2022/07/25,33,30,31,0,64
218,2022/07/25,26,21,21,0,47
296,2022/07/25,13,0,7,0,20
300,2022/07/25,15,8,2,0,17
304,2022/07/25,9,6,4,0,13
317,2022/07/25,48,16,11,1,59
343,2022/07/25,3,0,4,0,7
373,2022/07/25,30,0,10,1,40
374,2022/07/25,12,0,3,0,15
388,2022/07/25,26,21,26,2,52
419,2022/07/25,22,8,13,0,35
420,2022/07/25,15,8,8,0,23
462,2022/07/25,9,8,8,0,17
519,2022/07/25,19,0,7,0,26
525,2022/07/25,3,0,1,0,4
596,2022/07/25,7,0,3,0,10
597,2022/07/25,-2,0,8,0,6
598,2022/07/25,5,0,0,0,5
1035,2022/07/25,18,0,5,0,23
1084,2022/07/25,16,10,6,0,22
1111,2022/07/25,4,6,1,0,5
1112,2022/07/25,5,0,0,0,5
1113,2022/07/25,9,0,1,0,10
1114,2022/07/25,8,0,2,0,10
1115,2022/07/25,5,0,0,0,5
1117,2022/07/25,10,0,0,0,10
1118,2022/07/25,10,6,2,0,12
1119,2022/07/25,9,0,0,0,9
1692,2022/07/25,19,0,0,0,19
1693,2022/07/25,18,8,10,0,28
1747,2022/07/25,12,15,14,0,26
1772,2022/07/25,3,0,1,0,4
1773,2022/07/25,8,0,0,0,8
1774,2022/07/25,7,0,0,0,7
1782,2022/07/25,14,12,12,0,26
1795,2022/07/25,18,14,11,1,29
1914,2022/07/25,6,0,0,0,6
1915,2022/07/25,9,6,1,0,10
1923,2022/07/25,2,0,0,0,2
1934,2022/07/25,8,5,0,0,8
1963,2022/07/25,30,16,18,1,48
1984,2022/07/25,9,0,2,0,11
2135,2022/07/25,13,0,1,0,14
2136,2022/07/25,10,6,0,0,10
2148,2022/07/25,15,0,3,0,18
2183,2022/07/25,8,0,1,0,9
2193,2022/07/25,22,12,17,2,39
2237,2022/07/25,4,0,3,0,7
2358,2022/07/25,22,0,2,0,24
2361,2022/07/25,8,0,6,0,14
2445,2022/07/25,5,6,1,0,6
2449,2022/07/25,25,8,9,0,34
2451,2022/07/25,13,0,10,0,23
2475,2022/07/25,5,0,0,0,5
2476,2022/07/25,1,0,0,0,1
2507,2022/07/25,21,12,9,0,30
2525,2022/07/25,4,6,1,0,5
2562,2022/07/25,15,0,6,0,21
2582,2022/07/25,12,0,2,0,14
2586,2022/07/25,12,0,6,0,18
2602,2022/07/25,9,0,2,0,11
2631,2022/07/25,13,0,1,0,14
2685,2022/07/25,-4,4,4,0,0
2723,2022/07/25,7,0,0,0,7
2730,2022/07/25,6,6,1,0,7
2731,2022/07/25,10,6,0,0,10
2732,2022/07/25,11,8,2,0,13
2734,2022/07/25,11,0,4,0,15
2735,2022/07/25,6,0,0,0,6
2761,2022/07/25,10,5,15,0,25
2788,2022/07/25,26,16,8,0,34
2812,2022/07/25,4,0,0,0,4
2814,2022/07/25,9,6,0,0,9
2913,2022/07/25,4,0,2,0,6
2914,2022/07/25,8,0,0,0,8
3015,2022/07/25,9,0,0,0,9
3035,2022/07/25,4,0,0,0,4
4446,2022/07/25,13,9,7,0,20
12136,2022/07/25,20,18,15,3,35
12516,2022/07/25,11,0,1,0,12
12518,2022/07/25,14,10,6,0,20
12523,2022/07/25,8,0,3,0,11
16062,2022/07/25,7,0,0,0,7
16063,2022/07/25,6,0,0,0,6
19322,2022/07/25,6,0,0,0,6
19516,2022/07/25,16,0,4,0,20
19520,2022/07/25,11,0,4,0,15
75,2022/07/26,39,36,38,0,77
76,2022/07/26,26,40,37,0,63
99,2022/07/26,6,0,0,0,6
117,2022/07/26,8,8,4,0,12
118,2022/07/26,5,0,5,0,10
119,2022/07/26,3,0,0,0,3
120,2022/07/26,3,0,2,0,5
149,2022/07/26,8,0,0,0,8
184,2022/07/26,6,9,4,0,10
195,2022/07/26,25,30,29,0,54
218,2022/07/26,29,24,21,0,50
296,2022/07/26,12,6,3,0,15
300,2022/07/26,13,0,3,0,16
304,2022/07/26,5,0,4,0,9
317,2022/07/26,44,8,11,0,55
343,2022/07/26,11,8,8,0,19
373,2022/07/26,27,8,7,4,34
374,2022/07/26,13,4,5,0,18
388,2022/07/26,16,18,15,0,31
419,2022/07/26,25,16,9,0,34
420,2022/07/26,15,8,7,0,22
462,2022/07/26,9,8,9,0,18
519,2022/07/26,18,6,3,0,21
525,2022/07/26,2,0,1,0,3
596,2022/07/26,8,4,4,2,12
597,2022/07/26,6,12,12,2,18
598,2022/07/26,5,0,2,0,7
1035,2022/07/26,19,6,2,0,21
1084,2022/07/26,20,10,9,0,29
1111,2022/07/26,3,0,1,0,4
1112,2022/07/26,5,0,0,0,5
1113,2022/07/26,8,0,0,0,8
1114,2022/07/26,6,0,0,0,6
1115,2022/07/26,5,0,0,0,5
1117,2022/07/26,10,0,0,0,10
1118,2022/07/26,8,0,1,0,9
1119,2022/07/26,9,0,1,0,10
1692,2022/07/26,19,0,0,0,19
1693,2022/07/26,16,8,7,0,23
1747,2022/07/26,13,15,10,0,23
1772,2022/07/26,2,0,0,0,2
1773,2022/07/26,8,0,0,0,8
1774,2022/07/26,7,0,0,0,7
1782,2022/07/26,20,18,14,0,34
1795,2022/07/26,20,14,7,4,27
1914,2022/07/26,6,0,0,0,6
1915,2022/07/26,8,0,0,0,8
1923,2022/07/26,8,6,0,0,8
1934,2022/07/26,8,0,3,0,11
1963,2022/07/26,27,16,13,0,40
1984,2022/07/26,7,0,0,2,7
2135,2022/07/26,12,0,0,0,12
2136,2022/07/26,10,0,0,0,10
2148,2022/07/26,12,0,2,0,14
2183,2022/07/26,13,6,1,0,14
2193,2022/07/26,15,12,14,0,29
2237,2022/07/26,7,6,0,0,7
2358,2022/07/26,20,0,4,0,24
2361,2022/07/26,9,7,3,0,12
2445,2022/07/26,10,6,4,2,14
2449,2022/07/26,24,8,11,0,35
2451,2022/07/26,3,0,3,0,6
2476,2022/07/26,1,0,0,0,1
2507,2022/07/26,18,6,8,2,26
2525,2022/07/26,9,6,3,0,12
2562,2022/07/26,17,8,6,0,23
2582,2022/07/26,10,0,1,0,11
2586,2022/07/26,8,8,8,0,16
2602,2022/07/26,7,0,4,0,11
2631,2022/07/26,12,0,2,1,14
2685,2022/07/26,2,4,4,0,6
2723,2022/07/26,7,0,1,0,8
2730,2022/07/26,11,6,2,0,13
2731,2022/07/26,10,0,1,0,11
2732,2022/07/26,9,0,0,0,9
2734,2022/07/26,7,0,1,0,8
2735,2022/07/26,6,0,2,0,8
2761,2022/07/26,10,15,10,0,20
2788,2022/07/26,14,12,13,0,27
2812,2022/07/26,10,6,0,0,10
2814,2022/07/26,9,0,0,0,9
2913,2022/07/26,2,0,1,0,3
2914,2022/07/26,8,0,0,0,8
3015,2022/07/26,9,0,0,0,9
3035,2022/07/26,10,6,0,0,10
4446,2022/07/26,18,12,6,0,24
12136,2022/07/26,20,18,12,0,32
12516,2022/07/26,10,0,0,0,10
12518,2022/07/26,8,0,3,0,11
12523,2022/07/26,9,4,2,0,11
16062,2022/07/26,7,0,0,0,7
16063,2022/07/26,12,6,1,0,13
19322,2022/07/26,6,0,0,0,6
19516,2022/07/26,20,8,5,0,25
19520,2022/07/26,7,0,1,0,8
75,2022/07/27,29,28,30,0,59
76,2022/07/27,22,28,24,0,46
99,2022/07/27,6,0,1,0,7
117,2022/07/27,4,0,4,0,8
118,2022/07/27,8,8,6,0,14
119,2022/07/27,3,0,1,0,4
120,2022/07/27,1,0,1,0,2
149,2022/07/27,8,0,1,0,9
184,2022/07/27,11,9,10,0,21
195,2022/07/27,31,30,28,2,59
218,2022/07/27,29,21,25,0,54
296,2022/07/27,15,6,9,0,24
300,2022/07/27,10,0,2,0,12
304,2022/07/27,1,0,1,0,2
317,2022/07/27,33,0,9,0,42
343,2022/07/27,3,0,0,0,3
373,2022/07/27,16,0,8,1,24
374,2022/07/27,8,0,7,0,15
388,2022/07/27,17,18,18,0,35
419,2022/07/27,25,8,10,0,35
420,2022/07/27,8,0,4,0,12
462,2022/07/27,8,8,6,0,14
519,2022/07/27,15,0,3,0,18
525,2022/07/27,6,5,3,0,9
596,2022/07/27,2,0,2,0,4
597,2022/07/27,13,12,8,0,21
598,2022/07/27,9,6,1,0,10
1035,2022/07/27,17,0,3,4,20
1084,2022/07/27,16,5,11,0,27
1111,2022/07/27,8,6,2,0,10
1112,2022/07/27,5,0,0,0,5
1113,2022/07/27,8,0,1,0,9
1114,2022/07/27,12,6,3,0,15
1115,2022/07/27,11,6,1,0,12
1117,2022/07/27,10,0,1,0,11
1118,2022/07/27,7,0,0,0,7
1119,2022/07/27,8,0,0,0,8
1692,2022/07/27,19,0,0,0,19
1693,2022/07/27,9,0,3,0,12
1747,2022/07/27,30,20,20,0,50
1772,2022/07/27,10,8,1,0,11
1773,2022/07/27,8,0,1,0,9
1774,2022/07/27,7,0,3,0,10
1782,2022/07/27,27,21,25,0,52
1795,2022/07/27,23,14,16,0,39
1914,2022/07/27,6,0,0,0,6
1915,2022/07/27,8,0,0,0,8
1923,2022/07/27,8,0,2,0,10
1934,2022/07/27,5,0,5,0,10
1963,2022/07/27,30,16,13,0,43
1984,2022/07/27,11,6,1,4,12
2135,2022/07/27,12,0,3,0,15
2136,2022/07/27,10,0,2,0,12
2148,2022/07/27,10,0,2,0,12
2183,2022/07/27,12,0,2,0,14
2193,2022/07/27,10,9,10,0,20
2237,2022/07/27,7,0,1,0,8
2358,2022/07/27,16,0,7,0,23
2361,2022/07/27,6,0,6,0,12
2445,2022/07/27,10,6,5,0,15
2449,2022/07/27,13,0,4,0,17
2451,2022/07/27,0,0,0,0,0
2476,2022/07/27,1,0,1,0,2
2507,2022/07/27,14,6,12,0,26
2525,2022/07/27,6,0,1,0,7
2562,2022/07/27,19,8,3,0,22
2582,2022/07/27,9,0,3,0,12
2586,2022/07/27,16,16,15,0,31
2602,2022/07/27,3,0,1,0,4
2631,2022/07/27,9,0,0,2,9
2685,2022/07/27,9,8,6,0,15
2723,2022/07/27,6,0,1,0,7
2730,2022/07/27,9,0,0,0,9
2731,2022/07/27,9,0,1,0,10
2732,2022/07/27,9,0,0,0,9
2734,2022/07/27,6,0,0,0,6
2735,2022/07/27,12,8,4,0,16
2761,2022/07/27,12,10,11,0,23
2788,2022/07/27,9,8,9,0,18
2812,2022/07/27,10,0,2,0,12
2814,2022/07/27,9,0,0,0,9
2913,2022/07/27,1,0,-1,1,0
2914,2022/07/27,8,0,0,0,8
3015,2022/07/27,9,0,0,0,9
3033,2022/07/27,9,0,1,0,10
3035,2022/07/27,10,0,0,0,10
4446,2022/07/27,24,12,16,0,40
12136,2022/07/27,23,15,23,0,46
12516,2022/07/27,10,0,2,0,12
12518,2022/07/27,5,0,3,0,8
12523,2022/07/27,7,0,5,0,12
16062,2022/07/27,7,0,0,0,7
16063,2022/07/27,11,0,2,0,13
19322,2022/07/27,6,0,1,0,7
19516,2022/07/27,23,8,5,0,28
19520,2022/07/27,6,0,1,0,7
75,2022/07/28,36,36,31,0,67
76,2022/07/28,36,36,38,0,74
99,2022/07/28,5,0,1,0,6
117,2022/07/28,0,0,0,0,0
118,2022/07/28,2,0,2,0,4
119,2022/07/28,6,4,1,0,7
120,2022/07/28,0,0,0,0,0
149,2022/07/28,7,0,0,0,7
184,2022/07/28,13,12,13,0,26
195,2022/07/28,28,27,28,0,56
218,2022/07/28,19,15,14,0,33
296,2022/07/28,5,0,5,0,10
300,2022/07/28,7,0,4,0,11
304,2022/07/28,7,6,6,0,13
317,2022/07/28,34,8,7,1,41
343,2022/07/28,0,0,0,0,0
373,2022/07/28,8,0,7,0,15
374,2022/07/28,1,0,0,0,1
388,2022/07/28,17,18,18,0,35
419,2022/07/28,11,0,5,0,16
420,2022/07/28,9,8,5,0,14
462,2022/07/28,2,0,2,0,4
519,2022/07/28,5,0,1,0,6
525,2022/07/28,7,0,2,2,9
596,2022/07/28,4,4,3,0,7
597,2022/07/28,17,12,10,0,27
598,2022/07/28,8,0,4,0,12
1035,2022/07/28,11,0,6,3,17
1084,2022/07/28,5,0,4,0,9
1111,2022/07/28,6,0,0,0,6
1112,2022/07/28,11,6,0,0,11
1113,2022/07/28,7,0,0,0,7
1114,2022/07/28,9,0,3,0,12
1115,2022/07/28,10,0,2,0,12
1117,2022/07/28,9,0,0,0,9
1118,2022/07/28,13,6,3,0,16
1119,2022/07/28,8,0,1,0,9
1692,2022/07/28,0,0,0,0,0
1693,2022/07/28,8,0,9,0,17
1747,2022/07/28,25,15,20,1,45
1772,2022/07/28,9,0,3,0,12
1773,2022/07/28,7,0,1,0,8
1774,2022/07/28,4,0,2,0,6
1782,2022/07/28,20,18,14,0,34
1795,2022/07/28,14,7,13,0,27
1914,2022/07/28,6,0,0,0,6
1915,2022/07/28,8,0,0,0,8
1923,2022/07/28,6,0,1,0,7
1934,2022/07/28,7,5,5,0,12
1963,2022/07/28,19,8,7,0,26
1984,2022/07/28,5,0,2,0,7
2135,2022/07/28,9,0,4,0,13
2136,2022/07/28,8,0,0,0,8
2148,2022/07/28,6,0,1,0,7
2183,2022/07/28,15,6,4,0,19
2193,2022/07/28,9,9,7,0,16
2237,2022/07/28,12,6,7,0,19
2358,2022/07/28,16,8,4,0,20
2361,2022/07/28,7,7,5,0,12
2445,2022/07/28,15,6,2,0,17
2449,2022/07/28,14,8,4,0,18
2451,2022/07/28,10,10,5,0,15
2475,2022/07/28,11,6,0,0,11
2476,2022/07/28,0,0,1,0,1
2507,2022/07/28,14,12,11,0,25
2525,2022/07/28,5,0,1,0,6
2562,2022/07/28,29,8,7,0,36
2582,2022/07/28,17,0,1,0,18
2586,2022/07/28,13,12,13,0,26
2602,2022/07/28,2,0,0,0,2
2631,2022/07/28,6,0,2,4,8
2685,2022/07/28,7,4,6,0,13
2723,2022/07/28,5,0,0,0,5
2730,2022/07/28,9,0,0,0,9
2731,2022/07/28,8,0,0,0,8
2732,2022/07/28,9,0,2,0,11
2734,2022/07/28,0,0,0,0,0
2735,2022/07/28,7,0,5,0,12
2761,2022/07/28,16,15,16,0,32
2788,2022/07/28,8,8,9,0,17
2812,2022/07/28,8,0,0,0,8
2814,2022/07/28,9,0,2,0,11
2913,2022/07/28,7,6,2,0,9
2914,2022/07/28,8,0,0,0,8
3015,2022/07/28,9,0,1,0,10
3033,2022/07/28,8,0,0,0,8
3035,2022/07/28,10,0,0,0,10
4446,2022/07/28,14,6,9,1,23
12136,2022/07/28,18,18,19,0,37
12516,2022/07/28,-2,0,3,0,1
12518,2022/07/28,12,10,10,0,22
12523,2022/07/28,8,4,6,0,14
16062,2022/07/28,7,0,1,0,8
16063,2022/07/28,9,0,0,0,9
19322,2022/07/28,5,0,0,0,5
19516,2022/07/28,19,8,7,1,26
19520,2022/07/28,13,8,3,0,16
75,2022/07/29,44,40,37,0,81
76,2022/07/29,46,48,47,0,93
99,2022/07/29,4,0,0,0,4
117,2022/07/29,0,0,0,0,0
118,2022/07/29,0,0,0,0,0
119,2022/07/29,5,0,3,0,8
120,2022/07/29,4,4,1,0,5
149,2022/07/29,7,0,0,0,7
184,2022/07/29,15,15,15,0,30
195,2022/07/29,36,36,33,0,69
218,2022/07/29,26,21,16,0,42
296,2022/07/29,6,6,3,0,9
300,2022/07/29,11,8,1,0,12
304,2022/07/29,7,6,1,0,8
317,2022/07/29,34,8,13,0,47
343,2022/07/29,0,0,0,0,0
373,2022/07/29,9,8,9,0,18
374,2022/07/29,5,4,4,0,9
388,2022/07/29,26,27,30,0,56
419,2022/07/29,22,16,5,0,27
420,2022/07/29,12,8,10,0,22
462,2022/07/29,8,8,2,0,10
519,2022/07/29,16,12,14,0,30
525,2022/07/29,3,0,3,0,6
596,2022/07/29,9,8,5,0,14
597,2022/07/29,31,24,11,0,42
598,2022/07/29,4,0,1,0,5
1035,2022/07/29,8,6,8,0,16
1084,2022/07/29,16,15,10,0,26
1111,2022/07/29,6,0,1,0,7
1112,2022/07/29,11,0,0,0,11
1113,2022/07/29,7,0,1,0,8
1114,2022/07/29,6,0,0,0,6
1115,2022/07/29,8,0,0,0,8
1117,2022/07/29,9,0,2,0,11
1118,2022/07/29,10,0,0,0,10
1119,2022/07/29,7,0,1,0,8
1692,2022/07/29,0,0,0,0,0
1693,2022/07/29,7,8,6,0,13
1747,2022/07/29,25,20,21,0,46
1772,2022/07/29,6,0,0,0,6
1773,2022/07/29,6,0,1,0,7
1774,2022/07/29,2,0,0,0,2
1782,2022/07/29,27,21,15,0,42
1795,2022/07/29,1,0,0,0,1
1914,2022/07/29,6,0,0,0,6
1915,2022/07/29,8,0,0,0,8
1923,2022/07/29,5,0,2,0,7
1934,2022/07/29,7,5,3,0,10
1963,2022/07/29,20,8,10,0,30
1984,2022/07/29,3,0,2,0,5
2135,2022/07/29,5,0,2,0,7
2136,2022/07/29,8,0,0,0,8
2148,2022/07/29,5,0,2,0,7
2183,2022/07/29,17,6,13,0,30
2193,2022/07/29,17,15,15,0,32
2237,2022/07/29,5,0,1,0,6
2358,2022/07/29,12,0,4,0,16
2361,2022/07/29,9,7,6,0,15
2445,2022/07/29,19,6,10,0,29
2449,2022/07/29,18,8,9,0,27
2451,2022/07/29,15,10,13,0,28
2475,2022/07/29,11,0,0,0,11
2476,2022/07/29,-1,0,0,0,-1
2507,2022/07/29,9,6,6,0,15
2525,2022/07/29,10,6,2,0,12
2562,2022/07/29,30,8,11,0,41
2582,2022/07/29,16,0,5,0,21
2586,2022/07/29,16,16,9,0,25
2602,2022/07/29,10,8,4,0,14
2631,2022/07/29,6,6,6,0,12
2685,2022/07/29,5,4,6,0,11
2723,2022/07/29,5,0,0,0,5
2730,2022/07/29,9,0,5,0,14
2731,2022/07/29,8,0,2,0,10
2732,2022/07/29,7,0,1,0,8
2734,2022/07/29,4,4,1,0,5
2735,2022/07/29,2,0,2,0,4
2761,2022/07/29,15,15,7,0,22
2788,2022/07/29,15,16,14,0,29
2812,2022/07/29,8,0,0,0,8
2814,2022/07/29,7,0,1,0,8
2913,2022/07/29,5,0,3,0,8
2914,2022/07/29,8,0,0,0,8
3015,2022/07/29,8,0,1,0,9
3035,2022/07/29,10,0,1,0,11
4446,2022/07/29,13,9,8,0,21
12136,2022/07/29,17,18,10,0,27
12516,2022/07/29,-5,0,2,0,-3
12518,2022/07/29,2,0,2,0,4
12523,2022/07/29,2,0,0,0,2
16062,2022/07/29,6,0,1,0,7
16063,2022/07/29,9,0,2,0,11
19322,2022/07/29,5,0,0,0,5
19516,2022/07/29,11,0,7,1,18
19520,2022/07/29,10,0,2,0,12
75,2022/07/30,39,32,20,1,59
76,2022/07/30,31,32,18,5,49
99,2022/07/30,4,0,0,0,4
117,2022/07/30,8,8,4,0,12
118,2022/07/30,8,8,4,0,12
119,2022/07/30,2,0,0,0,2
120,2022/07/30,3,0,3,0,6
149,2022/07/30,7,0,0,0,7
184,2022/07/30,6,6,7,1,13
195,2022/07/30,33,30,26,0,59
218,2022/07/30,31,21,25,3,56
296,2022/07/30,3,0,3,0,6
300,2022/07/30,10,0,8,0,18
304,2022/07/30,12,6,7,0,19
317,2022/07/30,29,8,15,0,44
343,2022/07/30,8,8,7,0,15
373,2022/07/30,8,8,3,0,11
374,2022/07/30,5,4,4,0,9
388,2022/07/30,17,21,16,0,33
419,2022/07/30,33,16,6,0,39
420,2022/07/30,10,8,3,0,13
462,2022/07/30,14,8,3,0,17
519,2022/07/30,2,0,3,0,5
525,2022/07/30,5,5,4,0,9
596,2022/07/30,4,0,2,0,6
597,2022/07/30,20,0,11,0,31
598,2022/07/30,9,6,2,0,11
1035,2022/07/30,6,6,6,0,12
1084,2022/07/30,6,0,5,0,11
1111,2022/07/30,11,6,2,0,13
1112,2022/07/30,11,0,1,0,12
1113,2022/07/30,6,0,4,0,10
1114,2022/07/30,6,0,0,0,6
1115,2022/07/30,8,0,5,0,13
1117,2022/07/30,7,0,0,0,7
1118,2022/07/30,10,0,1,0,11
1119,2022/07/30,6,0,0,0,6
1692,2022/07/30,0,0,0,0,0
1693,2022/07/30,9,8,4,0,13
1747,2022/07/30,13,10,12,0,25
1772,2022/07/30,6,0,1,0,7
1773,2022/07/30,5,0,1,0,6
1774,2022/07/30,10,8,1,0,11
1782,2022/07/30,21,9,23,0,44
1795,2022/07/30,22,21,17,0,39
1914,2022/07/30,6,0,1,0,7
1915,2022/07/30,8,0,3,0,11
1923,2022/07/30,9,6,2,0,11
1934,2022/07/30,4,0,0,0,4
1963,2022/07/30,34,24,17,0,51
1984,2022/07/30,1,0,1,0,2
2135,2022/07/30,3,0,1,0,4
2136,2022/07/30,8,0,0,0,8
2148,2022/07/30,3,0,3,0,6
2183,2022/07/30,4,0,4,0,8
2193,2022/07/30,14,12,11,0,25
2237,2022/07/30,4,0,1,0,5
2358,2022/07/30,8,0,4,0,12
2361,2022/07/30,3,0,5,0,8
2445,2022/07/30,9,0,3,1,12
2449,2022/07/30,25,16,10,0,35
2451,2022/07/30,12,10,7,0,19
2475,2022/07/30,11,0,0,0,11
2476,2022/07/30,-1,0,0,0,-1
2507,2022/07/30,15,12,7,0,22
2525,2022/07/30,8,0,0,0,8
2562,2022/07/30,27,8,5,0,32
2582,2022/07/30,11,0,6,0,17
2586,2022/07/30,19,12,10,0,29
2602,2022/07/30,6,0,1,0,7
2631,2022/07/30,6,6,6,0,12
2685,2022/07/30,3,4,2,0,5
2723,2022/07/30,5,0,2,0,7
2730,2022/07/30,4,0,3,0,7
2731,2022/07/30,6,0,0,0,6
2732,2022/07/30,6,0,1,0,7
2734,2022/07/30,3,0,0,0,3
2735,2022/07/30,0,0,1,0,1
2761,2022/07/30,23,15,10,0,33
2788,2022/07/30,17,16,8,1,25
2812,2022/07/30,8,0,0,0,8
2814,2022/07/30,6,0,2,0,8
2913,2022/07/30,2,0,3,0,5
2914,2022/07/30,8,0,2,0,10
3015,2022/07/30,7,0,0,0,7
3035,2022/07/30,9,0,1,0,10
4446,2022/07/30,11,6,6,0,17
12136,2022/07/30,25,18,14,6,39
12516,2022/07/30,-7,0,0,0,-7
12518,2022/07/30,0,0,0,0,0
12523,2022/07/30,6,4,4,0,10
16062,2022/07/30,5,0,0,0,5
16063,2022/07/30,7,0,3,0,10
19322,2022/07/30,5,0,0,0,5
19516,2022/07/30,3,0,3,0,6
19520,2022/07/30,8,0,0,0,8
75,2022/07/31,42,24,20,5,62
76,2022/07/31,32,24,31,0,63
99,2022/07/31,16,12,1,0,17
117,2022/07/31,4,0,4,0,8
118,2022/07/31,4,0,4,0,8
119,2022/07/31,6,4,3,0,9
120,2022/07/31,4,4,2,0,6
149,2022/07/31,7,0,0,0,7
184,2022/07/31,7,9,4,0,11
195,2022/07/31,25,18,15,0,40
218,2022/07/31,21,18,13,2,34
296,2022/07/31,6,6,6,0,12
300,2022/07/31,10,8,2,0,12
304,2022/07/31,5,0,3,0,8
317,2022/07/31,28,8,15,8,43
343,2022/07/31,1,0,1,0,2
373,2022/07/31,13,8,10,0,23
374,2022/07/31,13,12,9,0,22
388,2022/07/31,19,18,14,0,33
419,2022/07/31,43,16,13,0,56
420,2022/07/31,15,8,9,0,24
462,2022/07/31,19,8,6,0,25
519,2022/07/31,5,6,6,0,11
525,2022/07/31,1,0,2,0,3
596,2022/07/31,10,8,4,0,14
597,2022/07/31,21,12,8,0,29
598,2022/07/31,7,0,2,0,9
1035,2022/07/31,0,0,0,0,0
1084,2022/07/31,6,5,4,0,10
1111,2022/07/31,9,0,2,0,11
1112,2022/07/31,10,0,2,0,12
1113,2022/07/31,2,0,2,0,4
1114,2022/07/31,12,6,3,0,15
1115,2022/07/31,9,6,1,0,10
1117,2022/07/31,7,0,0,0,7
1118,2022/07/31,15,6,3,0,18
1119,2022/07/31,6,0,0,0,6
1692,2022/07/31,8,8,5,0,13
1693,2022/07/31,13,8,5,0,18
1747,2022/07/31,11,10,3,0,14
1772,2022/07/31,5,0,0,0,5
1773,2022/07/31,10,6,3,0,13
1774,2022/07/31,9,0,2,0,11
1782,2022/07/31,13,15,12,0,25
1795,2022/07/31,5,0,5,0,10
1914,2022/07/31,6,0,0,0,6
1915,2022/07/31,5,0,1,0,6
1923,2022/07/31,13,6,1,0,14
1934,2022/07/31,9,5,0,0,9
1963,2022/07/31,33,16,22,0,55
1984,2022/07/31,6,6,5,0,11
2135,2022/07/31,8,6,2,0,10
2136,2022/07/31,8,0,0,0,8
2148,2022/07/31,4,4,4,0,8
2183,2022/07/31,0,0,0,0,0
2193,2022/07/31,9,6,5,0,14
2237,2022/07/31,9,6,1,0,10
2358,2022/07/31,20,16,3,0,23
2361,2022/07/31,5,7,3,0,8
2445,2022/07/31,11,6,8,0,19
2449,2022/07/31,23,8,7,1,30
2451,2022/07/31,15,10,1,0,16
2475,2022/07/31,11,0,0,0,11
2476,2022/07/31,-1,0,1,0,0
2507,2022/07/31,14,6,12,0,26
2525,2022/07/31,8,0,5,0,13
2562,2022/07/31,30,8,5,0,35
2582,2022/07/31,5,0,0,0,5
2586,2022/07/31,17,8,10,0,27
2602,2022/07/31,5,0,0,0,5
2631,2022/07/31,0,0,0,0,0
2685,2022/07/31,5,4,2,0,7
2723,2022/07/31,3,0,2,0,5
2730,2022/07/31,1,0,1,0,2
2731,2022/07/31,6,0,1,0,7
2732,2022/07/31,5,0,1,0,6
2734,2022/07/31,11,8,12,0,23
2735,2022/07/31,7,8,1,0,8
2761,2022/07/31,23,10,7,0,30
2788,2022/07/31,20,12,6,7,26
2812,2022/07/31,8,0,1,0,9
2814,2022/07/31,4,0,0,0,4
2913,2022/07/31,5,6,0,0,5
2914,2022/07/31,6,0,0,0,6
3015,2022/07/31,7,0,0,0,7
3035,2022/07/31,8,0,1,0,9
4446,2022/07/31,14,9,10,0,24
12136,2022/07/31,23,18,14,0,37
12516,2022/07/31,1,8,1,0,2
12518,2022/07/31,10,10,5,0,15
12523,2022/07/31,6,4,1,0,7
16062,2022/07/31,5,0,1,0,6
16063,2022/07/31,4,0,0,0,4
19322,2022/07/31,5,0,1,0,6
19516,2022/07/31,8,8,4,0,12
19520,2022/07/31,8,0,2,0,10
75,2022/08/01,53,36,52,0,105
76,2022/08/01,49,48,32,8,81
99,2022/08/01,15,0,1,0,16
117,2022/08/01,0,0,0,0,0
118,2022/08/01,4,4,4,0,8
119,2022/08/01,3,0,2,0,5
120,2022/08/01,2,0,1,0,3
149,2022/08/01,7,0,0,0,7
184,2022/08/01,12,9,8,0,20
195,2022/08/01,44,33,31,4,75
218,2022/08/01,24,18,11,0,35
296,2022/08/01,6,6,3,0,9
300,2022/08/01,8,0,2,0,10
304,2022/08/01,8,6,4,0,12
317,2022/08/01,5,6,5,0,10
343,2022/08/01,0,0,0,0,0
373,2022/08/01,9,6,8,0,17
374,2022/08/01,4,0,4,0,8
388,2022/08/01,26,21,25,0,51
419,2022/08/01,42,12,18,0,60
420,2022/08/01,6,0,5,0,11
462,2022/08/01,21,8,6,0,27
519,2022/08/01,-1,0,0,0,-1
525,2022/08/01,-1,0,0,0,-1
596,2022/08/01,6,0,1,0,7
597,2022/08/01,13,0,6,0,19
598,2022/08/01,5,0,2,0,7
1035,2022/08/01,6,6,1,0,7
1084,2022/08/01,7,5,3,0,10
1111,2022/08/01,7,0,0,0,7
1112,2022/08/01,8,0,0,0,8
1113,2022/08/01,0,0,0,0,0
1114,2022/08/01,9,0,1,0,10
1115,2022/08/01,8,0,3,0,11
1117,2022/08/01,7,0,2,0,9
1118,2022/08/01,12,0,0,0,12
1119,2022/08/01,6,0,0,0,6
1692,2022/08/01,9,6,8,0,17
1693,2022/08/01,8,0,6,0,14
1747,2022/08/01,23,15,14,0,37
1772,2022/08/01,5,0,1,0,6
1773,2022/08/01,7,0,1,0,8
1774,2022/08/01,7,0,1,0,8
1782,2022/08/01,19,18,21,0,40
1795,2022/08/01,14,14,5,0,19
1914,2022/08/01,12,6,1,0,13
1915,2022/08/01,4,0,0,0,4
1923,2022/08/01,12,0,0,0,12
1934,2022/08/01,9,0,5,0,14
1963,2022/08/01,23,12,10,0,33
1984,2022/08/01,1,0,1,0,2
2135,2022/08/01,12,6,0,0,12
2136,2022/08/01,8,0,0,0,8
2148,2022/08/01,0,0,0,0,0
2183,2022/08/01,0,0,0,0,0
2193,2022/08/01,16,12,11,0,27
2237,2022/08/01,8,0,1,0,9
2358,2022/08/01,17,0,7,0,24
2361,2022/08/01,2,0,2,0,4
2445,2022/08/01,3,0,2,0,5
2449,2022/08/01,15,0,7,0,22
2451,2022/08/01,14,0,6,0,20
2475,2022/08/01,11,0,0,0,11
2476,2022/08/01,4,6,1,0,5
2507,2022/08/01,14,12,8,0,22
2525,2022/08/01,3,0,4,0,7
2562,2022/08/01,25,0,13,0,38
2582,2022/08/01,5,0,0,0,5
2586,2022/08/01,19,12,8,0,27
2602,2022/08/01,13,8,3,0,16
2631,2022/08/01,6,6,4,0,10
2685,2022/08/01,7,4,4,0,11
2723,2022/08/01,1,0,0,0,1
2730,2022/08/01,6,6,0,0,6
2731,2022/08/01,11,6,2,0,13
2732,2022/08/01,4,0,0,0,4
2734,2022/08/01,-1,0,0,0,-1
2735,2022/08/01,6,0,1,0,7
2761,2022/08/01,31,15,16,0,47
2788,2022/08/01,19,12,11,6,30
2812,2022/08/01,7,0,0,0,7
2814,2022/08/01,4,0,0,0,4
2913,2022/08/01,5,0,1,0,6
2914,2022/08/01,6,0,1,0,7
3015,2022/08/01,7,0,0,0,7
3035,2022/08/01,7,0,0,0,7
4446,2022/08/01,16,12,5,3,21
12136,2022/08/01,27,18,16,5,43
12516,2022/08/01,0,0,3,2,3
12518,2022/08/01,5,0,6,0,11
12523,2022/08/01,5,0,1,0,6
16062,2022/08/01,4,0,0,0,4
16063,2022/08/01,10,6,0,0,10
19322,2022/08/01,4,0,0,0,4
19516,2022/08/01,16,12,9,0,25
19520,2022/08/01,6,0,0,0,6
75,2022/08/02,37,36,38,0,75
76,2022/08/02,61,44,53,1,114
99,2022/08/02,14,0,0,0,14
117,2022/08/02,4,4,1,1,5
118,2022/08/02,4,4,3,0,7
119,2022/08/02,5,4,3,0,8
120,2022/08/02,1,0,1,0,2
149,2022/08/02,7,0,0,0,7
184,2022/08/02,16,12,8,0,24
195,2022/08/02,45,33,35,3,80
218,2022/08/02,31,18,13,2,44
296,2022/08/02,9,6,5,0,14
300,2022/08/02,6,0,3,0,9
304,2022/08/02,4,0,0,0,4
317,2022/08/02,12,12,9,0,21
343,2022/08/02,4,4,3,0,7
373,2022/08/02,7,6,5,0,12
374,2022/08/02,4,4,3,0,7
388,2022/08/02,28,27,29,1,57
419,2022/08/02,30,6,12,0,42
420,2022/08/02,13,12,12,0,25
462,2022/08/02,15,0,8,0,23
519,2022/08/02,5,6,2,0,7
525,2022/08/02,4,5,5,0,9
596,2022/08/02,9,4,5,0,14
597,2022/08/02,19,12,11,0,30
598,2022/08/02,3,0,2,0,5
1035,2022/08/02,11,6,0,0,11
1084,2022/08/02,14,10,12,0,26
1111,2022/08/02,7,0,1,0,8
1112,2022/08/02,8,0,0,0,8
1113,2022/08/02,6,6,0,0,6
1114,2022/08/02,8,0,1,0,9
1115,2022/08/02,11,6,0,0,11
1117,2022/08/02,5,0,0,0,5
1118,2022/08/02,12,0,0,0,12
1119,2022/08/02,6,0,0,0,6
1692,2022/08/02,7,6,6,0,13
1693,2022/08/02,8,6,5,0,13
1747,2022/08/02,24,15,24,0,48
1772,2022/08/02,4,0,1,0,5
1773,2022/08/02,6,0,0,0,6
1774,2022/08/02,6,0,0,0,6
1782,2022/08/02,13,15,12,0,25
1795,2022/08/02,23,14,19,1,42
1914,2022/08/02,11,0,2,0,13
1915,2022/08/02,4,0,0,0,4
1923,2022/08/02,12,0,1,0,13
1934,2022/08/02,9,5,4,0,13
1963,2022/08/02,25,12,15,0,40
1984,2022/08/02,6,6,0,0,6
2135,2022/08/02,18,6,1,0,19
2136,2022/08/02,8,0,1,0,9
2148,2022/08/02,4,4,0,0,4
2183,2022/08/02,6,6,0,0,6
2193,2022/08/02,20,15,14,0,34
2237,2022/08/02,7,0,2,0,9
2358,2022/08/02,10,0,5,0,15
2361,2022/08/02,7,7,1,0,8
2445,2022/08/02,7,6,1,0,8
2449,2022/08/02,20,12,8,0,28
2451,2022/08/02,8,0,6,0,14
2476,2022/08/02,9,6,0,0,9
2507,2022/08/02,12,6,11,0,23
2525,2022/08/02,-1,0,0,0,-1
2562,2022/08/02,12,0,4,0,16
2582,2022/08/02,9,4,1,0,10
2586,2022/08/02,19,8,11,1,30
2602,2022/08/02,10,0,1,0,11
2631,2022/08/02,8,6,1,0,9
2685,2022/08/02,11,8,5,0,16
2723,2022/08/02,9,8,0,0,9
2730,2022/08/02,12,6,0,0,12
2731,2022/08/02,9,0,1,0,10
2732,2022/08/02,12,8,3,0,15
2734,2022/08/02,-1,0,0,0,-1
2735,2022/08/02,5,0,3,0,8
2761,2022/08/02,25,10,9,1,34
2788,2022/08/02,20,12,18,1,38
2812,2022/08/02,7,0,0,0,7
2814,2022/08/02,10,6,0,0,10
2913,2022/08/02,10,6,1,0,11
2914,2022/08/02,5,0,0,0,5
3015,2022/08/02,7,0,0,0,7
3035,2022/08/02,7,0,0,0,7
4446,2022/08/02,20,9,11,0,31
12136,2022/08/02,23,12,19,2,42
12516,2022/08/02,-3,0,2,0,-1
12518,2022/08/02,9,10,0,0,9
12523,2022/08/02,8,4,3,0,11
16062,2022/08/02,4,0,0,0,4
16063,2022/08/02,10,0,0,0,10
19322,2022/08/02,4,0,0,0,4
19516,2022/08/02,7,0,3,0,10
19520,2022/08/02,14,8,0,0,14
75,2022/08/03,24,28,27,0,51
76,2022/08/03,46,40,47,0,93
99,2022/08/03,14,0,0,0,14
117,2022/08/03,6,4,3,0,9
118,2022/08/03,5,4,4,0,9
119,2022/08/03,2,0,1,0,3
120,2022/08/03,4,4,1,0,5
149,2022/08/03,7,0,2,0,9
184,2022/08/03,17,9,7,0,24
195,2022/08/03,40,30,39,0,79
218,2022/08/03,37,27,27,0,64
296,2022/08/03,10,6,6,0,16
300,2022/08/03,11,8,1,0,12
304,2022/08/03,10,6,4,0,14
317,2022/08/03,15,12,13,0,28
343,2022/08/03,5,4,5,0,10
373,2022/08/03,8,6,4,0,12
374,2022/08/03,5,4,2,0,7
388,2022/08/03,18,21,18,0,36
419,2022/08/03,24,6,6,0,30
420,2022/08/03,13,12,8,0,21
462,2022/08/03,15,8,6,0,21
519,2022/08/03,9,6,5,0,14
525,2022/08/03,-1,0,0,0,-1
596,2022/08/03,8,4,4,0,12
597,2022/08/03,14,6,12,0,26
598,2022/08/03,7,6,2,0,9
1035,2022/08/03,17,6,5,0,22
1084,2022/08/03,12,10,7,0,19
1111,2022/08/03,6,0,0,0,6
1112,2022/08/03,8,0,0,0,8
1113,2022/08/03,6,0,0,0,6
1114,2022/08/03,7,0,1,0,8
1115,2022/08/03,11,0,1,0,12
1117,2022/08/03,5,0,1,0,6
1118,2022/08/03,12,0,1,0,13
1119,2022/08/03,6,0,1,0,7
1692,2022/08/03,1,0,1,0,2
1693,2022/08/03,9,6,2,0,11
1747,2022/08/03,20,20,9,0,29
1772,2022/08/03,3,0,1,0,4
1773,2022/08/03,6,0,1,0,7
1774,2022/08/03,14,8,0,0,14
1782,2022/08/03,24,24,24,0,48
1795,2022/08/03,17,14,11,0,28
1914,2022/08/03,9,0,0,0,9
1915,2022/08/03,10,6,0,0,10
1923,2022/08/03,11,0,1,0,12
1934,2022/08/03,9,5,3,0,12
1963,2022/08/03,22,12,22,1,44
1984,2022/08/03,6,0,3,0,9
2135,2022/08/03,17,0,0,0,17
2136,2022/08/03,7,0,1,0,8
2148,2022/08/03,8,4,4,0,12
2183,2022/08/03,6,0,2,0,8
2193,2022/08/03,18,12,9,2,27
2237,2022/08/03,5,0,1,0,6
2358,2022/08/03,5,0,5,0,10
2361,2022/08/03,12,7,8,0,20
2445,2022/08/03,6,0,0,0,6
2449,2022/08/03,18,6,15,0,33
2451,2022/08/03,1,0,1,0,2
2476,2022/08/03,9,0,0,0,9
2507,2022/08/03,12,12,8,0,20
2525,2022/08/03,6,6,0,0,6
2562,2022/08/03,20,12,10,0,30
2582,2022/08/03,12,4,1,0,13
2586,2022/08/03,18,12,6,0,24
2602,2022/08/03,9,0,3,0,12
2631,2022/08/03,7,0,4,0,11
2685,2022/08/03,10,4,4,0,14
2723,2022/08/03,9,0,1,0,10
2730,2022/08/03,12,0,2,0,14
2731,2022/08/03,8,0,0,0,8
2732,2022/08/03,9,0,0,0,9
2734,2022/08/03,0,0,0,0,0
2735,2022/08/03,10,8,5,0,15
2761,2022/08/03,13,0,19,0,32
2788,2022/08/03,9,12,8,0,17
2812,2022/08/03,7,0,0,0,7
2814,2022/08/03,10,0,1,0,11
2913,2022/08/03,9,0,4,0,13
2914,2022/08/03,5,0,0,0,5
3015,2022/08/03,7,0,1,0,8
3035,2022/08/03,7,0,0,0,7
4446,2022/08/03,19,12,9,0,28
12136,2022/08/03,22,24,24,0,46
12516,2022/08/03,9,4,3,0,12
12518,2022/08/03,9,0,2,0,11
12523,2022/08/03,9,4,1,0,10
16062,2022/08/03,4,0,0,0,4
16063,2022/08/03,10,0,1,0,11
19322,2022/08/03,4,0,0,0,4
19516,2022/08/03,10,6,5,0,15
19520,2022/08/03,14,0,4,0,18
75,2022/08/04,25,28,36,0,61
76,2022/08/04,39,40,52,0,91
99,2022/08/04,14,0,0,0,14
117,2022/08/04,3,0,3,0,6
118,2022/08/04,1,0,1,0,2
119,2022/08/04,5,4,2,0,7
120,2022/08/04,3,0,1,0,4
149,2022/08/04,5,0,0,0,5
184,2022/08/04,22,12,16,2,38
195,2022/08/04,28,27,31,0,59
218,2022/08/04,28,18,27,6,55
296,2022/08/04,10,6,6,0,16
300,2022/08/04,10,0,5,0,15
304,2022/08/04,12,6,4,0,16
317,2022/08/04,14,12,13,0,27
343,2022/08/04,0,0,0,0,0
373,2022/08/04,16,12,10,0,26
374,2022/08/04,7,4,4,0,11
388,2022/08/04,21,21,33,0,54
419,2022/08/04,24,6,6,0,30
420,2022/08/04,5,0,5,0,10
462,2022/08/04,9,0,3,0,12
519,2022/08/04,10,6,12,0,22
525,2022/08/04,5,5,1,0,6
596,2022/08/04,8,4,8,0,16
597,2022/08/04,14,12,13,0,27
598,2022/08/04,5,0,2,0,7
1035,2022/08/04,18,6,3,0,21
1084,2022/08/04,10,5,10,0,20
1111,2022/08/04,6,0,0,0,6
1112,2022/08/04,8,0,0,0,8
1113,2022/08/04,6,0,0,0,6
1114,2022/08/04,6,0,0,0,6
1115,2022/08/04,10,0,3,0,13
1117,2022/08/04,4,0,1,0,5
1118,2022/08/04,11,0,2,0,13
1119,2022/08/04,5,0,1,0,6
1692,2022/08/04,6,6,5,0,11
1693,2022/08/04,13,6,7,0,20
1747,2022/08/04,31,20,31,1,62
1772,2022/08/04,10,8,1,0,11
1773,2022/08/04,5,0,2,0,7
1774,2022/08/04,14,0,0,0,14
1782,2022/08/04,18,18,17,0,35
1795,2022/08/04,20,14,20,0,40
1914,2022/08/04,9,0,1,0,10
1915,2022/08/04,10,0,0,0,10
1923,2022/08/04,10,0,2,0,12
1934,2022/08/04,6,0,3,0,9
1963,2022/08/04,11,12,11,0,22
1984,2022/08/04,9,6,6,0,15
2135,2022/08/04,17,0,1,0,18
2136,2022/08/04,6,0,0,0,6
2148,2022/08/04,8,4,5,0,13
2183,2022/08/04,10,6,6,0,16
2193,2022/08/04,19,12,13,4,32
2237,2022/08/04,4,0,0,0,4
2358,2022/08/04,8,8,3,0,11
2361,2022/08/04,11,7,12,0,23
2445,2022/08/04,12,6,2,0,14
2449,2022/08/04,9,6,6,2,15
2451,2022/08/04,10,10,9,0,19
2475,2022/08/04,11,0,2,0,13
2476,2022/08/04,9,0,3,0,12
2507,2022/08/04,16,12,16,0,32
2525,2022/08/04,12,6,1,0,13
2562,2022/08/04,16,6,11,0,27
2582,2022/08/04,11,0,0,0,11
2586,2022/08/04,28,16,22,0,50
2602,2022/08/04,6,0,0,0,6
2631,2022/08/04,9,6,2,0,11
2685,2022/08/04,10,4,9,0,19
2723,2022/08/04,8,0,0,0,8
2730,2022/08/04,10,0,0,0,10
2731,2022/08/04,8,0,0,0,8
2732,2022/08/04,9,0,1,0,10
2734,2022/08/04,4,4,4,0,8
2735,2022/08/04,5,0,2,0,7
2761,2022/08/04,9,15,10,0,19
2788,2022/08/04,9,8,7,0,16
2812,2022/08/04,7,0,0,0,7
2814,2022/08/04,9,0,1,0,10
2913,2022/08/04,5,0,3,0,8
2914,2022/08/04,5,0,0,0,5
3015,2022/08/04,6,0,0,0,6
3035,2022/08/04,7,0,0,0,7
4446,2022/08/04,16,6,12,0,28
12136,2022/08/04,17,18,16,0,33
12516,2022/08/04,10,4,2,0,12
12518,2022/08/04,17,10,2,0,19
12523,2022/08/04,12,4,6,0,18
16062,2022/08/04,4,0,0,0,4
16063,2022/08/04,9,0,3,0,12
19322,2022/08/04,4,0,0,0,4
19516,2022/08/04,17,12,5,1,22
19520,2022/08/04,10,0,0,0,10
75,2022/08/05,29,40,40,0,69
76,2022/08/05,19,32,30,0,49
99,2022/08/05,14,0,0,0,14
117,2022/08/05,4,4,2,0,6
118,2022/08/05,4,4,4,0,8
119,2022/08/05,3,0,1,0,4
120,2022/08/05,6,4,2,0,8
149,2022/08/05,5,0,0,0,5
184,2022/08/05,16,12,13,0,29
195,2022/08/05,24,27,25,0,49
218,2022/08/05,13,18,12,0,25
296,2022/08/05,4,0,4,0,8
300,2022/08/05,13,8,7,0,20
304,2022/08/05,14,6,3,0,17
317,2022/08/05,13,12,13,0,26
343,2022/08/05,4,4,4,0,8
373,2022/08/05,11,6,6,0,17
374,2022/08/05,7,4,0,0,7
388,2022/08/05,15,27,27,0,42
419,2022/08/05,18,0,0,0,18
420,2022/08/05,6,6,4,0,10
462,2022/08/05,6,0,4,0,10
519,2022/08/05,10,12,10,0,20
525,2022/08/05,9,5,2,0,11
596,2022/08/05,4,4,4,0,8
597,2022/08/05,25,24,14,0,39
598,2022/08/05,3,0,1,0,4
1035,2022/08/05,21,6,11,1,32
1084,2022/08/05,16,15,9,0,25
1111,2022/08/05,12,6,1,0,13
1112,2022/08/05,8,0,0,0,8
1113,2022/08/05,6,0,0,0,6
1114,2022/08/05,12,6,3,0,15
1115,2022/08/05,7,0,0,0,7
1117,2022/08/05,11,8,0,0,11
1118,2022/08/05,9,0,3,0,12
1119,2022/08/05,4,0,0,0,4
1692,2022/08/05,7,6,4,0,11
1693,2022/08/05,12,6,2,0,14
1747,2022/08/05,19,20,18,0,37
1772,2022/08/05,9,0,1,0,10
1773,2022/08/05,3,0,0,0,3
1774,2022/08/05,14,0,3,0,17
1782,2022/08/05,19,18,15,0,34
1795,2022/08/05,14,14,13,0,27
1914,2022/08/05,8,0,0,0,8
1915,2022/08/05,10,0,0,0,10
1923,2022/08/05,8,0,2,0,10
1934,2022/08/05,8,5,3,0,11
1963,2022/08/05,12,12,11,0,23
1984,2022/08/05,3,0,2,0,5
2135,2022/08/05,16,0,1,0,17
2136,2022/08/05,6,0,1,0,7
2148,2022/08/05,7,4,2,0,9
2183,2022/08/05,16,12,6,0,22
2193,2022/08/05,14,12,8,0,22
2237,2022/08/05,10,6,2,0,12
2358,2022/08/05,5,0,5,0,10
2361,2022/08/05,6,7,2,0,8
2445,2022/08/05,22,12,9,0,31
2449,2022/08/05,13,12,10,0,23
2451,2022/08/05,11,10,4,0,15
2475,2022/08/05,9,0,0,0,9
2476,2022/08/05,6,0,1,0,7
2507,2022/08/05,6,6,5,0,11
2525,2022/08/05,11,0,1,0,12
2562,2022/08/05,17,12,2,0,19
2582,2022/08/05,11,0,1,0,12
2586,2022/08/05,18,12,14,0,32
2602,2022/08/05,6,0,0,0,6
2631,2022/08/05,7,0,3,0,10
2685,2022/08/05,5,4,4,0,9
2723,2022/08/05,8,0,1,0,9
2730,2022/08/05,10,0,0,0,10
2731,2022/08/05,8,0,0,0,8
2732,2022/08/05,8,0,1,0,9
2734,2022/08/05,4,4,0,0,4
2735,2022/08/05,3,0,3,0,6
2761,2022/08/05,9,10,10,0,19
2788,2022/08/05,14,12,14,0,28
2812,2022/08/05,7,0,0,0,7
2814,2022/08/05,8,0,0,0,8
2913,2022/08/05,2,0,1,0,3
2914,2022/08/05,11,6,1,0,12
3015,2022/08/05,6,0,1,0,7
3035,2022/08/05,7,0,0,0,7
4446,2022/08/05,7,3,5,0,12
12136,2022/08/05,12,12,12,0,24
12516,2022/08/05,12,4,2,0,14
12518,2022/08/05,25,10,5,0,30
12523,2022/08/05,10,4,4,0,14
16062,2022/08/05,4,0,0,0,4
16063,2022/08/05,6,0,1,0,7
19322,2022/08/05,4,0,0,0,4
19516,2022/08/05,11,0,7,0,18
19520,2022/08/05,10,0,0,0,10
75,2022/08/06,17,28,25,0,42
76,2022/08/06,13,24,17,0,30
99,2022/08/06,14,0,1,0,15
117,2022/08/06,6,4,5,0,11
118,2022/08/06,4,4,2,0,6
119,2022/08/06,6,4,0,0,6
120,2022/08/06,4,0,0,0,4
149,2022/08/06,5,0,0,0,5
184,2022/08/06,12,9,8,0,20
195,2022/08/06,23,24,25,0,48
218,2022/08/06,19,18,18,0,37
296,2022/08/06,6,6,2,0,8
300,2022/08/06,6,0,1,0,7
304,2022/08/06,11,0,0,0,11
317,2022/08/06,6,6,4,0,10
343,2022/08/06,4,4,2,0,6
373,2022/08/06,17,12,3,0,20
374,2022/08/06,11,4,5,0,16
388,2022/08/06,6,18,16,0,22
419,2022/08/06,30,12,3,0,33
420,2022/08/06,14,12,2,0,16
462,2022/08/06,10,8,4,0,14
519,2022/08/06,6,6,0,0,6
525,2022/08/06,7,0,1,0,8
596,2022/08/06,0,0,0,0,0
597,2022/08/06,11,0,11,0,22
598,2022/08/06,8,6,2,0,10
1035,2022/08/06,9,0,9,0,18
1084,2022/08/06,6,0,5,0,11
1111,2022/08/06,11,0,2,0,13
1112,2022/08/06,8,0,0,0,8
1113,2022/08/06,6,0,1,0,7
1114,2022/08/06,9,0,2,0,11
1115,2022/08/06,13,6,3,0,16
1117,2022/08/06,11,0,0,0,11
1118,2022/08/06,6,0,2,0,8
1119,2022/08/06,4,0,0,0,4
1692,2022/08/06,9,6,3,0,12
1693,2022/08/06,10,0,3,0,13
1747,2022/08/06,21,20,16,0,37
1772,2022/08/06,8,0,0,0,8
1773,2022/08/06,9,6,1,0,10
1774,2022/08/06,11,0,3,0,14
1782,2022/08/06,22,18,12,0,34
1795,2022/08/06,15,14,14,0,29
1914,2022/08/06,8,0,0,0,8
1915,2022/08/06,10,0,2,0,12
1923,2022/08/06,6,0,3,0,9
1934,2022/08/06,10,5,1,0,11
1963,2022/08/06,19,18,11,0,30
1984,2022/08/06,1,0,0,0,1
2135,2022/08/06,15,0,4,0,19
2136,2022/08/06,5,0,0,0,5
2148,2022/08/06,5,0,1,0,6
2183,2022/08/06,10,0,9,0,19
2193,2022/08/06,18,12,8,4,26
2237,2022/08/06,8,0,2,0,10
2358,2022/08/06,8,8,1,0,9
2361,2022/08/06,4,0,4,0,8
2445,2022/08/06,19,6,6,0,25
2449,2022/08/06,3,0,2,0,5
2451,2022/08/06,12,5,2,0,14
2475,2022/08/06,9,0,1,0,10
2476,2022/08/06,5,0,0,0,5
2507,2022/08/06,13,12,8,0,21
2525,2022/08/06,10,0,2,0,12
2562,2022/08/06,15,0,7,0,22
2582,2022/08/06,14,4,0,0,14
2586,2022/08/06,16,12,8,0,24
2602,2022/08/06,6,0,1,0,7
2631,2022/08/06,10,6,4,0,14
2685,2022/08/06,5,4,6,0,11
2723,2022/08/06,7,0,0,0,7
2730,2022/08/06,10,0,1,0,11
2731,2022/08/06,8,0,1,0,9
2732,2022/08/06,7,0,0,0,7
2734,2022/08/06,8,4,0,0,8
2735,2022/08/06,8,8,4,0,12
2761,2022/08/06,14,15,11,0,25
2788,2022/08/06,12,12,11,1,23
2812,2022/08/06,7,0,0,0,7
2814,2022/08/06,8,0,1,0,9
2913,2022/08/06,1,0,2,0,3
2914,2022/08/06,10,0,2,0,12
3015,2022/08/06,5,0,0,0,5
3035,2022/08/06,7,0,2,0,9
4446,2022/08/06,14,12,4,0,18
12136,2022/08/06,18,18,17,0,35
12516,2022/08/06,10,0,0,0,10
12518,2022/08/06,20,0,2,0,22
12523,2022/08/06,6,0,0,0,6
16062,2022/08/06,4,0,0,0,4
16063,2022/08/06,5,0,0,0,5
19322,2022/08/06,4,0,2,0,6
19516,2022/08/06,16,12,7,1,23
19520,2022/08/06,10,0,0,0,10
75,2022/08/07,16,24,21,0,37
76,2022/08/07,28,32,37,0,65
99,2022/08/07,13,0,0,0,13
117,2022/08/07,1,0,1,0,2
118,2022/08/07,6,4,4,0,10
119,2022/08/07,6,0,1,0,7
120,2022/08/07,8,4,0,1,8
149,2022/08/07,5,0,0,0,5
184,2022/08/07,10,6,3,0,13
195,2022/08/07,22,24,19,0,41
218,2022/08/07,13,12,12,0,25
296,2022/08/07,10,6,6,0,16
300,2022/08/07,5,0,1,0,6
304,2022/08/07,17,6,3,0,20
317,2022/08/07,20,18,7,0,27
343,2022/08/07,6,4,3,0,9
373,2022/08/07,20,6,5,0,25
374,2022/08/07,14,8,3,0,17
388,2022/08/07,2,12,3,0,5
419,2022/08/07,45,18,20,0,65
420,2022/08/07,18,6,6,0,24
462,2022/08/07,14,8,6,0,20
519,2022/08/07,6,0,0,0,6
525,2022/08/07,6,0,1,0,7
596,2022/08/07,4,4,6,0,10
597,2022/08/07,12,12,3,0,15
598,2022/08/07,6,0,2,0,8
1035,2022/08/07,6,6,5,0,11
1084,2022/08/07,6,5,6,0,12
1111,2022/08/07,9,0,2,0,11
1112,2022/08/07,8,0,0,0,8
1113,2022/08/07,11,6,1,0,12
1114,2022/08/07,7,0,1,0,8
1115,2022/08/07,10,0,3,0,13
1117,2022/08/07,11,0,0,0,11
1118,2022/08/07,4,0,3,0,7
1119,2022/08/07,10,6,1,0,11
1692,2022/08/07,6,0,2,0,8
1693,2022/08/07,13,6,10,0,23
1747,2022/08/07,15,10,14,0,29
1772,2022/08/07,8,0,0,0,8
1773,2022/08/07,8,0,2,0,10
1774,2022/08/07,8,0,0,0,8
1782,2022/08/07,22,12,14,0,36
1795,2022/08/07,1,0,0,0,1
1914,2022/08/07,8,0,2,0,10
1915,2022/08/07,8,0,1,0,9
1923,2022/08/07,3,0,2,0,5
1934,2022/08/07,9,0,1,0,10
1963,2022/08/07,26,18,20,0,46
1984,2022/08/07,7,6,5,0,12
2135,2022/08/07,11,0,3,0,14
2136,2022/08/07,5,0,2,0,7
2148,2022/08/07,4,0,0,0,4
2183,2022/08/07,1,0,1,0,2
2193,2022/08/07,12,6,13,0,25
2237,2022/08/07,6,0,2,0,8
2358,2022/08/07,23,16,6,0,29
2361,2022/08/07,7,7,3,0,10
2445,2022/08/07,13,0,12,0,25
2449,2022/08/07,13,12,7,0,20
2451,2022/08/07,25,15,8,0,33
2475,2022/08/07,8,0,0,0,8
2476,2022/08/07,11,6,2,0,13
2507,2022/08/07,17,12,6,0,23
2525,2022/08/07,8,0,1,0,9
2562,2022/08/07,20,12,8,0,28
2582,2022/08/07,14,0,1,0,15
2586,2022/08/07,16,8,4,0,20
2602,2022/08/07,5,0,0,0,5
2631,2022/08/07,12,6,4,0,16
2685,2022/08/07,3,4,3,0,6
2723,2022/08/07,7,0,1,0,8
2730,2022/08/07,15,6,0,0,15
2731,2022/08/07,7,0,2,0,9
2732,2022/08/07,7,0,0,0,7
2734,2022/08/07,8,0,1,0,9
2735,2022/08/07,4,0,1,0,5
2761,2022/08/07,13,10,9,0,22
2788,2022/08/07,12,12,6,0,18
2812,2022/08/07,7,0,1,0,8
2814,2022/08/07,7,0,3,0,10
2913,2022/08/07,5,6,0,0,5
2914,2022/08/07,8,0,1,0,9
3015,2022/08/07,5,0,1,0,6
3035,2022/08/07,5,0,1,0,6
4446,2022/08/07,19,9,4,0,23
12136,2022/08/07,16,15,12,0,28
12516,2022/08/07,10,0,3,0,13
12518,2022/08/07,18,0,4,0,22
12523,2022/08/07,10,4,3,0,13
16062,2022/08/07,4,0,0,0,4
16063,2022/08/07,11,6,2,0,13
19322,2022/08/07,2,0,1,0,3
19516,2022/08/07,14,6,18,0,32
19520,2022/08/07,10,0,0,0,10
75,2022/08/08,31,36,30,0,61
76,2022/08/08,27,36,22,0,49
99,2022/08/08,13,0,1,0,14
117,2022/08/08,4,4,0,0,4
118,2022/08/08,6,4,1,0,7
119,2022/08/08,9,4,1,0,10
120,2022/08/08,7,0,0,0,7
149,2022/08/08,5,0,0,0,5
184,2022/08/08,16,9,10,0,26
195,2022/08/08,33,30,23,0,56
218,2022/08/08,22,21,15,0,37
296,2022/08/08,10,6,1,0,11
300,2022/08/08,12,8,3,0,15
304,2022/08/08,20,6,5,0,25
317,2022/08/08,31,18,10,0,41
343,2022/08/08,3,0,1,0,4
373,2022/08/08,21,6,6,0,27
374,2022/08/08,11,0,2,0,13
388,2022/08/08,23,24,24,0,47
419,2022/08/08,37,12,9,0,46
420,2022/08/08,24,12,8,0,32
462,2022/08/08,16,8,6,0,22
519,2022/08/08,18,12,3,0,21
525,2022/08/08,10,5,0,0,10
596,2022/08/08,2,4,3,0,5
597,2022/08/08,21,12,6,0,27
598,2022/08/08,10,6,1,0,11
1035,2022/08/08,1,0,1,0,2
1084,2022/08/08,5,5,5,0,10
1111,2022/08/08,7,0,1,0,8
1112,2022/08/08,8,0,1,0,9
1113,2022/08/08,10,0,2,0,12
1114,2022/08/08,6,0,0,0,6
1115,2022/08/08,7,0,3,0,10
1117,2022/08/08,11,0,0,0,11
1118,2022/08/08,7,6,1,0,8
1119,2022/08/08,9,0,0,0,9
1692,2022/08/08,10,6,4,0,14
1693,2022/08/08,9,6,1,0,10
1747,2022/08/08,21,20,17,0,38
1772,2022/08/08,8,0,1,0,9
1773,2022/08/08,6,0,0,0,6
1774,2022/08/08,8,0,1,0,9
1782,2022/08/08,26,18,26,0,52
1795,2022/08/08,15,14,11,0,26
1914,2022/08/08,6,0,0,0,6
1915,2022/08/08,7,0,0,0,7
1923,2022/08/08,1,0,2,0,3
1934,2022/08/08,8,0,3,0,11
1963,2022/08/08,24,18,5,4,29
1984,2022/08/08,8,6,4,0,12
2135,2022/08/08,8,0,4,0,12
2136,2022/08/08,3,0,0,0,3
2148,2022/08/08,4,0,1,0,5
2183,2022/08/08,6,6,1,0,7
2193,2022/08/08,11,12,8,0,19
2237,2022/08/08,4,0,2,0,6
2358,2022/08/08,17,0,8,0,25
2361,2022/08/08,4,0,2,0,6
2445,2022/08/08,1,0,1,0,2
2449,2022/08/08,18,12,6,0,24
2451,2022/08/08,17,0,2,0,19
2475,2022/08/08,8,0,0,0,8
2476,2022/08/08,9,0,1,0,10
2507,2022/08/08,23,12,12,1,35
2525,2022/08/08,7,0,0,0,7
2562,2022/08/08,24,12,7,0,31
2582,2022/08/08,13,0,0,0,13
2586,2022/08/08,24,12,6,2,30
2602,2022/08/08,5,0,0,0,5
2631,2022/08/08,8,0,1,0,9
2685,2022/08/08,4,4,4,0,8
2723,2022/08/08,6,0,0,0,6
2730,2022/08/08,15,0,3,0,18
2731,2022/08/08,5,0,0,0,5
2732,2022/08/08,7,0,0,0,7
2734,2022/08/08,7,0,1,0,8
2735,2022/08/08,3,0,0,0,3
2761,2022/08/08,19,15,14,0,33
2788,2022/08/08,18,12,17,0,35
2812,2022/08/08,6,0,0,0,6
2814,2022/08/08,4,0,2,0,6
2913,2022/08/08,5,0,0,0,5
2914,2022/08/08,7,0,0,0,7
3015,2022/08/08,4,0,0,0,4
3035,2022/08/08,4,0,2,0,6
4446,2022/08/08,27,12,6,7,33
12136,2022/08/08,19,15,8,0,27
12516,2022/08/08,7,0,1,0,8
12518,2022/08/08,14,0,2,0,16
12523,2022/08/08,7,0,2,0,9
16062,2022/08/08,4,0,0,0,4
16063,2022/08/08,9,0,3,0,12
19322,2022/08/08,1,0,0,0,1
19516,2022/08/08,2,6,2,0,4
19520,2022/08/08,10,0,0,0,10
75,2022/08/09,33,32,23,0,56
76,2022/08/09,37,32,25,0,62
99,2022/08/09,12,0,0,0,12
117,2022/08/09,4,0,2,0,6
118,2022/08/09,9,4,4,0,13
119,2022/08/09,8,0,1,0,9
120,2022/08/09,7,0,1,0,8
149,2022/08/09,5,0,0,0,5
184,2022/08/09,12,6,7,0,19
195,2022/08/09,34,24,24,4,58
218,2022/08/09,25,18,20,2,45
296,2022/08/09,15,6,9,0,24
300,2022/08/09,9,0,4,0,13
304,2022/08/09,15,0,4,0,19
317,2022/08/09,39,18,11,0,50
343,2022/08/09,6,4,3,0,9
373,2022/08/09,27,12,11,0,38
374,2022/08/09,13,4,2,0,15
388,2022/08/09,20,21,17,0,37
419,2022/08/09,34,6,7,0,41
420,2022/08/09,22,6,11,0,33
462,2022/08/09,18,8,8,0,26
519,2022/08/09,27,12,2,0,29
525,2022/08/09,10,0,1,0,11
596,2022/08/09,3,4,5,0,8
597,2022/08/09,21,6,7,0,28
598,2022/08/09,9,0,2,0,11
1035,2022/08/09,6,6,3,0,9
1084,2022/08/09,10,10,9,0,19
1111,2022/08/09,6,0,0,0,6
1112,2022/08/09,7,0,2,0,9
1113,2022/08/09,8,0,0,0,8
1114,2022/08/09,12,6,4,0,16
1115,2022/08/09,4,0,4,0,8
1117,2022/08/09,11,0,1,0,12
1118,2022/08/09,12,6,1,0,13
1119,2022/08/09,9,0,1,0,10
1692,2022/08/09,12,6,3,0,15
1693,2022/08/09,8,0,6,0,14
1747,2022/08/09,19,15,7,0,26
1772,2022/08/09,7,0,2,0,9
1773,2022/08/09,6,0,0,0,6
1774,2022/08/09,7,0,0,0,7
1782,2022/08/09,6,6,6,0,12
1795,2022/08/09,25,21,16,0,41
1914,2022/08/09,6,0,0,0,6
1915,2022/08/09,7,0,0,0,7
1923,2022/08/09,5,6,4,0,9
1934,2022/08/09,10,5,3,2,13
1963,2022/08/09,33,18,23,0,56
1984,2022/08/09,4,0,3,0,7
2135,2022/08/09,4,0,1,0,5
2136,2022/08/09,3,0,1,0,4
2148,2022/08/09,7,4,4,0,11
2183,2022/08/09,11,6,5,1,16
2193,2022/08/09,12,9,8,0,20
2237,2022/08/09,8,6,2,0,10
2358,2022/08/09,9,0,5,0,14
2361,2022/08/09,9,7,4,2,13
2445,2022/08/09,6,6,6,0,12
2449,2022/08/09,24,12,8,0,32
2451,2022/08/09,15,0,5,0,20
2475,2022/08/09,8,0,0,0,8
2476,2022/08/09,8,0,0,0,8
2507,2022/08/09,16,6,4,0,20
2525,2022/08/09,7,0,3,0,10
2562,2022/08/09,23,6,7,0,30
2582,2022/08/09,17,4,3,0,20
2586,2022/08/09,28,12,14,3,42
2602,2022/08/09,5,0,1,0,6
2631,2022/08/09,7,0,4,0,11
2685,2022/08/09,4,4,3,0,7
2723,2022/08/09,6,0,1,0,7
2730,2022/08/09,12,0,2,0,14
2731,2022/08/09,5,0,0,0,5
2732,2022/08/09,7,0,0,0,7
2734,2022/08/09,10,4,4,0,14
2735,2022/08/09,3,0,2,0,5
2761,2022/08/09,15,10,9,0,24
2788,2022/08/09,17,16,14,0,31
2812,2022/08/09,6,0,0,0,6
2814,2022/08/09,2,0,0,0,2
2913,2022/08/09,5,0,1,0,6
2914,2022/08/09,7,0,1,0,8
3015,2022/08/09,4,0,1,0,5
3035,2022/08/09,8,6,0,0,8
4446,2022/08/09,23,9,5,3,28
12136,2022/08/09,23,12,13,8,36
12516,2022/08/09,10,4,2,0,12
12518,2022/08/09,12,0,4,0,16
12523,2022/08/09,9,4,4,0,13
16062,2022/08/09,10,6,2,0,12
16063,2022/08/09,6,0,4,0,10
19322,2022/08/09,7,6,0,0,7
19516,2022/08/09,6,6,6,0,12
19520,2022/08/09,10,0,0,0,10
75,2022/08/10,42,32,37,2,79
76,2022/08/10,44,32,42,0,86
99,2022/08/10,12,0,1,0,13
117,2022/08/10,6,4,1,0,7
118,2022/08/10,9,4,2,0,11
119,2022/08/10,7,0,2,0,9
120,2022/08/10,6,0,1,2,7
149,2022/08/10,5,0,2,0,7
184,2022/08/10,14,9,9,1,23
195,2022/08/10,30,24,21,1,51
218,2022/08/10,24,21,22,0,46
296,2022/08/10,12,6,7,0,19
300,2022/08/10,13,8,5,0,18
304,2022/08/10,11,0,6,0,17
317,2022/08/10,40,12,17,0,57
343,2022/08/10,3,0,1,0,4
373,2022/08/10,22,6,18,1,40
374,2022/08/10,15,4,8,0,23
388,2022/08/10,21,18,21,2,42
419,2022/08/10,33,6,12,0,45
420,2022/08/10,11,0,11,0,22
462,2022/08/10,10,0,6,0,16
519,2022/08/10,31,6,8,1,39
525,2022/08/10,9,0,0,5,9
596,2022/08/10,2,4,3,0,5
597,2022/08/10,26,12,11,0,37
598,2022/08/10,7,0,1,0,8
1035,2022/08/10,9,6,3,0,12
1084,2022/08/10,6,5,5,0,11
1111,2022/08/10,6,0,0,0,6
1112,2022/08/10,5,0,0,0,5
1113,2022/08/10,8,0,0,0,8
1114,2022/08/10,8,0,0,0,8
1115,2022/08/10,6,6,0,0,6
1117,2022/08/10,10,0,0,0,10
1118,2022/08/10,11,0,2,0,13
1119,2022/08/10,8,0,0,0,8
1692,2022/08/10,15,6,14,0,29
1693,2022/08/10,8,6,7,0,15
1747,2022/08/10,22,10,13,0,35
1772,2022/08/10,5,0,0,0,5
1773,2022/08/10,6,0,0,0,6
1774,2022/08/10,7,0,1,0,8
1782,2022/08/10,18,18,19,0,37
1795,2022/08/10,16,7,13,0,29
1914,2022/08/10,6,0,1,0,7
1915,2022/08/10,7,0,1,0,8
1923,2022/08/10,7,6,2,0,9
1934,2022/08/10,5,0,1,1,6
1963,2022/08/10,28,18,26,0,54
1984,2022/08/10,1,0,0,0,1
2135,2022/08/10,3,0,1,0,4
2136,2022/08/10,8,6,1,0,9
2148,2022/08/10,7,4,3,0,10
2183,2022/08/10,11,6,4,0,15
2193,2022/08/10,16,12,12,0,28
2237,2022/08/10,6,0,0,0,6
2358,2022/08/10,4,0,4,0,8
2361,2022/08/10,10,7,5,0,15
2445,2022/08/10,0,0,0,0,0
2449,2022/08/10,22,6,18,0,40
2451,2022/08/10,10,0,8,0,18
2475,2022/08/10,8,0,0,0,8
2476,2022/08/10,8,0,0,0,8
2507,2022/08/10,24,12,5,0,29
2525,2022/08/10,4,0,0,0,4
2562,2022/08/10,22,6,14,0,36
2582,2022/08/10,14,0,2,0,16
2586,2022/08/10,23,12,7,1,30
2602,2022/08/10,4,0,1,0,5
2631,2022/08/10,9,6,5,1,14
2685,2022/08/10,9,8,1,0,10
2723,2022/08/10,5,0,0,0,5
2730,2022/08/10,10,0,0,0,10
2731,2022/08/10,11,6,1,0,12
2732,2022/08/10,7,0,0,0,7
2734,2022/08/10,6,0,0,0,6
2735,2022/08/10,9,8,4,0,13
2761,2022/08/10,21,15,8,0,29
2788,2022/08/10,15,12,9,0,24
2812,2022/08/10,6,0,0,0,6
2814,2022/08/10,8,6,0,0,8
2913,2022/08/10,10,6,2,0,12
2914,2022/08/10,6,0,0,0,6
3015,2022/08/10,3,0,0,0,3
3035,2022/08/10,8,0,0,0,8
4446,2022/08/10,15,0,12,0,27
12136,2022/08/10,26,24,21,0,47
12516,2022/08/10,8,0,1,0,9
12518,2022/08/10,18,10,1,0,19
12523,2022/08/10,5,0,1,0,6
16062,2022/08/10,8,0,0,0,8
16063,2022/08/10,2,0,0,0,2
19322,2022/08/10,7,0,0,0,7
19516,2022/08/10,12,12,12,0,24
19520,2022/08/10,10,0,1,0,11
75,2022/08/11,35,32,36,0,71
76,2022/08/11,46,44,44,0,90
99,2022/08/11,11,0,0,0,11
117,2022/08/11,5,0,1,0,6
118,2022/08/11,7,0,4,0,11
119,2022/08/11,9,4,0,4,9
120,2022/08/11,3,0,0,0,3
149,2022/08/11,3,0,0,0,3
184,2022/08/11,13,9,9,0,22
195,2022/08/11,38,30,22,2,60
218,2022/08/11,23,21,20,2,43
296,2022/08/11,5,0,3,0,8
300,2022/08/11,8,0,1,0,9
304,2022/08/11,5,0,1,0,6
317,2022/08/11,29,6,18,0,47
343,2022/08/11,6,4,2,0,8
373,2022/08/11,9,6,9,1,18
374,2022/08/11,7,0,3,0,10
388,2022/08/11,10,12,10,0,20
419,2022/08/11,27,6,7,0,34
420,2022/08/11,6,6,6,0,12
462,2022/08/11,12,8,5,0,17
519,2022/08/11,28,6,3,6,31
525,2022/08/11,4,0,3,0,7
596,2022/08/11,7,8,0,0,7
597,2022/08/11,21,6,12,0,33
598,2022/08/11,6,0,1,0,7
1035,2022/08/11,12,6,10,0,22
1084,2022/08/11,11,10,6,0,17
1111,2022/08/11,13,6,1,0,14
1112,2022/08/11,6,0,0,0,6
1113,2022/08/11,13,0,0,0,13
1114,2022/08/11,2,0,2,0,4
1115,2022/08/11,19,0,2,0,21
1118,2022/08/11,9,0,2,0,11
1119,2022/08/11,8,0,0,0,8
1692,2022/08/11,7,6,6,0,13
1693,2022/08/11,7,6,6,0,13
1747,2022/08/11,34,25,24,0,58
1772,2022/08/11,3,0,0,0,3
1773,2022/08/11,3,0,0,0,3
1774,2022/08/11,6,0,2,0,8
1782,2022/08/11,17,18,16,0,33
1795,2022/08/11,17,14,19,0,36
1914,2022/08/11,5,0,0,0,5
1915,2022/08/11,6,0,1,0,7
1923,2022/08/11,8,0,2,0,10
1934,2022/08/11,3,0,1,0,4
1963,2022/08/11,14,12,17,0,31
1984,2022/08/11,7,6,5,0,12
2135,2022/08/11,7,6,1,0,8
2136,2022/08/11,7,0,0,0,7
2148,2022/08/11,4,0,1,0,5
2183,2022/08/11,7,0,2,0,9
2193,2022/08/11,16,12,9,0,25
2237,2022/08/11,7,0,2,0,9
2358,2022/08/11,8,8,10,0,18
2361,2022/08/11,12,7,3,0,15
2445,2022/08/11,6,6,6,0,12
2449,2022/08/11,10,6,9,0,19
2451,2022/08/11,12,10,4,0,16
2475,2022/08/11,7,0,0,0,7
2476,2022/08/11,12,0,0,0,12
2507,2022/08/11,31,12,16,0,47
2525,2022/08/11,6,0,0,0,6
2562,2022/08/11,14,6,9,0,23
2582,2022/08/11,12,0,0,0,12
2586,2022/08/11,27,12,13,3,40
2602,2022/08/11,3,0,2,0,5
2631,2022/08/11,3,0,2,0,5
2685,2022/08/11,16,8,5,0,21
2723,2022/08/11,5,0,0,0,5
2730,2022/08/11,10,0,1,0,11
2731,2022/08/11,9,0,0,0,9
2732,2022/08/11,7,0,0,0,7
2734,2022/08/11,6,0,0,0,6
2735,2022/08/11,5,0,0,0,5
2761,2022/08/11,23,10,10,0,33
2788,2022/08/11,18,12,8,3,26
2812,2022/08/11,0,0,0,0,0
2814,2022/08/11,6,0,0,0,6
2913,2022/08/11,8,0,1,0,9
2914,2022/08/11,6,0,0,0,6
3015,2022/08/11,11,8,1,0,12
3033,2022/08/11,6,0,1,0,7
3035,2022/08/11,7,0,0,0,7
4446,2022/08/11,9,6,7,0,16
12136,2022/08/11,17,12,13,4,30
12516,2022/08/11,7,0,2,0,9
12518,2022/08/11,17,0,3,0,20
12523,2022/08/11,8,4,3,0,11
16062,2022/08/11,8,0,0,0,8
16063,2022/08/11,7,6,1,0,8
19322,2022/08/11,7,0,0,0,7
19516,2022/08/11,6,6,5,0,11
19520,2022/08/11,9,0,0,0,9
75,2022/08/12,33,32,30,0,63
76,2022/08/12,28,28,24,0,52
99,2022/08/12,11,0,0,0,11
117,2022/08/12,8,4,2,0,10
118,2022/08/12,3,0,2,0,5
119,2022/08/12,5,0,1,0,6
120,2022/08/12,3,0,1,2,4
149,2022/08/12,3,0,1,0,4
184,2022/08/12,13,12,11,0,24
195,2022/08/12,34,24,23,11,57
218,2022/08/12,17,15,12,0,29
296,2022/08/12,8,6,3,0,11
300,2022/08/12,7,0,1,0,8
304,2022/08/12,6,6,4,0,10
317,2022/08/12,11,0,11,0,22
343,2022/08/12,8,4,3,0,11
373,2022/08/12,-1,0,0,0,-1
374,2022/08/12,4,0,3,0,7
388,2022/08/12,24,24,18,0,42
419,2022/08/12,32,12,11,1,43
420,2022/08/12,6,6,6,0,12
462,2022/08/12,7,0,6,0,13
519,2022/08/12,19,0,12,0,31
525,2022/08/12,1,0,1,0,2
596,2022/08/12,19,8,5,0,24
597,2022/08/12,31,24,14,2,45
598,2022/08/12,5,0,0,0,5
1035,2022/08/12,8,6,8,0,16
1084,2022/08/12,19,15,7,0,26
1111,2022/08/12,12,0,0,0,12
1112,2022/08/12,6,0,0,0,6
1113,2022/08/12,13,0,1,0,14
1114,2022/08/12,6,6,1,0,7
1115,2022/08/12,23,6,3,0,26
1117,2022/08/12,10,0,0,0,10
1118,2022/08/12,7,0,0,0,7
1119,2022/08/12,8,0,1,0,9
1692,2022/08/12,1,0,0,0,1
1693,2022/08/12,7,6,6,0,13
1747,2022/08/12,31,20,16,0,47
1772,2022/08/12,11,8,0,0,11
1773,2022/08/12,9,6,0,0,9
1774,2022/08/12,4,0,0,0,4
1782,2022/08/12,24,24,13,0,37
1795,2022/08/12,13,14,10,0,23
1914,2022/08/12,5,0,2,0,7
1915,2022/08/12,5,0,0,0,5
1923,2022/08/12,12,6,3,0,15
1934,2022/08/12,6,5,1,0,7
1963,2022/08/12,3,6,10,1,13
1984,2022/08/12,8,6,6,0,14
2135,2022/08/12,6,0,1,0,7
2136,2022/08/12,7,0,1,0,8
2148,2022/08/12,7,4,4,0,11
2183,2022/08/12,5,0,4,0,9
2193,2022/08/12,14,12,12,2,26
2237,2022/08/12,11,6,4,0,15
2358,2022/08/12,6,8,5,0,11
2361,2022/08/12,10,0,5,0,15
2445,2022/08/12,6,6,7,0,13
2449,2022/08/12,1,0,0,0,1
2451,2022/08/12,7,0,5,0,12
2475,2022/08/12,7,0,1,0,8
2476,2022/08/12,12,0,1,0,13
2507,2022/08/12,21,6,14,2,35
2525,2022/08/12,12,6,0,0,12
2562,2022/08/12,6,6,4,0,10
2582,2022/08/12,12,0,0,0,12
2586,2022/08/12,10,0,10,0,20
2602,2022/08/12,9,8,0,0,9
2631,2022/08/12,1,0,1,0,2
2685,2022/08/12,14,4,5,1,19
2723,2022/08/12,5,0,0,0,5
2730,2022/08/12,9,0,0,0,9
2731,2022/08/12,9,0,1,0,10
2732,2022/08/12,7,0,0,0,7
2734,2022/08/12,6,0,2,0,8
2735,2022/08/12,5,0,0,0,5
2761,2022/08/12,19,10,11,0,30
2788,2022/08/12,18,12,16,1,34
2812,2022/08/12,0,0,0,0,0
2814,2022/08/12,6,0,1,0,7
2913,2022/08/12,7,0,5,0,12
2914,2022/08/12,6,0,0,0,6
3015,2022/08/12,10,0,0,0,10
3033,2022/08/12,5,0,0,0,5
3035,2022/08/12,7,0,1,0,8
4446,2022/08/12,13,12,10,0,23
12136,2022/08/12,11,12,11,0,22
12516,2022/08/12,5,0,2,1,7
12518,2022/08/12,14,0,3,0,17
12523,2022/08/12,9,4,2,0,11
16062,2022/08/12,8,0,0,0,8
16063,2022/08/12,12,6,1,0,13
19322,2022/08/12,7,0,1,0,8
19516,2022/08/12,7,6,3,0,10
19520,2022/08/12,9,0,0,0,9
75,2022/08/13,23,20,20,0,43
76,2022/08/13,20,16,19,0,39
99,2022/08/13,11,0,1,0,12
117,2022/08/13,10,4,2,0,12
118,2022/08/13,5,4,4,0,9
119,2022/08/13,4,0,1,0,5
120,2022/08/13,0,0,0,0,0
149,2022/08/13,8,6,0,0,8
184,2022/08/13,11,9,8,0,19
195,2022/08/13,24,24,24,0,48
218,2022/08/13,23,18,21,0,44
296,2022/08/13,11,6,4,0,15
300,2022/08/13,14,8,3,0,17
304,2022/08/13,2,0,2,0,4
317,2022/08/13,12,12,14,0,26
343,2022/08/13,5,0,1,0,6
373,2022/08/13,-1,0,0,0,-1
374,2022/08/13,5,4,4,0,9
388,2022/08/13,18,12,16,3,34
419,2022/08/13,20,0,0,0,20
420,2022/08/13,6,6,7,0,13
462,2022/08/13,9,8,5,0,14
519,2022/08/13,13,6,2,0,15
525,2022/08/13,0,0,0,0,0
596,2022/08/13,14,0,2,0,16
597,2022/08/13,15,0,13,1,28
598,2022/08/13,11,6,0,0,11
1035,2022/08/13,6,6,5,0,11
1084,2022/08/13,12,0,6,0,18
1111,2022/08/13,12,0,4,0,16
1112,2022/08/13,6,0,0,0,6
1113,2022/08/13,12,0,0,0,12
1114,2022/08/13,11,6,2,0,13
1115,2022/08/13,20,0,5,0,25
1117,2022/08/13,10,0,0,0,10
1118,2022/08/13,7,0,2,0,9
1119,2022/08/13,7,0,1,0,8
1692,2022/08/13,1,0,0,0,1
1693,2022/08/13,1,0,0,0,1
1747,2022/08/13,20,5,17,0,37
1772,2022/08/13,11,0,0,0,11
1773,2022/08/13,9,0,1,0,10
1774,2022/08/13,4,0,2,0,6
1782,2022/08/13,26,15,10,0,36
1795,2022/08/13,24,21,17,0,41
1914,2022/08/13,3,0,0,0,3
1915,2022/08/13,5,0,0,0,5
1923,2022/08/13,9,0,1,0,10
1934,2022/08/13,5,0,1,1,6
1963,2022/08/13,4,12,12,0,16
1984,2022/08/13,8,6,1,0,9
2135,2022/08/13,5,0,2,0,7
2136,2022/08/13,6,0,1,0,7
2148,2022/08/13,7,4,0,0,7
2183,2022/08/13,7,6,5,0,12
2193,2022/08/13,6,6,5,1,11
2237,2022/08/13,7,0,1,0,8
2358,2022/08/13,1,0,2,0,3
2361,2022/08/13,12,7,4,0,16
2445,2022/08/13,5,6,2,0,7
2449,2022/08/13,7,6,6,0,13
2451,2022/08/13,2,0,2,0,4
2475,2022/08/13,6,0,0,0,6
2476,2022/08/13,11,0,0,0,11
2507,2022/08/13,5,0,4,0,9
2525,2022/08/13,12,0,0,0,12
2562,2022/08/13,8,6,8,0,16
2582,2022/08/13,12,0,0,0,12
2586,2022/08/13,12,12,11,0,23
2602,2022/08/13,9,0,3,0,12
2631,2022/08/13,6,6,8,0,14
2685,2022/08/13,12,4,5,1,17
2723,2022/08/13,5,0,0,0,5
2730,2022/08/13,9,0,0,0,9
2731,2022/08/13,8,0,0,0,8
2732,2022/08/13,7,0,0,0,7
2734,2022/08/13,8,4,1,0,9
2735,2022/08/13,13,8,5,0,18
2761,2022/08/13,18,10,12,0,30
2788,2022/08/13,13,12,11,0,24
2812,2022/08/13,6,6,0,0,6
2813,2022/08/13,6,6,1,0,7
2814,2022/08/13,5,0,1,0,6
2913,2022/08/13,8,6,2,0,10
2914,2022/08/13,6,0,0,0,6
3015,2022/08/13,10,0,0,0,10
3033,2022/08/13,5,0,0,0,5
3035,2022/08/13,6,0,1,0,7
4446,2022/08/13,9,6,4,0,13
12136,2022/08/13,18,18,18,0,36
12516,2022/08/13,6,4,2,0,8
12518,2022/08/13,11,0,1,0,12
12523,2022/08/13,11,4,4,0,15
16062,2022/08/13,8,0,0,0,8
16063,2022/08/13,11,0,3,0,14
19322,2022/08/13,6,0,0,0,6
19516,2022/08/13,10,6,9,0,19
19520,2022/08/13,9,0,2,0,11
75,2022/08/14,27,24,14,0,41
76,2022/08/14,25,24,10,0,35
99,2022/08/14,10,0,2,0,12
117,2022/08/14,8,0,5,0,13
118,2022/08/14,5,4,1,0,6
119,2022/08/14,3,0,2,0,5
120,2022/08/14,4,4,1,0,5
149,2022/08/14,8,0,1,0,9
184,2022/08/14,9,6,7,0,16
195,2022/08/14,18,18,16,0,34
218,2022/08/14,17,15,14,0,31
296,2022/08/14,13,6,9,0,22
300,2022/08/14,11,0,4,0,15
304,2022/08/14,6,6,0,0,6
317,2022/08/14,10,12,10,0,20
343,2022/08/14,4,0,1,0,5
373,2022/08/14,0,0,0,0,0
374,2022/08/14,9,8,3,0,12
388,2022/08/14,11,12,4,0,15
419,2022/08/14,20,0,0,0,20
420,2022/08/14,11,12,11,0,22
462,2022/08/14,12,8,4,0,16
519,2022/08/14,17,6,11,1,28
525,2022/08/14,5,5,2,0,7
596,2022/08/14,16,4,3,2,19
597,2022/08/14,1,0,1,0,2
598,2022/08/14,11,0,1,0,12
1035,2022/08/14,1,0,1,0,2
1084,2022/08/14,11,5,5,0,16
1111,2022/08/14,8,0,3,0,11
1112,2022/08/14,6,0,0,0,6
1113,2022/08/14,12,0,0,0,12
1114,2022/08/14,9,0,4,0,13
1115,2022/08/14,15,0,2,0,17
1117,2022/08/14,10,0,0,0,10
1118,2022/08/14,11,6,2,0,13
1119,2022/08/14,6,0,0,0,6
1692,2022/08/14,7,6,6,0,13
1693,2022/08/14,13,12,12,0,25
1747,2022/08/14,13,10,10,0,23
1772,2022/08/14,11,0,2,0,13
1773,2022/08/14,8,0,1,0,9
1774,2022/08/14,10,8,1,0,11
1782,2022/08/14,28,12,9,8,37
1795,2022/08/14,7,0,7,0,14
1915,2022/08/14,11,6,0,0,11
1923,2022/08/14,8,0,1,0,9
1934,2022/08/14,8,5,1,0,9
1963,2022/08/14,-8,0,9,0,1
1984,2022/08/14,7,0,1,0,8
2135,2022/08/14,9,6,4,0,13
2136,2022/08/14,5,0,2,0,7
2148,2022/08/14,11,4,0,1,11
2183,2022/08/14,8,6,3,0,11
2193,2022/08/14,12,12,3,0,15
2237,2022/08/14,6,0,0,0,6
2358,2022/08/14,15,16,5,0,20
2361,2022/08/14,15,7,0,0,15
2445,2022/08/14,9,6,4,0,13
2449,2022/08/14,13,12,12,0,25
2451,2022/08/14,20,20,6,0,26
2475,2022/08/14,6,0,0,0,6
2476,2022/08/14,11,0,0,0,11
2507,2022/08/14,7,6,8,0,15
2525,2022/08/14,12,0,0,0,12
2562,2022/08/14,6,6,6,0,12
2582,2022/08/14,12,0,2,0,14
2586,2022/08/14,9,8,6,1,15
2602,2022/08/14,6,0,3,0,9
2631,2022/08/14,4,6,4,0,8
2685,2022/08/14,10,4,2,0,12
2723,2022/08/14,5,0,2,0,7
2730,2022/08/14,9,0,1,0,10
2731,2022/08/14,8,0,1,0,9
2732,2022/08/14,7,0,1,0,8
2734,2022/08/14,7,0,3,0,10
2735,2022/08/14,8,0,4,0,12
2761,2022/08/14,11,5,7,0,18
2788,2022/08/14,14,12,7,0,21
2812,2022/08/14,12,6,1,0,13
2813,2022/08/14,11,6,0,0,11
2814,2022/08/14,4,0,1,0,5
2913,2022/08/14,6,0,4,0,10
2914,2022/08/14,6,0,1,0,7
3015,2022/08/14,10,0,1,0,11
3033,2022/08/14,5,0,0,0,5
3035,2022/08/14,5,0,0,0,5
4446,2022/08/14,14,9,4,0,18
12136,2022/08/14,15,15,13,0,28
12516,2022/08/14,4,0,0,0,4
12518,2022/08/14,10,0,4,0,14
12523,2022/08/14,11,4,5,0,16
16062,2022/08/14,8,0,0,0,8
16063,2022/08/14,8,0,1,0,9
19322,2022/08/14,6,0,0,0,6
19516,2022/08/14,1,0,0,0,1
19520,2022/08/14,7,0,0,0,7
75,2022/08/15,50,36,41,4,91
76,2022/08/15,59,44,49,4,108
99,2022/08/15,8,0,0,0,8
117,2022/08/15,3,0,2,0,5
118,2022/08/15,8,4,4,0,12
119,2022/08/15,5,4,2,0,7
120,2022/08/15,3,0,1,0,4
149,2022/08/15,7,0,1,0,8
184,2022/08/15,14,12,6,0,20
195,2022/08/15,31,27,29,0,60
218,2022/08/15,24,21,19,0,43
296,2022/08/15,10,6,6,0,16
300,2022/08/15,15,8,5,0,20
304,2022/08/15,12,6,4,0,16
317,2022/08/15,30,30,13,0,43
343,2022/08/15,7,4,1,0,8
373,2022/08/15,12,12,8,0,20
374,2022/08/15,6,0,4,0,10
388,2022/08/15,31,24,28,0,59
419,2022/08/15,32,12,11,0,43
420,2022/08/15,6,6,6,0,12
462,2022/08/15,16,8,3,0,19
519,2022/08/15,11,6,1,0,12
525,2022/08/15,3,0,0,0,3
596,2022/08/15,11,0,3,0,14
597,2022/08/15,12,12,10,0,22
598,2022/08/15,10,0,1,0,11
1035,2022/08/15,6,6,3,0,9
1084,2022/08/15,16,10,9,0,25
1111,2022/08/15,5,0,0,0,5
1112,2022/08/15,6,0,0,0,6
1113,2022/08/15,12,0,0,0,12
1114,2022/08/15,5,0,3,0,8
1115,2022/08/15,13,0,2,0,15
1117,2022/08/15,10,0,0,0,10
1118,2022/08/15,9,0,1,0,10
1119,2022/08/15,6,0,0,0,6
1692,2022/08/15,13,12,7,0,20
1693,2022/08/15,7,6,6,0,13
1747,2022/08/15,18,15,12,0,30
1772,2022/08/15,9,0,1,0,10
1773,2022/08/15,7,0,0,0,7
1774,2022/08/15,9,0,0,0,9
1782,2022/08/15,32,21,13,2,45
1795,2022/08/15,15,14,12,0,27
1915,2022/08/15,11,0,0,0,11
1923,2022/08/15,7,0,0,0,7
1934,2022/08/15,7,0,5,0,12
1963,2022/08/15,8,24,19,0,27
1984,2022/08/15,12,6,0,0,12
2135,2022/08/15,5,0,2,0,7
2136,2022/08/15,3,0,0,0,3
2148,2022/08/15,10,0,1,0,11
2183,2022/08/15,5,0,3,0,8
2193,2022/08/15,21,12,15,2,36
2237,2022/08/15,12,6,0,0,12
2358,2022/08/15,10,0,2,0,12
2361,2022/08/15,15,0,5,0,20
2445,2022/08/15,11,6,3,0,14
2449,2022/08/15,19,18,10,0,29
2451,2022/08/15,14,0,8,0,22
2475,2022/08/15,6,0,0,0,6
2476,2022/08/15,11,0,1,0,12
2507,2022/08/15,11,12,5,0,16
2525,2022/08/15,12,0,1,0,13
2562,2022/08/15,18,18,10,0,28
2582,2022/08/15,10,0,2,0,12
2586,2022/08/15,18,16,10,0,28
2602,2022/08/15,3,0,2,0,5
2631,2022/08/15,0,0,0,0,0
2685,2022/08/15,8,0,4,1,12
2723,2022/08/15,3,0,1,0,4
2730,2022/08/15,8,0,1,0,9
2731,2022/08/15,7,0,0,0,7
2732,2022/08/15,6,0,2,0,8
2734,2022/08/15,4,0,3,0,7
2735,2022/08/15,4,0,1,0,5
2761,2022/08/15,24,20,14,0,38
2788,2022/08/15,23,16,15,6,38
2812,2022/08/15,11,0,0,0,11
2813,2022/08/15,11,0,0,0,11
2814,2022/08/15,9,6,1,0,10
2913,2022/08/15,2,0,0,0,2
2914,2022/08/15,5,0,1,0,6
3015,2022/08/15,9,0,1,0,10
3033,2022/08/15,5,0,0,0,5
3035,2022/08/15,11,6,1,0,12
4446,2022/08/15,20,9,7,2,27
12136,2022/08/15,20,18,11,2,31
12516,2022/08/15,4,0,1,0,5
12518,2022/08/15,16,10,1,0,17
12523,2022/08/15,6,0,4,0,10
16062,2022/08/15,8,0,0,0,8
16063,2022/08/15,7,0,1,0,8
19322,2022/08/15,6,0,0,0,6
19516,2022/08/15,1,0,1,0,2
75,2022/08/16,35,32,35,0,70
76,2022/08/16,42,36,38,0,80
99,2022/08/16,8,0,1,0,9
117,2022/08/16,1,0,0,0,1
118,2022/08/16,8,4,1,0,9
119,2022/08/16,3,0,2,0,5
120,2022/08/16,6,4,3,0,9
149,2022/08/16,6,0,3,0,9
184,2022/08/16,14,6,6,0,20
195,2022/08/16,27,27,27,1,54
218,2022/08/16,26,21,20,0,46
296,2022/08/16,4,0,4,0,8
300,2022/08/16,10,0,2,0,12
304,2022/08/16,14,6,2,0,16
317,2022/08/16,29,12,14,1,43
343,2022/08/16,10,4,7,0,17
373,2022/08/16,4,0,4,0,8
374,2022/08/16,6,4,4,0,10
388,2022/08/16,24,21,19,3,43
419,2022/08/16,21,0,1,0,22
420,2022/08/16,12,12,11,0,23
462,2022/08/16,21,8,8,0,29
519,2022/08/16,16,6,9,0,25
525,2022/08/16,3,0,1,0,4
596,2022/08/16,8,0,4,2,12
597,2022/08/16,13,12,12,0,25
598,2022/08/16,9,0,3,0,12
1035,2022/08/16,9,6,0,0,9
1084,2022/08/16,17,10,7,0,24
1111,2022/08/16,11,6,1,0,12
1112,2022/08/16,6,0,0,0,6
1113,2022/08/16,12,0,1,0,13
1114,2022/08/16,2,0,0,0,2
1115,2022/08/16,11,0,1,0,12
1117,2022/08/16,10,0,0,0,10
1118,2022/08/16,8,0,0,0,8
1119,2022/08/16,6,0,0,0,6
1692,2022/08/16,12,6,11,0,23
1693,2022/08/16,7,6,6,0,13
1747,2022/08/16,21,15,11,0,32
1772,2022/08/16,8,0,1,0,9
1773,2022/08/16,7,0,0,0,7
1774,2022/08/16,9,0,0,0,9
1782,2022/08/16,20,3,11,1,31
1795,2022/08/16,16,14,9,0,25
1915,2022/08/16,11,0,0,0,11
1923,2022/08/16,13,6,1,0,14
1934,2022/08/16,2,0,2,0,4
1963,2022/08/16,-12,0,4,0,-8
1984,2022/08/16,12,0,0,0,12
2135,2022/08/16,9,6,0,0,9
2136,2022/08/16,3,0,0,0,3
2148,2022/08/16,9,0,3,0,12
2183,2022/08/16,8,6,2,0,10
2193,2022/08/16,13,9,12,0,25
2237,2022/08/16,12,0,1,0,13
2358,2022/08/16,16,8,7,0,23
2361,2022/08/16,10,0,5,5,15
2445,2022/08/16,14,6,4,0,18
2449,2022/08/16,15,6,15,0,30
2451,2022/08/16,6,0,4,0,10
2475,2022/08/16,6,0,0,0,6
2476,2022/08/16,10,0,0,0,10
2507,2022/08/16,18,12,9,0,27
2525,2022/08/16,11,0,0,0,11
2562,2022/08/16,20,12,12,0,32
2582,2022/08/16,8,0,2,0,10
2586,2022/08/16,20,12,6,0,26
2602,2022/08/16,9,8,2,0,11
2631,2022/08/16,6,6,2,0,8
2685,2022/08/16,7,4,2,2,9
2723,2022/08/16,2,0,0,0,2
2730,2022/08/16,7,0,1,0,8
2731,2022/08/16,7,0,1,0,8
2732,2022/08/16,4,0,0,0,4
2734,2022/08/16,1,0,1,0,2
2735,2022/08/16,3,0,1,0,4
2761,2022/08/16,20,10,12,0,32
2788,2022/08/16,18,16,10,0,28
2812,2022/08/16,11,0,1,0,12
2813,2022/08/16,11,0,1,0,12
2814,2022/08/16,8,0,1,0,9
2913,2022/08/16,2,0,1,0,3
2914,2022/08/16,4,0,0,0,4
3015,2022/08/16,8,0,0,0,8
3033,2022/08/16,5,0,0,0,5
3035,2022/08/16,10,0,0,0,10
4446,2022/08/16,19,9,10,0,29
12136,2022/08/16,21,15,19,4,40
12516,2022/08/16,7,4,1,0,8
12518,2022/08/16,15,0,8,0,23
12523,2022/08/16,6,4,2,0,8
16062,2022/08/16,8,0,1,0,9
16063,2022/08/16,6,0,1,0,7
19322,2022/08/16,6,0,0,0,6
19516,2022/08/16,6,6,5,0,11
75,2022/08/17,33,32,33,0,66
76,2022/08/17,36,32,25,1,61
99,2022/08/17,7,0,0,0,7
117,2022/08/17,1,0,1,0,2
118,2022/08/17,7,0,7,0,14
119,2022/08/17,5,4,1,0,6
120,2022/08/17,3,0,3,0,6
149,2022/08/17,3,0,1,0,4
184,2022/08/17,14,6,4,0,18
195,2022/08/17,27,27,23,0,50
218,2022/08/17,27,21,23,0,50
296,2022/08/17,6,6,6,0,12
300,2022/08/17,8,0,0,0,8
304,2022/08/17,18,6,5,0,23
317,2022/08/17,32,18,25,0,57
343,2022/08/17,3,0,3,0,6
373,2022/08/17,12,12,11,0,23
374,2022/08/17,10,8,6,0,16
388,2022/08/17,23,21,23,0,46
419,2022/08/17,32,12,17,0,49
420,2022/08/17,13,12,13,0,26
462,2022/08/17,13,0,8,0,21
519,2022/08/17,7,0,4,0,11
525,2022/08/17,2,0,2,0,4
596,2022/08/17,6,4,3,0,9
597,2022/08/17,14,12,11,0,25
598,2022/08/17,6,0,2,0,8
1035,2022/08/17,15,6,0,0,15
1084,2022/08/17,10,0,4,0,14
1111,2022/08/17,10,0,2,0,12
1112,2022/08/17,6,0,1,0,7
1113,2022/08/17,11,0,0,0,11
1114,2022/08/17,8,6,3,0,11
1115,2022/08/17,10,0,0,0,10
1117,2022/08/17,10,0,0,0,10
1118,2022/08/17,8,0,0,0,8
1119,2022/08/17,6,0,0,0,6
1692,2022/08/17,7,6,6,0,13
1693,2022/08/17,1,0,0,0,1
1747,2022/08/17,25,15,15,0,40
1772,2022/08/17,7,0,0,0,7
1773,2022/08/17,7,0,0,0,7
1774,2022/08/17,9,0,2,0,11
1782,2022/08/17,20,12,12,1,32
1795,2022/08/17,22,14,13,0,35
1915,2022/08/17,11,0,1,0,12
1923,2022/08/17,12,0,0,0,12
1934,2022/08/17,5,5,3,0,8
1963,2022/08/17,8,24,26,0,34
1984,2022/08/17,18,6,2,5,20
2135,2022/08/17,9,0,0,0,9
2136,2022/08/17,9,6,1,0,10
2148,2022/08/17,10,4,10,0,20
2183,2022/08/17,6,0,1,0,7
2193,2022/08/17,13,12,9,1,22
2237,2022/08/17,11,0,0,0,11
2358,2022/08/17,17,8,11,0,28
2361,2022/08/17,7,7,6,0,13
2445,2022/08/17,10,0,2,0,12
2449,2022/08/17,6,6,5,0,11
2451,2022/08/17,2,0,1,1,3
2475,2022/08/17,6,0,0,0,6
2476,2022/08/17,10,0,2,0,12
2507,2022/08/17,21,12,9,0,30
2525,2022/08/17,11,0,1,0,12
2562,2022/08/17,14,6,13,0,27
2582,2022/08/17,6,0,0,0,6
2586,2022/08/17,27,12,8,0,35
2602,2022/08/17,7,0,1,0,8
2631,2022/08/17,10,6,0,0,10
2685,2022/08/17,7,4,5,0,12
2723,2022/08/17,10,8,0,0,10
2730,2022/08/17,6,0,0,0,6
2731,2022/08/17,6,0,0,0,6
2732,2022/08/17,4,0,1,0,5
2734,2022/08/17,4,4,4,0,8
2735,2022/08/17,2,0,2,0,4
2761,2022/08/17,18,10,16,0,34
2788,2022/08/17,20,12,18,0,38
2812,2022/08/17,10,0,1,0,11
2813,2022/08/17,10,0,0,0,10
2814,2022/08/17,7,0,2,0,9
2913,2022/08/17,7,6,0,0,7
2914,2022/08/17,4,0,0,0,4
3015,2022/08/17,8,0,0,0,8
3033,2022/08/17,5,0,0,0,5
3035,2022/08/17,10,0,0,0,10
4446,2022/08/17,15,6,9,0,24
12136,2022/08/17,20,21,20,0,40
12516,2022/08/17,6,0,1,0,7
12518,2022/08/17,7,0,1,0,8
12523,2022/08/17,4,0,2,0,6
16062,2022/08/17,7,0,0,0,7
16063,2022/08/17,11,6,2,0,13
19322,2022/08/17,6,0,2,0,8
19516,2022/08/17,13,12,11,0,24
75,2022/08/18,28,28,25,0,53
76,2022/08/18,42,32,39,0,81
99,2022/08/18,7,0,1,0,8
117,2022/08/18,4,4,3,0,7
118,2022/08/18,4,4,3,0,7
119,2022/08/18,4,0,3,0,7
120,2022/08/18,0,0,0,0,0
149,2022/08/18,2,0,1,0,3
184,2022/08/18,19,9,10,1,29
195,2022/08/18,27,24,29,1,56
218,2022/08/18,19,15,15,0,34
296,2022/08/18,6,6,5,0,11
300,2022/08/18,16,8,3,0,19
304,2022/08/18,13,0,1,0,14
317,2022/08/18,19,12,13,0,32
343,2022/08/18,0,0,0,0,0
373,2022/08/18,13,12,12,0,25
374,2022/08/18,8,4,8,0,16
388,2022/08/18,6,6,7,0,13
419,2022/08/18,21,6,6,0,27
420,2022/08/18,6,6,6,0,12
462,2022/08/18,13,8,8,0,21
519,2022/08/18,9,6,8,0,17
525,2022/08/18,5,5,0,0,5
596,2022/08/18,7,4,2,0,9
597,2022/08/18,15,12,15,0,30
598,2022/08/18,4,0,1,0,5
1035,2022/08/18,21,6,6,0,27
1084,2022/08/18,11,5,12,0,23
1111,2022/08/18,8,0,0,0,8
1112,2022/08/18,5,0,0,0,5
1113,2022/08/18,11,0,1,0,12
1114,2022/08/18,11,6,0,0,11
1115,2022/08/18,10,0,0,0,10
1118,2022/08/18,8,0,3,0,11
1119,2022/08/18,6,0,1,0,7
1692,2022/08/18,1,0,0,0,1
1693,2022/08/18,13,12,13,0,26
1747,2022/08/18,30,20,17,0,47
1772,2022/08/18,7,0,0,0,7
1773,2022/08/18,7,0,1,0,8
1774,2022/08/18,7,0,3,0,10
1782,2022/08/18,22,15,13,0,35
1795,2022/08/18,22,14,14,0,36
1915,2022/08/18,10,0,0,0,10
1923,2022/08/18,12,0,1,0,13
1934,2022/08/18,2,0,2,0,4
1963,2022/08/18,6,24,23,0,29
1984,2022/08/18,17,6,4,0,21
2135,2022/08/18,9,0,0,0,9
2136,2022/08/18,8,0,0,0,8
2148,2022/08/18,0,0,0,0,0
2183,2022/08/18,11,6,2,0,13
2193,2022/08/18,12,9,11,0,23
2237,2022/08/18,11,0,4,0,15
2358,2022/08/18,6,0,2,0,8
2361,2022/08/18,1,0,1,0,2
2445,2022/08/18,14,6,8,0,22
2449,2022/08/18,13,12,12,0,25
2451,2022/08/18,10,10,3,0,13
2475,2022/08/18,6,0,0,0,6
2476,2022/08/18,8,0,0,0,8
2507,2022/08/18,24,12,9,0,33
2525,2022/08/18,10,0,0,0,10
2562,2022/08/18,7,6,7,0,14
2582,2022/08/18,6,0,1,0,7
2586,2022/08/18,26,8,4,4,30
2602,2022/08/18,6,0,2,0,8
2631,2022/08/18,16,6,1,0,17
2685,2022/08/18,6,4,6,0,12
2723,2022/08/18,10,0,1,0,11
2730,2022/08/18,6,0,0,0,6
2731,2022/08/18,6,0,1,0,7
2732,2022/08/18,3,0,0,0,3
2734,2022/08/18,0,0,0,0,0
2735,2022/08/18,0,0,0,0,0
2761,2022/08/18,12,10,12,0,24
2788,2022/08/18,10,8,9,0,19
2812,2022/08/18,9,0,0,0,9
2813,2022/08/18,10,0,2,0,12
2814,2022/08/18,5,0,2,0,7
2913,2022/08/18,7,0,0,0,7
2914,2022/08/18,4,0,0,0,4
3015,2022/08/18,8,0,2,0,10
3033,2022/08/18,5,0,0,0,5
3035,2022/08/18,10,0,0,0,10
4446,2022/08/18,9,3,7,1,16
12136,2022/08/18,12,12,14,0,26
12516,2022/08/18,9,4,2,0,11
12518,2022/08/18,16,10,4,0,20
12523,2022/08/18,6,4,2,0,8
16062,2022/08/18,7,0,0,0,7
16063,2022/08/18,9,0,0,0,9
19322,2022/08/18,4,0,0,0,4
19516,2022/08/18,14,12,8,0,22
75,2022/08/19,47,44,31,0,78
76,2022/08/19,39,36,30,0,69
99,2022/08/19,6,0,0,0,6
117,2022/08/19,5,4,3,0,8
118,2022/08/19,5,4,0,0,5
119,2022/08/19,5,4,1,0,6
120,2022/08/19,0,0,0,0,0
149,2022/08/19,7,6,0,0,7
184,2022/08/19,18,9,12,0,30
195,2022/08/19,27,30,25,0,52
218,2022/08/19,23,18,17,0,40
296,2022/08/19,7,6,1,0,8
300,2022/08/19,13,0,5,0,18
304,2022/08/19,12,0,5,0,17
317,2022/08/19,6,0,4,0,10
343,2022/08/19,4,4,2,0,6
373,2022/08/19,0,0,0,0,0
374,2022/08/19,4,4,1,0,5
388,2022/08/19,24,24,9,0,33
419,2022/08/19,6,6,8,0,14
420,2022/08/19,6,6,6,0,12
462,2022/08/19,5,0,4,0,9
519,2022/08/19,7,6,10,0,17
525,2022/08/19,5,0,3,0,8
596,2022/08/19,13,8,6,0,19
597,2022/08/19,24,24,13,0,37
598,2022/08/19,3,0,1,0,4
1035,2022/08/19,21,6,10,0,31
1084,2022/08/19,14,15,6,0,20
1111,2022/08/19,8,0,1,0,9
1112,2022/08/19,5,0,0,0,5
1113,2022/08/19,10,0,0,0,10
1114,2022/08/19,11,0,3,0,14
1115,2022/08/19,10,0,0,0,10
1117,2022/08/19,10,0,1,0,11
1118,2022/08/19,5,0,2,0,7
1119,2022/08/19,5,0,1,0,6
1692,2022/08/19,7,6,8,0,15
1693,2022/08/19,6,6,5,0,11
1747,2022/08/19,28,15,24,0,52
1772,2022/08/19,7,0,0,0,7
1773,2022/08/19,6,0,2,0,8
1774,2022/08/19,4,0,2,0,6
1782,2022/08/19,27,18,18,1,45
1795,2022/08/19,22,14,16,0,38
1915,2022/08/19,10,0,0,0,10
1923,2022/08/19,11,0,5,0,16
1934,2022/08/19,5,5,2,0,7
1963,2022/08/19,12,12,12,0,24
1984,2022/08/19,13,0,5,0,18
2135,2022/08/19,9,0,0,0,9
2136,2022/08/19,8,0,2,0,10
2148,2022/08/19,0,0,0,0,0
2183,2022/08/19,15,6,10,0,25
2193,2022/08/19,16,15,15,0,31
2237,2022/08/19,7,0,0,0,7
2358,2022/08/19,12,8,1,0,13
2361,2022/08/19,7,7,3,0,10
2445,2022/08/19,12,6,6,2,18
2449,2022/08/19,12,12,12,0,24
2451,2022/08/19,12,5,8,0,20
2475,2022/08/19,6,0,1,0,7
2476,2022/08/19,8,0,1,0,9
2507,2022/08/19,21,6,18,0,39
2525,2022/08/19,10,0,0,0,10
2562,2022/08/19,13,12,12,0,25
2582,2022/08/19,9,4,1,0,10
2586,2022/08/19,26,8,14,5,40
2602,2022/08/19,4,0,1,0,5
2631,2022/08/19,21,6,7,0,28
2685,2022/08/19,8,8,3,0,11
2723,2022/08/19,9,0,0,0,9
2730,2022/08/19,6,0,3,0,9
2731,2022/08/19,5,0,1,0,6
2732,2022/08/19,11,8,2,0,13
2734,2022/08/19,4,4,4,0,8
2735,2022/08/19,0,0,0,0,0
2761,2022/08/19,12,10,8,0,20
2788,2022/08/19,18,16,12,0,30
2812,2022/08/19,9,0,0,0,9
2813,2022/08/19,8,0,0,0,8
2814,2022/08/19,3,0,0,0,3
2913,2022/08/19,13,6,1,0,14
2914,2022/08/19,10,6,0,0,10
3015,2022/08/19,6,0,1,0,7
3033,2022/08/19,5,0,0,0,5
3035,2022/08/19,10,0,0,0,10
4446,2022/08/19,10,9,10,0,20
12136,2022/08/19,10,12,10,0,20
12516,2022/08/19,7,0,4,0,11
12518,2022/08/19,12,0,4,0,16
12523,2022/08/19,8,4,4,0,12
16062,2022/08/19,7,0,2,0,9
16063,2022/08/19,9,0,2,0,11
19322,2022/08/19,4,0,0,0,4
19516,2022/08/19,6,0,6,0,12
75,2022/08/20,36,20,30,8,66
76,2022/08/20,32,24,32,1,64
99,2022/08/20,6,0,1,0,7
117,2022/08/20,2,0,2,0,4
118,2022/08/20,5,0,0,0,5
119,2022/08/20,4,0,1,0,5
120,2022/08/20,4,4,2,0,6
149,2022/08/20,7,0,1,0,8
184,2022/08/20,11,6,5,0,16
195,2022/08/20,23,21,27,0,50
218,2022/08/20,26,21,14,0,40
296,2022/08/20,12,6,3,0,15
300,2022/08/20,8,0,2,0,10
304,2022/08/20,7,0,4,0,11
317,2022/08/20,13,12,6,0,19
343,2022/08/20,6,4,1,0,7
373,2022/08/20,6,6,3,0,9
374,2022/08/20,3,0,2,0,5
388,2022/08/20,32,18,24,9,56
419,2022/08/20,9,12,4,0,13
420,2022/08/20,6,6,6,0,12
462,2022/08/20,8,8,4,0,12
519,2022/08/20,3,6,3,0,6
525,2022/08/20,2,0,0,0,2
596,2022/08/20,7,0,3,0,10
597,2022/08/20,11,0,5,0,16
598,2022/08/20,2,0,0,0,2
1035,2022/08/20,11,0,9,0,20
1084,2022/08/20,8,0,3,0,11
1111,2022/08/20,7,0,2,0,9
1112,2022/08/20,5,0,0,0,5
1113,2022/08/20,10,0,3,0,13
1114,2022/08/20,8,0,4,0,12
1115,2022/08/20,10,0,2,0,12
1117,2022/08/20,9,0,0,0,9
1118,2022/08/20,3,0,1,0,4
1119,2022/08/20,4,0,0,0,4
1692,2022/08/20,5,6,4,0,9
1693,2022/08/20,6,6,4,0,10
1747,2022/08/20,19,15,17,0,36
1772,2022/08/20,7,0,1,0,8
1773,2022/08/20,4,0,1,0,5
1774,2022/08/20,2,0,0,0,2
1782,2022/08/20,20,12,16,0,36
1795,2022/08/20,27,21,19,0,46
1915,2022/08/20,10,0,0,0,10
1923,2022/08/20,6,0,0,0,6
1934,2022/08/20,8,5,1,0,9
1963,2022/08/20,12,12,12,0,24
1984,2022/08/20,8,0,3,0,11
2135,2022/08/20,9,0,4,0,13
2136,2022/08/20,6,0,2,0,8
2148,2022/08/20,4,4,1,0,5
2183,2022/08/20,11,6,2,0,13
2193,2022/08/20,7,6,10,0,17
2237,2022/08/20,7,0,0,0,7
2358,2022/08/20,11,0,6,0,17
2361,2022/08/20,11,7,5,0,16
2445,2022/08/20,4,0,5,0,9
2449,2022/08/20,12,12,11,0,23
2451,2022/08/20,9,5,3,0,12
2475,2022/08/20,5,0,1,0,6
2476,2022/08/20,7,0,1,0,8
2507,2022/08/20,9,6,7,0,16
2525,2022/08/20,10,0,1,0,11
2562,2022/08/20,13,12,6,0,19
2582,2022/08/20,8,0,3,0,11
2586,2022/08/20,15,8,12,0,27
2602,2022/08/20,11,8,1,0,12
2631,2022/08/20,14,0,2,0,16
2685,2022/08/20,9,4,4,0,13
2730,2022/08/20,3,0,1,0,4
2731,2022/08/20,4,0,2,0,6
2732,2022/08/20,9,0,0,0,9
2734,2022/08/20,0,0,0,0,0
2735,2022/08/20,0,0,0,0,0
2761,2022/08/20,17,15,12,0,29
2788,2022/08/20,13,8,8,0,21
2812,2022/08/20,9,0,0,0,9
2813,2022/08/20,8,0,0,0,8
2814,2022/08/20,9,6,1,0,10
2913,2022/08/20,12,0,5,0,17
2914,2022/08/20,10,0,1,0,11
3015,2022/08/20,5,0,0,0,5
3033,2022/08/20,5,0,1,0,6
3035,2022/08/20,10,0,0,0,10
4446,2022/08/20,9,9,8,0,17
12136,2022/08/20,18,18,18,0,36
12516,2022/08/20,3,0,2,0,5
12518,2022/08/20,8,0,2,0,10
12523,2022/08/20,8,4,1,0,9
16062,2022/08/20,5,0,0,0,5
16063,2022/08/20,7,0,3,0,10
19322,2022/08/20,10,6,1,0,11
19516,2022/08/20,12,12,6,0,18
75,2022/08/21,14,16,12,0,26
76,2022/08/21,24,24,21,0,45
99,2022/08/21,5,0,0,0,5
117,2022/08/21,4,4,2,0,6
118,2022/08/21,9,4,1,0,10
119,2022/08/21,3,0,2,0,5
120,2022/08/21,2,0,2,0,4
149,2022/08/21,6,0,0,0,6
184,2022/08/21,12,6,6,0,18
195,2022/08/21,17,21,11,1,28
218,2022/08/21,30,18,26,0,56
296,2022/08/21,15,6,10,0,25
300,2022/08/21,6,0,3,0,9
304,2022/08/21,9,6,8,0,17
317,2022/08/21,25,18,10,0,35
343,2022/08/21,5,0,3,0,8
373,2022/08/21,15,12,4,0,19
374,2022/08/21,13,12,5,0,18
388,2022/08/21,11,12,10,0,21
419,2022/08/21,17,12,7,0,24
420,2022/08/21,12,12,3,0,15
462,2022/08/21,12,8,9,0,21
519,2022/08/21,12,12,10,0,22
525,2022/08/21,7,5,2,0,9
596,2022/08/21,8,4,4,0,12
597,2022/08/21,18,12,10,0,28
598,2022/08/21,8,6,2,0,10
1035,2022/08/21,2,0,2,0,4
1084,2022/08/21,10,5,3,0,13
1111,2022/08/21,5,0,3,0,8
1112,2022/08/21,5,0,0,0,5
1113,2022/08/21,7,0,0,0,7
1114,2022/08/21,4,0,3,0,7
1115,2022/08/21,8,0,2,0,10
1117,2022/08/21,9,0,2,0,11
1118,2022/08/21,8,6,0,0,8
1119,2022/08/21,4,0,0,0,4
1692,2022/08/21,7,6,4,0,11
1693,2022/08/21,8,6,8,0,16
1747,2022/08/21,17,15,13,0,30
1772,2022/08/21,6,0,0,0,6
1773,2022/08/21,3,0,0,0,3
1774,2022/08/21,10,8,7,0,17
1782,2022/08/21,16,12,13,0,29
1795,2022/08/21,8,0,4,0,12
1915,2022/08/21,10,0,2,0,12
1923,2022/08/21,6,0,1,0,7
1934,2022/08/21,7,0,2,0,9
1963,2022/08/21,24,24,24,0,48
1984,2022/08/21,5,0,3,1,8
2135,2022/08/21,5,0,1,0,6
2136,2022/08/21,4,0,0,0,4
2148,2022/08/21,7,4,2,0,9
2183,2022/08/21,15,6,5,0,20
2193,2022/08/21,9,12,8,2,17
2237,2022/08/21,13,6,3,0,16
2358,2022/08/21,21,16,5,0,26
2361,2022/08/21,13,7,2,0,15
2445,2022/08/21,5,6,1,0,6
2449,2022/08/21,13,12,7,0,20
2451,2022/08/21,21,15,17,0,38
2475,2022/08/21,4,0,0,0,4
2476,2022/08/21,6,0,1,0,7
2507,2022/08/21,14,12,7,0,21
2525,2022/08/21,9,0,3,0,12
2562,2022/08/21,19,12,4,0,23
2582,2022/08/21,5,0,0,0,5
2586,2022/08/21,11,8,8,0,19
2602,2022/08/21,10,0,2,0,12
2631,2022/08/21,12,0,3,0,15
2685,2022/08/21,9,4,2,0,11
2723,2022/08/21,9,0,0,0,9
2730,2022/08/21,2,0,2,0,4
2731,2022/08/21,2,0,1,0,3
2732,2022/08/21,9,0,0,0,9
2734,2022/08/21,8,8,4,0,12
2735,2022/08/21,8,8,4,0,12
2761,2022/08/21,20,15,7,0,27
2788,2022/08/21,21,16,13,0,34
2812,2022/08/21,9,0,1,0,10
2813,2022/08/21,8,0,0,0,8
2814,2022/08/21,8,0,1,0,9
2913,2022/08/21,13,6,3,0,16
2914,2022/08/21,9,0,0,0,9
3015,2022/08/21,5,0,2,0,7
3033,2022/08/21,4,0,0,0,4
3035,2022/08/21,10,0,0,0,10
4446,2022/08/21,7,6,9,0,16
12136,2022/08/21,15,15,12,0,27
12516,2022/08/21,5,4,2,0,7
12518,2022/08/21,16,10,2,0,18
12523,2022/08/21,11,4,4,0,15
16062,2022/08/21,5,0,0,0,5
16063,2022/08/21,4,0,3,0,7
19322,2022/08/21,9,0,1,0,10
19516,2022/08/21,6,0,5,0,11
75,2022/08/22,38,36,40,0,78
76,2022/08/22,43,40,38,0,81
99,2022/08/22,5,0,1,0,6
117,2022/08/22,2,0,2,0,4
118,2022/08/22,12,4,2,0,14
119,2022/08/22,5,4,2,0,7
120,2022/08/22,4,4,0,0,4
149,2022/08/22,6,0,0,0,6
184,2022/08/22,12,6,4,0,16
195,2022/08/22,35,30,33,4,68
218,2022/08/22,22,18,17,0,39
296,2022/08/22,11,6,4,0,15
300,2022/08/22,11,8,4,0,15
304,2022/08/22,1,0,1,0,2
317,2022/08/22,33,18,7,0,40
343,2022/08/22,6,4,2,0,8
373,2022/08/22,23,12,5,0,28
374,2022/08/22,8,0,3,0,11
388,2022/08/22,28,27,19,0,47
419,2022/08/22,22,12,14,0,36
420,2022/08/22,15,6,6,0,21
462,2022/08/22,11,8,4,0,15
519,2022/08/22,8,6,5,1,13
525,2022/08/22,5,0,1,0,6
596,2022/08/22,4,0,1,0,5
597,2022/08/22,20,12,11,0,31
598,2022/08/22,6,0,1,0,7
1035,2022/08/22,6,6,1,0,7
1084,2022/08/22,17,10,5,0,22
1111,2022/08/22,8,6,1,0,9
1112,2022/08/22,11,6,0,0,11
1113,2022/08/22,7,0,0,0,7
1114,2022/08/22,7,6,2,0,9
1115,2022/08/22,12,6,0,0,12
1117,2022/08/22,7,0,0,0,7
1118,2022/08/22,8,0,1,0,9
1119,2022/08/22,4,0,0,0,4
1692,2022/08/22,9,6,6,0,15
1693,2022/08/22,6,6,6,0,12
1747,2022/08/22,4,0,3,0,7
1772,2022/08/22,6,0,0,0,6
1773,2022/08/22,9,6,0,0,9
1774,2022/08/22,3,0,1,0,4
1782,2022/08/22,15,12,12,0,27
1795,2022/08/22,18,14,11,0,29
1915,2022/08/22,8,0,0,0,8
1923,2022/08/22,11,6,2,0,13
1934,2022/08/22,10,5,3,0,13
1963,2022/08/22,30,30,6,0,36
1984,2022/08/22,1,0,0,0,1
2135,2022/08/22,4,0,0,0,4
2136,2022/08/22,4,0,0,0,4
2148,2022/08/22,5,0,2,0,7
2183,2022/08/22,10,0,1,0,11
2193,2022/08/22,14,15,12,0,26
2237,2022/08/22,10,0,1,0,11
2358,2022/08/22,16,0,5,1,21
2361,2022/08/22,11,0,5,0,16
2445,2022/08/22,4,0,2,0,6
2449,2022/08/22,18,12,5,0,23
2451,2022/08/22,4,0,4,0,8
2475,2022/08/22,10,6,0,0,10
2476,2022/08/22,5,0,1,0,6
2507,2022/08/22,13,6,9,0,22
2525,2022/08/22,6,0,1,0,7
2562,2022/08/22,27,12,9,1,36
2582,2022/08/22,5,0,0,0,5
2586,2022/08/22,11,8,10,0,21
2602,2022/08/22,8,0,1,0,9
2631,2022/08/22,9,0,4,0,13
2685,2022/08/22,11,4,8,2,19
2723,2022/08/22,9,0,0,0,9
2730,2022/08/22,6,6,1,0,7
2731,2022/08/22,7,6,0,0,7
2732,2022/08/22,9,0,0,0,9
2734,2022/08/22,4,0,2,0,6
2735,2022/08/22,4,0,1,0,5
2761,2022/08/22,28,15,15,0,43
2788,2022/08/22,24,16,18,5,42
2812,2022/08/22,8,0,0,0,8
2813,2022/08/22,8,0,1,0,9
2814,2022/08/22,7,0,1,0,8
2913,2022/08/22,10,0,2,0,12
2914,2022/08/22,9,0,0,0,9
3015,2022/08/22,11,8,1,0,12
3033,2022/08/22,4,0,1,0,5
3035,2022/08/22,10,0,1,0,11
4446,2022/08/22,7,9,5,0,12
12136,2022/08/22,18,15,11,1,29
12516,2022/08/22,3,0,1,0,4
12518,2022/08/22,14,0,1,0,15
12523,2022/08/22,7,0,3,0,10
16062,2022/08/22,11,6,0,0,11
16063,2022/08/22,7,6,0,0,7
19322,2022/08/22,8,0,0,0,8
19516,2022/08/22,13,12,11,1,24
75,2022/08/23,33,36,33,0,66
76,2022/08/23,38,36,35,1,73
99,2022/08/23,4,0,1,0,5
117,2022/08/23,5,4,0,0,5
118,2022/08/23,10,0,1,1,11
119,2022/08/23,3,0,2,0,5
120,2022/08/23,4,0,0,0,4
149,2022/08/23,12,6,1,0,13
184,2022/08/23,11,9,5,0,16
195,2022/08/23,26,27,25,0,51
218,2022/08/23,19,18,17,0,36
296,2022/08/23,7,0,4,0,11
300,2022/08/23,15,8,1,0,16
304,2022/08/23,6,6,5,0,11
317,2022/08/23,38,12,4,0,42
343,2022/08/23,4,0,4,0,8
373,2022/08/23,30,12,6,0,36
374,2022/08/23,9,4,3,0,12
388,2022/08/23,27,18,27,0,54
419,2022/08/23,26,18,12,0,38
420,2022/08/23,21,12,2,0,23
462,2022/08/23,15,8,1,0,16
519,2022/08/23,8,6,5,0,13
525,2022/08/23,4,0,1,1,5
596,2022/08/23,5,4,3,0,8
597,2022/08/23,21,12,18,0,39
598,2022/08/23,11,6,2,0,13
1035,2022/08/23,11,6,3,0,14
1084,2022/08/23,19,10,10,1,29
1111,2022/08/23,7,0,2,0,9
1112,2022/08/23,11,0,0,0,11
1113,2022/08/23,13,6,1,0,14
1114,2022/08/23,11,6,1,0,12
1115,2022/08/23,12,0,1,0,13
1117,2022/08/23,7,0,0,0,7
1118,2022/08/23,7,0,0,0,7
1119,2022/08/23,10,6,0,0,10
1692,2022/08/23,9,6,5,0,14
1693,2022/08/23,6,6,4,0,10
1747,2022/08/23,16,15,15,0,31
1772,2022/08/23,6,0,0,0,6
1773,2022/08/23,9,0,0,0,9
1774,2022/08/23,2,0,0,0,2
1782,2022/08/23,16,15,18,0,34
1795,2022/08/23,11,7,12,0,23
1915,2022/08/23,8,0,2,0,10
1923,2022/08/23,9,0,2,0,11
1934,2022/08/23,8,0,6,0,14
1963,2022/08/23,36,12,13,0,49
1984,2022/08/23,7,6,0,1,7
2135,2022/08/23,10,6,1,0,11
2136,2022/08/23,10,6,1,0,11
2148,2022/08/23,7,4,2,0,9
2183,2022/08/23,15,6,1,6,16
2193,2022/08/23,17,12,12,1,29
2237,2022/08/23,9,0,1,0,10
2358,2022/08/23,10,0,4,0,14
2361,2022/08/23,8,0,5,0,13
2445,2022/08/23,8,6,2,0,10
2449,2022/08/23,25,12,11,0,36
2451,2022/08/23,1,0,0,0,1
2475,2022/08/23,10,0,1,0,11
2476,2022/08/23,4,0,0,0,4
2507,2022/08/23,15,12,12,0,27
2525,2022/08/23,5,0,0,0,5
2562,2022/08/23,29,12,4,0,33
2582,2022/08/23,9,4,1,0,10
2586,2022/08/23,12,12,12,0,24
2602,2022/08/23,7,0,1,0,8
2631,2022/08/23,11,6,2,2,13
2685,2022/08/23,5,4,4,0,9
2723,2022/08/23,9,0,0,0,9
2730,2022/08/23,5,0,1,0,6
2731,2022/08/23,7,0,2,0,9
2732,2022/08/23,9,0,1,0,10
2734,2022/08/23,6,4,4,0,10
2735,2022/08/23,11,8,5,0,16
2761,2022/08/23,23,10,18,0,41
2788,2022/08/23,13,12,11,0,24
2812,2022/08/23,8,0,1,0,9
2813,2022/08/23,7,0,1,0,8
2814,2022/08/23,6,0,1,0,7
2913,2022/08/23,8,0,1,1,9
2914,2022/08/23,9,0,1,0,10
3015,2022/08/23,10,0,0,0,10
3033,2022/08/23,9,6,0,0,9
3035,2022/08/23,9,0,0,0,9
4446,2022/08/23,11,9,10,0,21
12136,2022/08/23,26,18,24,1,50
12516,2022/08/23,6,4,1,0,7
12518,2022/08/23,13,0,1,0,14
12523,2022/08/23,8,4,2,0,10
16062,2022/08/23,11,0,0,0,11
16063,2022/08/23,7,0,0,0,7
19322,2022/08/23,8,0,1,0,9
19516,2022/08/23,7,6,4,0,11
75,2022/08/24,36,36,37,0,73
76,2022/08/24,38,36,34,0,72
99,2022/08/24,3,0,0,0,3
117,2022/08/24,5,0,0,0,5
118,2022/08/24,12,4,1,5,13
119,2022/08/24,5,4,2,0,7
120,2022/08/24,8,4,4,0,12
149,2022/08/24,11,0,0,0,11
184,2022/08/24,12,6,9,0,21
195,2022/08/24,31,30,34,0,65
218,2022/08/24,20,18,18,0,38
296,2022/08/24,9,6,5,0,14
300,2022/08/24,14,0,3,0,17
304,2022/08/24,7,6,4,0,11
317,2022/08/24,46,12,25,0,71
343,2022/08/24,4,4,2,0,6
373,2022/08/24,30,6,10,0,40
374,2022/08/24,10,4,4,0,14
388,2022/08/24,21,21,24,0,45
419,2022/08/24,32,18,12,0,44
420,2022/08/24,31,12,8,0,39
462,2022/08/24,22,8,11,0,33
519,2022/08/24,9,6,8,0,17
525,2022/08/24,7,5,2,0,9
596,2022/08/24,6,4,6,0,12
597,2022/08/24,15,12,12,0,27
598,2022/08/24,9,0,2,0,11
1035,2022/08/24,14,6,7,0,21
1084,2022/08/24,13,5,7,0,20
1111,2022/08/24,5,0,2,0,7
1112,2022/08/24,11,0,0,0,11
1113,2022/08/24,12,0,0,0,12
1114,2022/08/24,10,0,1,0,11
1115,2022/08/24,11,0,1,0,12
1117,2022/08/24,7,0,2,0,9
1118,2022/08/24,7,0,0,0,7
1119,2022/08/24,10,0,0,0,10
1692,2022/08/24,10,6,7,0,17
1693,2022/08/24,8,6,7,0,15
1747,2022/08/24,21,20,13,0,34
1772,2022/08/24,6,0,0,0,6
1773,2022/08/24,9,0,1,0,10
1774,2022/08/24,10,8,3,0,13
1782,2022/08/24,16,18,9,0,25
1795,2022/08/24,13,14,13,0,26
1915,2022/08/24,6,0,0,0,6
1923,2022/08/24,7,0,0,0,7
1934,2022/08/24,2,0,1,0,3
1963,2022/08/24,41,18,30,0,71
1984,2022/08/24,6,0,4,0,10
2135,2022/08/24,9,0,2,0,11
2136,2022/08/24,9,0,0,0,9
2148,2022/08/24,9,4,0,0,9
2183,2022/08/24,8,0,8,0,16
2193,2022/08/24,16,12,15,0,31
2237,2022/08/24,8,0,1,0,9
2358,2022/08/24,14,8,5,1,19
2361,2022/08/24,10,7,7,0,17
2445,2022/08/24,12,6,7,0,19
2449,2022/08/24,26,12,17,0,43
2451,2022/08/24,1,0,1,0,2
2475,2022/08/24,9,0,0,0,9
2476,2022/08/24,10,6,0,0,10
2507,2022/08/24,9,6,9,0,18
2525,2022/08/24,11,6,1,0,12
2562,2022/08/24,37,12,9,0,46
2582,2022/08/24,8,0,2,0,10
2586,2022/08/24,12,12,11,0,23
2602,2022/08/24,14,8,0,0,14
2631,2022/08/24,7,0,2,0,9
2685,2022/08/24,5,4,3,0,8
2723,2022/08/24,9,0,0,0,9
2730,2022/08/24,4,0,2,0,6
2731,2022/08/24,11,6,1,0,12
2732,2022/08/24,8,0,0,0,8
2734,2022/08/24,2,0,2,0,4
2735,2022/08/24,6,0,3,0,9
2761,2022/08/24,20,15,21,0,41
2788,2022/08/24,10,8,9,0,19
2812,2022/08/24,7,0,0,0,7
2813,2022/08/24,6,0,0,0,6
2814,2022/08/24,5,0,1,0,6
2913,2022/08/24,6,0,0,4,6
2914,2022/08/24,8,0,0,0,8
3015,2022/08/24,10,0,2,0,12
3033,2022/08/24,9,0,1,0,10
3035,2022/08/24,9,0,0,0,9
4446,2022/08/24,10,9,8,0,18
12136,2022/08/24,22,21,13,0,35
12516,2022/08/24,5,0,1,0,6
12518,2022/08/24,22,10,1,0,23
12523,2022/08/24,6,0,3,0,9
16062,2022/08/24,11,0,0,0,11
16063,2022/08/24,13,6,0,0,13
19322,2022/08/24,7,0,0,0,7
19516,2022/08/24,15,12,9,0,24
75,2022/08/25,32,32,29,0,61
76,2022/08/25,44,40,35,1,79
99,2022/08/25,15,12,0,0,15
117,2022/08/25,12,4,2,0,14
118,2022/08/25,16,0,3,0,19
119,2022/08/25,2,0,0,0,2
120,2022/08/25,9,4,2,0,11
149,2022/08/25,11,0,0,0,11
184,2022/08/25,12,9,8,1,20
195,2022/08/25,21,24,25,0,46
218,2022/08/25,26,24,25,0,51
296,2022/08/25,9,6,3,0,12
300,2022/08/25,12,0,2,0,14
304,2022/08/25,9,6,6,0,15
317,2022/08/25,22,0,14,0,36
343,2022/08/25,10,4,1,0,11
373,2022/08/25,25,6,6,0,31
374,2022/08/25,14,8,6,0,20
388,2022/08/25,18,21,18,0,36
419,2022/08/25,25,6,4,0,29
420,2022/08/25,23,0,7,0,30
462,2022/08/25,20,8,4,0,24
519,2022/08/25,9,6,8,0,17
525,2022/08/25,5,0,3,0,8
596,2022/08/25,4,4,1,0,5
597,2022/08/25,16,12,11,0,27
598,2022/08/25,7,0,3,1,10
1035,2022/08/25,13,6,8,0,21
1084,2022/08/25,11,5,8,0,19
1111,2022/08/25,3,0,1,0,4
1112,2022/08/25,11,0,1,0,12
1113,2022/08/25,12,0,0,0,12
1114,2022/08/25,9,0,2,0,11
1115,2022/08/25,10,0,1,0,11
1117,2022/08/25,5,0,0,0,5
1118,2022/08/25,13,6,2,0,15
1119,2022/08/25,10,0,0,0,10
1692,2022/08/25,10,6,5,0,15
1693,2022/08/25,13,12,7,0,20
1747,2022/08/25,28,20,13,0,41
1772,2022/08/25,6,0,1,0,7
1773,2022/08/25,8,0,2,0,10
1774,2022/08/25,7,0,2,0,9
1782,2022/08/25,22,15,14,0,36
1795,2022/08/25,21,21,10,0,31
1915,2022/08/25,6,0,0,0,6
1923,2022/08/25,7,0,0,0,7
1934,2022/08/25,5,5,1,0,6
1963,2022/08/25,29,18,14,0,43
1984,2022/08/25,8,6,2,0,10
2135,2022/08/25,7,0,0,0,7
2136,2022/08/25,9,0,1,0,10
2148,2022/08/25,12,4,4,0,16
2183,2022/08/25,3,0,1,0,4
2193,2022/08/25,14,12,10,0,24
2237,2022/08/25,7,0,2,0,9
2358,2022/08/25,9,0,2,0,11
2361,2022/08/25,10,7,5,0,15
2445,2022/08/25,12,6,0,0,12
2449,2022/08/25,15,6,5,0,20
2451,2022/08/25,11,10,4,0,15
2475,2022/08/25,9,0,0,0,9
2476,2022/08/25,10,0,0,0,10
2507,2022/08/25,12,12,10,0,22
2525,2022/08/25,10,0,2,0,12
2562,2022/08/25,27,0,14,0,41
2582,2022/08/25,5,4,2,0,7
2586,2022/08/25,13,12,9,0,22
2602,2022/08/25,14,0,0,0,14
2631,2022/08/25,4,0,4,0,8
2685,2022/08/25,6,4,0,0,6
2723,2022/08/25,9,0,0,0,9
2730,2022/08/25,8,6,1,0,9
2731,2022/08/25,10,0,2,0,12
2732,2022/08/25,8,0,1,0,9
2734,2022/08/25,4,4,1,0,5
2735,2022/08/25,0,0,0,0,0
2761,2022/08/25,4,5,4,0,8
2788,2022/08/25,17,16,11,0,28
2812,2022/08/25,7,0,1,0,8
2813,2022/08/25,6,0,1,0,7
2814,2022/08/25,10,6,2,0,12
2913,2022/08/25,1,0,1,0,2
2914,2022/08/25,8,0,1,0,9
3015,2022/08/25,8,0,0,0,8
3033,2022/08/25,8,0,0,0,8
3035,2022/08/25,9,0,0,0,9
4446,2022/08/25,14,12,9,0,23
12136,2022/08/25,27,18,25,0,52
12516,2022/08/25,7,4,3,0,10
12518,2022/08/25,21,0,4,0,25
12523,2022/08/25,5,4,3,0,8
16062,2022/08/25,11,0,0,0,11
16063,2022/08/25,13,0,1,0,14
19516,2022/08/25,13,6,4,0,17
75,2022/08/26,38,36,43,0,81
76,2022/08/26,44,36,38,2,82
99,2022/08/26,15,0,2,0,17
117,2022/08/26,10,0,3,0,13
118,2022/08/26,3,0,3,0,6
119,2022/08/26,6,4,2,0,8
120,2022/08/26,7,0,3,0,10
149,2022/08/26,11,0,2,0,13
184,2022/08/26,15,12,12,0,27
195,2022/08/26,29,33,32,0,61
218,2022/08/26,19,18,21,0,40
296,2022/08/26,12,6,3,0,15
300,2022/08/26,18,8,0,0,18
304,2022/08/26,9,6,6,0,15
317,2022/08/26,14,6,7,0,21
343,2022/08/26,9,0,2,0,11
373,2022/08/26,19,0,7,0,26
374,2022/08/26,8,0,4,0,12
388,2022/08/26,12,12,12,0,24
419,2022/08/26,21,0,7,0,28
420,2022/08/26,22,6,11,0,33
462,2022/08/26,16,0,10,0,26
519,2022/08/26,13,12,4,0,17
525,2022/08/26,7,5,1,0,8
596,2022/08/26,11,8,10,0,21
597,2022/08/26,28,24,15,0,43
598,2022/08/26,9,6,2,0,11
1035,2022/08/26,17,12,15,0,32
1084,2022/08/26,13,10,6,2,19
1111,2022/08/26,8,6,0,0,8
1112,2022/08/26,10,0,1,0,11
1113,2022/08/26,12,0,1,0,13
1114,2022/08/26,7,0,3,0,10
1115,2022/08/26,9,0,3,0,12
1117,2022/08/26,5,0,1,0,6
1118,2022/08/26,11,0,3,0,14
1119,2022/08/26,10,0,0,0,10
1692,2022/08/26,11,6,8,0,19
1693,2022/08/26,12,6,7,0,19
1747,2022/08/26,35,20,30,0,65
1772,2022/08/26,5,0,2,0,7
1773,2022/08/26,6,0,1,0,7
1774,2022/08/26,5,0,0,0,5
1782,2022/08/26,26,18,21,3,47
1795,2022/08/26,25,14,24,0,49
1915,2022/08/26,12,6,1,0,13
1923,2022/08/26,13,6,2,0,15
1934,2022/08/26,4,0,4,0,8
1963,2022/08/26,15,0,15,0,30
1984,2022/08/26,12,6,9,0,21
2135,2022/08/26,7,0,3,0,10
2136,2022/08/26,8,0,0,0,8
2148,2022/08/26,8,0,4,0,12
2183,2022/08/26,8,6,8,0,16
2193,2022/08/26,18,15,15,0,33
2237,2022/08/26,5,0,1,0,6
2358,2022/08/26,15,8,2,0,17
2361,2022/08/26,5,0,3,0,8
2445,2022/08/26,18,6,13,0,31
2449,2022/08/26,16,6,10,0,26
2451,2022/08/26,16,10,6,0,22
2475,2022/08/26,9,0,0,0,9
2476,2022/08/26,10,0,0,0,10
2507,2022/08/26,14,12,12,0,26
2525,2022/08/26,8,0,4,0,12
2562,2022/08/26,25,12,6,0,31
2582,2022/08/26,3,0,0,0,3
2586,2022/08/26,16,12,16,0,32
2602,2022/08/26,14,0,1,0,15
2631,2022/08/26,6,6,6,0,12
2685,2022/08/26,14,8,3,0,17
2723,2022/08/26,9,0,0,0,9
2730,2022/08/26,7,0,2,0,9
2731,2022/08/26,8,0,0,0,8
2732,2022/08/26,7,0,1,0,8
2734,2022/08/26,7,4,0,0,7
2735,2022/08/26,0,0,0,0,0
2761,2022/08/26,15,15,10,0,25
2788,2022/08/26,18,12,17,0,35
2812,2022/08/26,6,0,0,0,6
2813,2022/08/26,5,0,0,0,5
2814,2022/08/26,8,0,1,0,9
2913,2022/08/26,6,6,1,0,7
2914,2022/08/26,7,0,0,0,7
3015,2022/08/26,8,0,2,0,10
3033,2022/08/26,8,0,1,0,9
3035,2022/08/26,9,0,1,0,10
4446,2022/08/26,14,9,12,0,26
12136,2022/08/26,14,12,14,0,28
12516,2022/08/26,8,4,7,0,15
12518,2022/08/26,17,0,10,0,27
12523,2022/08/26,6,4,3,0,9
16062,2022/08/26,11,0,1,0,12
16063,2022/08/26,12,0,0,0,12
19516,2022/08/26,9,0,7,0,16
75,2022/08/27,19,24,22,0,41
76,2022/08/27,29,24,23,3,52
99,2022/08/27,13,0,1,0,14
117,2022/08/27,7,0,2,0,9
118,2022/08/27,4,4,4,0,8
119,2022/08/27,4,0,2,0,6
120,2022/08/27,4,0,1,1,5
149,2022/08/27,9,0,2,0,11
184,2022/08/27,9,6,6,0,15
195,2022/08/27,21,24,21,0,42
218,2022/08/27,13,15,12,0,25
296,2022/08/27,15,6,2,0,17
300,2022/08/27,18,0,4,0,22
304,2022/08/27,9,6,5,0,14
317,2022/08/27,13,6,9,0,22
343,2022/08/27,11,4,1,0,12
373,2022/08/27,18,6,6,2,24
374,2022/08/27,8,4,6,0,14
388,2022/08/27,18,18,17,0,35
419,2022/08/27,20,6,8,0,28
420,2022/08/27,11,0,4,0,15
462,2022/08/27,6,0,5,0,11
519,2022/08/27,21,12,6,0,27
525,2022/08/27,6,0,3,0,9
596,2022/08/27,1,0,1,0,2
597,2022/08/27,13,0,10,0,23
598,2022/08/27,7,0,1,0,8
1035,2022/08/27,8,6,3,0,11
1084,2022/08/27,5,0,3,0,8
1111,2022/08/27,8,0,3,0,11
1112,2022/08/27,9,0,2,0,11
1113,2022/08/27,11,0,0,0,11
1114,2022/08/27,10,6,6,0,16
1115,2022/08/27,6,0,2,0,8
1117,2022/08/27,12,8,1,0,13
1118,2022/08/27,8,0,2,0,10
1119,2022/08/27,10,0,0,0,10
1692,2022/08/27,3,0,2,0,5
1693,2022/08/27,11,6,1,0,12
1747,2022/08/27,25,20,20,0,45
1772,2022/08/27,3,0,0,0,3
1773,2022/08/27,5,0,1,0,6
1774,2022/08/27,5,0,1,0,6
1782,2022/08/27,17,15,17,0,34
1795,2022/08/27,22,21,15,0,37
1915,2022/08/27,11,0,0,0,11
1923,2022/08/27,11,0,2,0,13
1934,2022/08/27,5,5,1,0,6
1963,2022/08/27,12,12,9,0,21
1984,2022/08/27,9,6,5,0,14
2135,2022/08/27,10,6,2,0,12
2136,2022/08/27,8,0,1,0,9
2148,2022/08/27,4,0,5,0,9
2183,2022/08/27,6,6,7,0,13
2193,2022/08/27,12,9,9,0,21
2237,2022/08/27,10,6,2,0,12
2358,2022/08/27,21,8,9,0,30
2361,2022/08/27,9,7,7,0,16
2445,2022/08/27,11,6,6,0,17
2449,2022/08/27,18,12,8,1,26
2451,2022/08/27,15,5,3,0,18
2475,2022/08/27,9,0,2,0,11
2476,2022/08/27,10,0,2,0,12
2507,2022/08/27,14,12,10,0,24
2525,2022/08/27,4,0,1,0,5
2562,2022/08/27,19,0,5,0,24
2582,2022/08/27,3,0,2,0,5
2586,2022/08/27,12,12,12,0,24
2602,2022/08/27,13,0,4,0,17
2631,2022/08/27,6,6,3,0,9
2685,2022/08/27,15,4,9,0,24
2730,2022/08/27,5,0,1,0,6
2731,2022/08/27,8,0,1,0,9
2732,2022/08/27,6,0,1,0,7
2734,2022/08/27,11,4,0,0,11
2735,2022/08/27,0,0,0,0,0
2761,2022/08/27,20,15,19,0,39
2788,2022/08/27,13,12,11,0,24
2812,2022/08/27,6,0,0,0,6
2813,2022/08/27,5,0,1,0,6
2814,2022/08/27,7,0,0,0,7
2913,2022/08/27,5,0,0,0,5
2914,2022/08/27,7,0,0,0,7
3015,2022/08/27,6,0,1,0,7
3033,2022/08/27,7,0,0,0,7
3035,2022/08/27,8,0,0,0,8
4446,2022/08/27,11,9,10,0,21
12136,2022/08/27,18,18,14,0,32
12516,2022/08/27,1,0,0,0,1
12518,2022/08/27,7,0,6,0,13
12523,2022/08/27,7,4,1,0,8
16062,2022/08/27,10,0,1,0,11
16063,2022/08/27,12,0,1,0,13
19322,2022/08/27,7,0,0,0,7
19516,2022/08/27,14,12,2,0,16
75,2022/08/28,21,24,23,0,44
76,2022/08/28,27,28,29,1,56
99,2022/08/28,12,0,4,1,16
117,2022/08/28,5,0,1,0,6
118,2022/08/28,0,0,0,0,0
119,2022/08/28,6,4,3,0,9
120,2022/08/28,1,0,1,0,2
149,2022/08/28,7,0,1,0,8
184,2022/08/28,9,6,2,0,11
195,2022/08/28,24,24,27,0,51
218,2022/08/28,16,15,16,0,32
296,2022/08/28,13,0,2,0,15
300,2022/08/28,14,0,1,1,15
304,2022/08/28,4,0,3,0,7
317,2022/08/28,28,24,12,0,40
343,2022/08/28,10,0,3,0,13
373,2022/08/28,8,0,6,0,14
374,2022/08/28,10,8,3,0,13
388,2022/08/28,19,18,18,0,37
419,2022/08/28,24,12,14,0,38
420,2022/08/28,13,6,10,0,23
462,2022/08/28,9,8,8,0,17
519,2022/08/28,21,6,2,0,23
525,2022/08/28,3,0,1,0,4
596,2022/08/28,4,4,1,0,5
597,2022/08/28,15,12,9,0,24
598,2022/08/28,6,0,1,0,7
1035,2022/08/28,11,6,9,1,20
1084,2022/08/28,7,5,5,0,12
1111,2022/08/28,11,6,1,0,12
1112,2022/08/28,7,0,1,0,8
1113,2022/08/28,11,0,1,0,12
1114,2022/08/28,4,0,4,0,8
1115,2022/08/28,4,0,1,0,5
1117,2022/08/28,11,0,0,0,11
1118,2022/08/28,6,0,2,0,8
1119,2022/08/28,10,0,1,0,11
1692,2022/08/28,7,6,4,0,11
1693,2022/08/28,16,6,2,0,18
1747,2022/08/28,10,5,10,0,20
1772,2022/08/28,3,0,1,0,4
1773,2022/08/28,10,6,0,0,10
1774,2022/08/28,12,8,4,0,16
1782,2022/08/28,6,6,6,0,12
1795,2022/08/28,7,0,8,0,15
1914,2022/08/28,9,0,1,0,10
1915,2022/08/28,11,0,1,0,12
1923,2022/08/28,9,0,2,0,11
1934,2022/08/28,9,5,4,0,13
1963,2022/08/28,21,18,12,0,33
1984,2022/08/28,4,0,1,0,5
2135,2022/08/28,8,0,1,0,9
2136,2022/08/28,7,0,1,0,8
2148,2022/08/28,3,4,1,0,4
2183,2022/08/28,5,6,4,1,9
2193,2022/08/28,12,9,7,0,19
2237,2022/08/28,8,0,2,0,10
2358,2022/08/28,20,8,7,0,27
2361,2022/08/28,9,7,3,0,12
2445,2022/08/28,5,0,5,0,10
2449,2022/08/28,20,12,16,0,36
2451,2022/08/28,37,25,8,0,45
2475,2022/08/28,7,0,1,0,8
2476,2022/08/28,8,0,2,0,10
2507,2022/08/28,10,6,5,0,15
2525,2022/08/28,3,0,3,0,6
2562,2022/08/28,14,0,5,0,19
2582,2022/08/28,5,4,1,0,6
2586,2022/08/28,8,8,8,0,16
2602,2022/08/28,9,0,1,0,10
2631,2022/08/28,9,6,4,0,13
2685,2022/08/28,10,4,2,0,12
2723,2022/08/28,9,0,1,0,10
2730,2022/08/28,10,6,0,0,10
2731,2022/08/28,7,0,1,0,8
2732,2022/08/28,5,0,0,0,5
2734,2022/08/28,11,0,2,0,13
2735,2022/08/28,0,0,0,0,0
2761,2022/08/28,6,5,6,0,12
2788,2022/08/28,6,4,4,1,10
2812,2022/08/28,6,0,1,0,7
2813,2022/08/28,10,6,0,0,10
2814,2022/08/28,7,0,0,0,7
2913,2022/08/28,11,6,1,0,12
2914,2022/08/28,7,0,1,0,8
3015,2022/08/28,5,0,2,0,7
3033,2022/08/28,7,0,1,0,8
3035,2022/08/28,8,0,0,0,8
4446,2022/08/28,7,6,5,0,12
12136,2022/08/28,10,6,8,0,18
12516,2022/08/28,5,4,1,0,6
12518,2022/08/28,1,0,1,0,2
12523,2022/08/28,14,8,4,0,18
16062,2022/08/28,9,0,0,0,9
16063,2022/08/28,11,0,0,0,11
19322,2022/08/28,7,0,0,0,7
19516,2022/08/28,18,6,4,0,22
19521,2022/08/28,8,8,1,0,9
75,2022/08/29,34,36,41,0,75
76,2022/08/29,32,32,41,0,73
99,2022/08/29,7,0,1,0,8
117,2022/08/29,4,0,0,0,4
118,2022/08/29,4,4,3,0,7
119,2022/08/29,3,0,0,0,3
120,2022/08/29,5,4,0,0,5
149,2022/08/29,6,0,0,0,6
184,2022/08/29,16,9,1,0,17
195,2022/08/29,27,30,30,0,57
218,2022/08/29,24,24,26,0,50
296,2022/08/29,17,6,5,0,22
300,2022/08/29,12,0,5,0,17
304,2022/08/29,7,6,0,0,7
317,2022/08/29,34,18,11,0,45
343,2022/08/29,7,0,2,0,9
373,2022/08/29,4,0,3,0,7
374,2022/08/29,7,0,5,0,12
388,2022/08/29,28,27,24,0,52
419,2022/08/29,10,0,9,0,19
420,2022/08/29,9,6,9,0,18
462,2022/08/29,1,0,4,0,5
519,2022/08/29,25,6,3,0,28
525,2022/08/29,7,5,0,0,7
596,2022/08/29,7,4,0,0,7
597,2022/08/29,12,6,11,0,23
598,2022/08/29,11,6,3,0,14
1035,2022/08/29,7,6,5,0,12
1084,2022/08/29,12,10,8,0,20
1111,2022/08/29,10,0,1,1,11
1112,2022/08/29,6,0,0,2,6
1113,2022/08/29,10,0,1,0,11
1114,2022/08/29,0,0,0,1,0
1115,2022/08/29,9,6,0,0,9
1117,2022/08/29,11,0,0,0,11
1118,2022/08/29,10,6,1,0,11
1119,2022/08/29,9,0,0,0,9
1692,2022/08/29,9,6,9,0,18
1693,2022/08/29,20,6,13,0,33
1747,2022/08/29,10,10,9,0,19
1772,2022/08/29,10,8,2,0,12
1773,2022/08/29,10,0,2,0,12
1774,2022/08/29,8,0,1,0,9
1782,2022/08/29,15,15,16,0,31
1795,2022/08/29,13,14,14,0,27
1914,2022/08/29,8,0,0,0,8
1915,2022/08/29,10,0,0,0,10
1923,2022/08/29,7,0,2,0,9
1934,2022/08/29,5,0,3,0,8
1963,2022/08/29,9,0,9,0,18
1984,2022/08/29,3,0,1,0,4
2135,2022/08/29,7,0,3,0,10
2136,2022/08/29,6,0,0,0,6
2148,2022/08/29,2,0,3,0,5
2183,2022/08/29,6,6,3,0,9
2193,2022/08/29,20,15,21,0,41
2237,2022/08/29,6,0,2,0,8
2358,2022/08/29,13,0,10,0,23
2361,2022/08/29,13,7,0,0,13
2445,2022/08/29,0,0,0,0,0
2449,2022/08/29,11,6,11,0,22
2451,2022/08/29,29,0,10,0,39
2475,2022/08/29,6,0,1,0,7
2476,2022/08/29,6,0,1,0,7
2507,2022/08/29,17,12,10,0,27
2525,2022/08/29,6,6,0,0,6
2562,2022/08/29,21,12,7,2,28
2582,2022/08/29,4,0,3,0,7
2586,2022/08/29,12,12,19,0,31
2602,2022/08/29,8,0,2,0,10
2631,2022/08/29,11,6,5,0,16
2685,2022/08/29,8,0,2,0,10
2723,2022/08/29,8,0,0,0,8
2730,2022/08/29,10,0,1,0,11
2731,2022/08/29,6,0,1,0,7
2732,2022/08/29,5,0,1,0,6
2734,2022/08/29,9,0,8,0,17
2735,2022/08/29,0,0,0,0,0
2761,2022/08/29,15,15,15,0,30
2788,2022/08/29,17,16,19,0,36
2812,2022/08/29,5,0,0,0,5
2813,2022/08/29,10,0,1,0,11
2814,2022/08/29,7,0,0,0,7
2913,2022/08/29,10,0,4,0,14
2914,2022/08/29,6,0,0,0,6
3015,2022/08/29,11,8,1,0,12
3033,2022/08/29,6,0,0,0,6
3035,2022/08/29,8,0,1,0,9
4446,2022/08/29,11,9,11,0,22
12136,2022/08/29,20,18,22,0,42
12516,2022/08/29,4,0,3,0,7
12518,2022/08/29,0,0,0,0,0
12523,2022/08/29,10,0,2,0,12
16062,2022/08/29,9,0,0,0,9
16063,2022/08/29,11,0,0,0,11
19322,2022/08/29,7,0,0,0,7
19516,2022/08/29,14,0,12,0,26
19521,2022/08/29,15,8,2,0,17
75,2022/08/30,33,40,37,1,70
76,2022/08/30,35,44,41,0,76
99,2022/08/30,6,0,1,0,7
117,2022/08/30,8,4,1,0,9
118,2022/08/30,5,4,2,0,7
119,2022/08/30,7,4,3,0,10
120,2022/08/30,5,0,2,0,7
149,2022/08/30,6,0,1,0,7
184,2022/08/30,24,9,18,0,42
195,2022/08/30,27,30,36,0,63
218,2022/08/30,19,21,21,0,40
296,2022/08/30,18,6,1,0,19
300,2022/08/30,7,0,3,0,10
304,2022/08/30,13,6,1,0,14
317,2022/08/30,35,12,14,0,49
343,2022/08/30,5,0,1,0,6
373,2022/08/30,7,6,5,0,12
374,2022/08/30,6,4,4,0,10
388,2022/08/30,19,15,19,0,38
419,2022/08/30,13,12,12,0,25
420,2022/08/30,6,6,6,0,12
462,2022/08/30,5,8,5,0,10
519,2022/08/30,28,6,9,0,37
525,2022/08/30,7,0,0,0,7
596,2022/08/30,15,8,8,0,23
597,2022/08/30,19,18,20,0,39
598,2022/08/30,8,0,0,0,8
1035,2022/08/30,8,6,5,0,13
1084,2022/08/30,14,10,10,0,24
1111,2022/08/30,8,0,1,0,9
1112,2022/08/30,10,6,0,0,10
1113,2022/08/30,9,0,0,0,9
1114,2022/08/30,5,6,0,0,5
1115,2022/08/30,9,0,0,0,9
1117,2022/08/30,11,0,1,0,12
1118,2022/08/30,9,0,0,0,9
1119,2022/08/30,9,0,0,0,9
1692,2022/08/30,6,6,6,0,12
1693,2022/08/30,13,6,9,0,22
1747,2022/08/30,21,20,18,0,39
1772,2022/08/30,8,0,0,0,8
1773,2022/08/30,8,0,1,0,9
1774,2022/08/30,7,0,2,0,9
1782,2022/08/30,20,21,19,0,39
1795,2022/08/30,6,7,9,0,15
1914,2022/08/30,8,0,0,0,8
1915,2022/08/30,10,0,0,0,10
1923,2022/08/30,5,0,1,0,6
1934,2022/08/30,7,5,3,0,10
1963,2022/08/30,24,24,19,0,43
1984,2022/08/30,8,6,1,0,9
2135,2022/08/30,10,6,3,0,13
2136,2022/08/30,6,0,0,0,6
2148,2022/08/30,3,4,2,0,5
2183,2022/08/30,9,6,4,0,13
2193,2022/08/30,11,12,13,0,24
2237,2022/08/30,4,0,1,0,5
2358,2022/08/30,3,0,3,0,6
2361,2022/08/30,13,0,4,0,17
2445,2022/08/30,6,6,5,0,11
2449,2022/08/30,12,12,8,0,20
2451,2022/08/30,19,0,9,0,28
2475,2022/08/30,5,0,0,0,5
2476,2022/08/30,5,0,0,0,5
2507,2022/08/30,19,12,10,0,29
2525,2022/08/30,6,0,0,0,6
2562,2022/08/30,18,6,8,0,26
2582,2022/08/30,5,4,4,0,9
2586,2022/08/30,5,12,5,0,10
2602,2022/08/30,6,0,1,0,7
2631,2022/08/30,6,0,2,0,8
2685,2022/08/30,10,4,3,0,13
2723,2022/08/30,8,0,1,0,9
2730,2022/08/30,9,0,1,0,10
2731,2022/08/30,5,0,0,0,5
2732,2022/08/30,4,0,0,0,4
2734,2022/08/30,5,4,1,0,6
2735,2022/08/30,8,8,2,0,10
2761,2022/08/30,15,15,15,0,30
2788,2022/08/30,14,16,11,0,25
2812,2022/08/30,5,0,0,0,5
2813,2022/08/30,9,0,0,0,9
2814,2022/08/30,7,0,1,0,8
2913,2022/08/30,6,0,2,0,8
2914,2022/08/30,6,0,0,0,6
3015,2022/08/30,10,0,1,0,11
3033,2022/08/30,6,0,0,0,6
3035,2022/08/30,7,0,0,0,7
4446,2022/08/30,6,6,5,0,11
12136,2022/08/30,16,18,17,0,33
12516,2022/08/30,5,4,0,0,5
12518,2022/08/30,10,10,3,0,13
12523,2022/08/30,12,4,2,0,14
16062,2022/08/30,9,0,0,0,9
16063,2022/08/30,11,0,1,0,12
19322,2022/08/30,7,0,0,0,7
19516,2022/08/30,2,0,0,0,2
19521,2022/08/30,13,0,0,0,13
75,2022/08/31,28,32,29,0,57
76,2022/08/31,26,32,30,0,56
99,2022/08/31,17,12,0,0,17
117,2022/08/31,7,0,0,0,7
118,2022/08/31,7,4,4,0,11
119,2022/08/31,4,0,1,1,5
120,2022/08/31,7,4,1,0,8
149,2022/08/31,11,6,0,0,11
184,2022/08/31,13,6,8,0,21
195,2022/08/31,18,27,24,0,42
218,2022/08/31,19,21,21,0,40
296,2022/08/31,23,6,2,0,25
300,2022/08/31,4,0,2,0,6
304,2022/08/31,18,6,8,0,26
317,2022/08/31,33,12,4,0,37
343,2022/08/31,8,4,2,0,10
373,2022/08/31,14,12,4,0,18
374,2022/08/31,6,4,4,0,10
388,2022/08/31,18,18,21,0,39
419,2022/08/31,7,6,7,0,14
420,2022/08/31,12,12,4,0,16
462,2022/08/31,8,8,3,0,11
519,2022/08/31,19,0,4,0,23
525,2022/08/31,7,0,1,1,8
596,2022/08/31,11,4,2,0,13
597,2022/08/31,11,12,9,0,20
598,2022/08/31,8,0,2,0,10
1035,2022/08/31,3,0,0,0,3
1084,2022/08/31,9,5,4,0,13
1111,2022/08/31,7,0,0,0,7
1112,2022/08/31,10,0,0,0,10
1113,2022/08/31,9,0,1,0,10
1114,2022/08/31,5,0,1,0,6
1115,2022/08/31,9,0,2,0,11
1117,2022/08/31,10,0,0,0,10
1118,2022/08/31,9,0,2,0,11
1119,2022/08/31,9,0,2,0,11
1692,2022/08/31,6,6,2,0,8
1693,2022/08/31,10,6,5,0,15
1747,2022/08/31,18,15,15,0,33
1772,2022/08/31,8,0,2,0,10
1773,2022/08/31,7,0,2,0,9
1774,2022/08/31,5,0,2,0,7
1782,2022/08/31,16,15,15,0,31
1795,2022/08/31,18,21,17,0,35
1914,2022/08/31,8,0,0,0,8
1915,2022/08/31,10,0,0,0,10
1923,2022/08/31,10,6,5,0,15
1934,2022/08/31,4,0,3,0,7
1963,2022/08/31,23,18,11,0,34
1984,2022/08/31,13,6,3,0,16
2135,2022/08/31,7,0,1,0,8
2136,2022/08/31,12,6,3,0,15
2148,2022/08/31,5,4,0,0,5
2183,2022/08/31,11,6,1,0,12
2193,2022/08/31,13,15,14,0,27
2237,2022/08/31,3,0,3,0,6
2358,2022/08/31,8,8,4,0,12
2361,2022/08/31,16,7,6,0,22
2445,2022/08/31,7,6,5,0,12
2449,2022/08/31,16,12,7,0,23
2451,2022/08/31,10,0,6,0,16
2475,2022/08/31,11,6,0,0,11
2476,2022/08/31,11,6,0,0,11
2507,2022/08/31,21,12,19,0,40
2525,2022/08/31,12,6,2,0,14
2562,2022/08/31,16,6,9,0,25
2582,2022/08/31,1,0,1,0,2
2586,2022/08/31,12,12,13,0,25
2602,2022/08/31,5,0,1,0,6
2631,2022/08/31,10,6,1,0,11
2685,2022/08/31,11,4,4,0,15
2723,2022/08/31,7,0,2,0,9
2730,2022/08/31,8,0,0,0,8
2731,2022/08/31,11,6,2,0,13
2732,2022/08/31,12,8,1,0,13
2734,2022/08/31,4,0,4,0,8
2735,2022/08/31,14,8,3,0,17
2761,2022/08/31,20,20,15,0,35
2788,2022/08/31,15,12,12,0,27
2812,2022/08/31,5,0,0,0,5
2813,2022/08/31,9,0,0,0,9
2814,2022/08/31,6,0,1,0,7
2913,2022/08/31,4,0,3,0,7
2914,2022/08/31,6,0,0,0,6
3015,2022/08/31,9,0,3,0,12
3033,2022/08/31,6,0,3,0,9
3035,2022/08/31,7,0,2,0,9
4446,2022/08/31,13,12,10,0,23
12136,2022/08/31,17,18,16,0,33
12516,2022/08/31,5,0,2,0,7
12518,2022/08/31,7,0,2,0,9
12523,2022/08/31,10,0,5,0,15
16062,2022/08/31,9,0,0,0,9
16063,2022/08/31,10,0,2,0,12
19322,2022/08/31,7,0,0,0,7
19516,2022/08/31,14,12,9,0,23
19521,2022/08/31,13,0,0,0,13
75,2022/09/01,26,36,50,0,76
76,2022/09/01,17,36,45,0,62
99,2022/09/01,17,0,0,0,17
117,2022/09/01,7,0,0,0,7
118,2022/09/01,7,4,4,0,11
119,2022/09/01,6,4,3,0,9
120,2022/09/01,6,0,2,0,8
149,2022/09/01,11,0,0,0,11
184,2022/09/01,5,6,11,0,16
195,2022/09/01,28,36,45,0,73
218,2022/09/01,18,24,29,0,47
296,2022/09/01,21,0,6,0,27
300,2022/09/01,10,8,4,0,14
304,2022/09/01,16,6,5,0,21
317,2022/09/01,29,0,9,0,38
343,2022/09/01,6,0,2,0,8
373,2022/09/01,16,6,5,0,21
374,2022/09/01,10,8,3,0,13
388,2022/09/01,15,24,26,0,41
419,2022/09/01,6,6,5,0,11
420,2022/09/01,14,6,5,0,19
462,2022/09/01,13,8,5,0,18
519,2022/09/01,15,0,6,6,21
525,2022/09/01,10,5,5,0,15
596,2022/09/01,9,0,9,0,18
597,2022/09/01,15,12,15,0,30
598,2022/09/01,6,0,2,0,8
1035,2022/09/01,15,12,2,0,17
1084,2022/09/01,15,10,15,0,30
1111,2022/09/01,7,0,1,0,8
1112,2022/09/01,10,0,1,0,11
1113,2022/09/01,8,0,1,0,9
1114,2022/09/01,4,0,2,0,6
1115,2022/09/01,7,0,0,0,7
1117,2022/09/01,10,0,0,0,10
1118,2022/09/01,7,0,0,0,7
1119,2022/09/01,7,0,0,0,7
1692,2022/09/01,10,6,10,0,20
1693,2022/09/01,5,0,5,0,10
1747,2022/09/01,24,25,30,0,54
1772,2022/09/01,6,0,0,0,6
1773,2022/09/01,5,0,1,0,6
1774,2022/09/01,11,8,0,0,11
1782,2022/09/01,18,18,21,0,39
1795,2022/09/01,15,14,12,0,27
1914,2022/09/01,8,0,0,0,8
1915,2022/09/01,10,0,0,0,10
1923,2022/09/01,5,0,1,0,6
1934,2022/09/01,6,5,2,1,8
1963,2022/09/01,30,18,24,0,54
1984,2022/09/01,16,6,4,0,20
2135,2022/09/01,6,0,0,0,6
2136,2022/09/01,9,0,0,0,9
2148,2022/09/01,9,4,4,0,13
2183,2022/09/01,10,0,4,0,14
2193,2022/09/01,31,6,7,0,38
2237,2022/09/01,0,0,0,0,0
2358,2022/09/01,4,0,4,0,8
2361,2022/09/01,17,7,13,0,30
2445,2022/09/01,8,6,8,0,16
2449,2022/09/01,21,12,11,0,32
2451,2022/09/01,9,5,7,0,16
2475,2022/09/01,11,0,2,0,13
2476,2022/09/01,11,0,0,0,11
2507,2022/09/01,14,12,14,0,28
2525,2022/09/01,10,0,0,0,10
2562,2022/09/01,13,6,11,0,24
2582,2022/09/01,0,0,0,0,0
2586,2022/09/01,11,12,19,0,30
2602,2022/09/01,4,0,1,0,5
2631,2022/09/01,9,0,7,0,16
2685,2022/09/01,4,4,7,0,11
2723,2022/09/01,5,0,0,0,5
2730,2022/09/01,8,0,1,0,9
2731,2022/09/01,9,0,0,0,9
2732,2022/09/01,11,0,0,0,11
2734,2022/09/01,0,0,0,0,0
2735,2022/09/01,11,0,1,0,12
2761,2022/09/01,16,10,17,0,33
2788,2022/09/01,6,16,16,0,22
2812,2022/09/01,5,0,1,0,6
2813,2022/09/01,9,0,0,0,9
2814,2022/09/01,5,0,1,0,6
2913,2022/09/01,1,0,0,1,1
2914,2022/09/01,6,0,0,0,6
3015,2022/09/01,6,0,1,0,7
3033,2022/09/01,3,0,0,0,3
3035,2022/09/01,5,0,0,0,5
4446,2022/09/01,13,12,18,0,31
12136,2022/09/01,16,24,20,0,36
12516,2022/09/01,3,0,1,0,4
12518,2022/09/01,5,0,2,0,7
12523,2022/09/01,5,0,1,0,6
16062,2022/09/01,9,0,3,0,12
16063,2022/09/01,8,0,0,0,8
19516,2022/09/01,5,0,3,0,8
19521,2022/09/01,13,0,3,0,16
75,2022/09/02,28,48,29,0,57
76,2022/09/02,22,40,22,0,44
99,2022/09/02,17,0,1,0,18
117,2022/09/02,7,0,3,0,10
118,2022/09/02,3,0,1,0,4
119,2022/09/02,3,0,1,1,4
120,2022/09/02,8,4,0,0,8
149,2022/09/02,11,0,0,0,11
184,2022/09/02,0,6,3,0,3
195,2022/09/02,13,30,17,0,30
218,2022/09/02,12,21,13,0,25
296,2022/09/02,15,0,3,0,18
300,2022/09/02,6,0,0,0,6
304,2022/09/02,11,0,0,0,11
317,2022/09/02,26,6,14,0,40
343,2022/09/02,8,4,3,0,11
373,2022/09/02,23,12,8,0,31
374,2022/09/02,11,4,1,0,12
388,2022/09/02,19,24,18,0,37
419,2022/09/02,13,12,10,0,23
420,2022/09/02,15,6,5,0,20
462,2022/09/02,16,8,7,0,23
519,2022/09/02,9,6,9,0,18
525,2022/09/02,5,0,2,0,7
596,2022/09/02,4,4,4,0,8
597,2022/09/02,24,24,10,0,34
598,2022/09/02,10,6,2,0,12
1035,2022/09/02,25,12,7,0,32
1084,2022/09/02,15,15,13,0,28
1111,2022/09/02,6,0,1,0,7
1112,2022/09/02,9,0,1,0,10
1113,2022/09/02,7,0,0,0,7
1114,2022/09/02,8,6,2,0,10
1115,2022/09/02,7,0,1,0,8
1117,2022/09/02,10,0,1,0,11
1118,2022/09/02,13,6,2,0,15
1119,2022/09/02,7,0,1,0,8
1692,2022/09/02,6,6,5,0,11
1693,2022/09/02,6,6,1,0,7
1747,2022/09/02,9,15,12,0,21
1772,2022/09/02,6,0,3,0,9
1773,2022/09/02,4,0,2,0,6
1774,2022/09/02,11,0,0,0,11
1782,2022/09/02,15,18,15,0,30
1795,2022/09/02,24,21,16,0,40
1914,2022/09/02,8,0,0,0,8
1915,2022/09/02,10,0,0,0,10
1923,2022/09/02,4,0,2,0,6
1934,2022/09/02,8,5,3,0,11
1963,2022/09/02,18,12,9,1,27
1984,2022/09/02,12,0,2,0,14
2135,2022/09/02,12,6,3,0,15
2136,2022/09/02,9,0,0,0,9
2148,2022/09/02,9,4,0,0,9
2183,2022/09/02,12,6,6,0,18
2193,2022/09/02,42,18,13,0,55
2237,2022/09/02,0,0,0,0,0
2358,2022/09/02,8,8,5,0,13
2361,2022/09/02,4,0,2,1,6
2445,2022/09/02,12,12,10,0,22
2449,2022/09/02,22,12,6,0,28
2451,2022/09/02,12,10,9,0,21
2475,2022/09/02,9,0,1,0,10
2476,2022/09/02,11,0,0,0,11
2507,2022/09/02,12,12,11,0,23
2525,2022/09/02,10,0,1,0,11
2562,2022/09/02,8,6,2,0,10
2582,2022/09/02,4,4,1,0,5
2586,2022/09/02,12,20,12,0,24
2602,2022/09/02,3,0,0,0,3
2631,2022/09/02,8,6,4,0,12
2685,2022/09/02,1,4,1,0,2
2723,2022/09/02,5,0,0,0,5
2730,2022/09/02,7,0,3,0,10
2731,2022/09/02,9,0,1,0,10
2732,2022/09/02,11,0,0,0,11
2734,2022/09/02,4,4,2,0,6
2735,2022/09/02,10,0,0,0,10
2761,2022/09/02,13,15,12,0,25
2788,2022/09/02,16,16,17,0,33
2812,2022/09/02,4,0,0,0,4
2813,2022/09/02,9,0,0,0,9
2814,2022/09/02,10,6,0,0,10
2913,2022/09/02,0,0,0,0,0
2914,2022/09/02,6,0,1,0,7
3015,2022/09/02,5,0,1,0,6
3033,2022/09/02,3,0,0,0,3
3035,2022/09/02,5,0,0,0,5
4446,2022/09/02,1,6,1,0,2
12136,2022/09/02,22,18,19,0,41
12516,2022/09/02,10,8,0,0,10
12518,2022/09/02,13,10,0,0,13
12523,2022/09/02,8,4,2,0,10
16062,2022/09/02,6,0,0,0,6
16063,2022/09/02,8,0,4,0,12
19516,2022/09/02,8,6,5,0,13
19521,2022/09/02,10,0,0,0,10
75,2022/09/03,19,20,20,0,39
76,2022/09/03,32,32,25,0,57
99,2022/09/03,16,0,0,0,16
117,2022/09/03,8,4,2,0,10
118,2022/09/03,6,4,1,0,7
119,2022/09/03,1,0,0,0,1
120,2022/09/03,8,0,1,0,9
149,2022/09/03,11,0,1,0,12
184,2022/09/03,12,15,18,0,30
195,2022/09/03,20,24,19,0,39
218,2022/09/03,17,18,20,0,37
296,2022/09/03,12,0,5,0,17
300,2022/09/03,14,8,3,0,17
304,2022/09/03,11,0,3,0,14
317,2022/09/03,24,12,9,1,33
343,2022/09/03,5,0,1,0,6
373,2022/09/03,21,6,8,0,29
374,2022/09/03,14,4,2,0,16
388,2022/09/03,16,15,14,0,30
419,2022/09/03,15,12,9,0,24
420,2022/09/03,16,6,3,0,19
462,2022/09/03,17,8,7,0,24
519,2022/09/03,6,6,1,0,7
525,2022/09/03,3,0,1,0,4
596,2022/09/03,0,0,0,0,0
597,2022/09/03,14,0,14,0,28
598,2022/09/03,8,0,1,0,9
1035,2022/09/03,24,6,7,0,31
1084,2022/09/03,2,0,2,0,4
1111,2022/09/03,5,0,1,0,6
1112,2022/09/03,8,0,0,0,8
1113,2022/09/03,7,0,0,0,7
1114,2022/09/03,6,6,5,0,11
1115,2022/09/03,6,6,2,0,8
1117,2022/09/03,9,0,0,0,9
1118,2022/09/03,11,0,1,0,12
1119,2022/09/03,6,0,0,0,6
1692,2022/09/03,7,6,7,0,14
1693,2022/09/03,11,6,1,0,12
1747,2022/09/03,17,20,20,0,37
1772,2022/09/03,3,0,0,0,3
1773,2022/09/03,2,6,0,0,2
1774,2022/09/03,11,0,0,0,11
1782,2022/09/03,18,18,18,0,36
1795,2022/09/03,29,21,9,0,38
1914,2022/09/03,8,0,1,0,9
1915,2022/09/03,10,0,1,0,11
1923,2022/09/03,2,6,1,0,3
1934,2022/09/03,5,0,0,0,5
1963,2022/09/03,8,0,15,0,23
1984,2022/09/03,16,6,5,0,21
2135,2022/09/03,9,0,4,0,13
2136,2022/09/03,9,0,1,0,10
2148,2022/09/03,13,4,2,0,15
2183,2022/09/03,12,6,2,0,14
2193,2022/09/03,38,9,8,0,46
2237,2022/09/03,0,0,0,0,0
2358,2022/09/03,11,8,2,0,13
2361,2022/09/03,8,7,3,0,11
2445,2022/09/03,8,6,7,0,15
2449,2022/09/03,22,6,9,0,31
2451,2022/09/03,8,5,6,0,14
2475,2022/09/03,8,0,0,0,8
2476,2022/09/03,11,0,1,0,12
2507,2022/09/03,7,6,7,0,14
2525,2022/09/03,9,0,1,0,10
2562,2022/09/03,12,6,4,0,16
2582,2022/09/03,3,0,2,0,5
2586,2022/09/03,12,12,12,0,24
2602,2022/09/03,3,8,2,0,5
2631,2022/09/03,10,6,2,0,12
2685,2022/09/03,8,8,8,0,16
2723,2022/09/03,5,0,0,0,5
2730,2022/09/03,4,0,2,0,6
2731,2022/09/03,8,0,2,0,10
2732,2022/09/03,11,0,0,0,11
2734,2022/09/03,6,4,4,0,10
2735,2022/09/03,10,0,1,0,11
2761,2022/09/03,16,15,11,0,27
2788,2022/09/03,11,12,11,0,22
2812,2022/09/03,4,0,0,0,4
2813,2022/09/03,9,0,0,0,9
2814,2022/09/03,10,0,3,0,13
2913,2022/09/03,6,6,5,0,11
2914,2022/09/03,5,0,1,0,6
3015,2022/09/03,4,8,1,0,5
3033,2022/09/03,3,6,0,0,3
3035,2022/09/03,5,6,1,0,6
4446,2022/09/03,6,6,6,0,12
12136,2022/09/03,15,12,12,0,27
12516,2022/09/03,14,4,2,0,16
12518,2022/09/03,13,0,1,0,14
12523,2022/09/03,10,4,0,0,10
16062,2022/09/03,6,0,0,0,6
16063,2022/09/03,4,0,0,0,4
19322,2022/09/03,7,0,1,0,8
19516,2022/09/03,9,6,7,0,16
19521,2022/09/03,10,0,0,0,10
75,2022/09/04,23,24,22,0,45
76,2022/09/04,39,32,28,2,67
99,2022/09/04,16,0,1,0,17
117,2022/09/04,6,0,0,0,6
118,2022/09/04,9,4,2,0,11
119,2022/09/04,5,4,1,0,6
120,2022/09/04,7,0,3,2,10
149,2022/09/04,10,0,2,0,12
184,2022/09/04,0,6,0,0,0
195,2022/09/04,28,27,21,1,49
218,2022/09/04,15,18,11,0,26
296,2022/09/04,13,6,4,0,17
300,2022/09/04,11,0,5,0,16
304,2022/09/04,14,6,2,0,16
317,2022/09/04,14,0,13,0,27
343,2022/09/04,4,4,1,0,5
353,2022/09/04,12,0,1,0,13
373,2022/09/04,19,6,7,1,26
374,2022/09/04,20,8,2,0,22
388,2022/09/04,20,18,17,0,37
419,2022/09/04,18,12,17,0,35
420,2022/09/04,13,0,12,0,25
462,2022/09/04,18,8,12,0,30
519,2022/09/04,11,6,7,0,18
525,2022/09/04,2,0,1,0,3
596,2022/09/04,8,8,8,0,16
597,2022/09/04,12,12,12,0,24
598,2022/09/04,7,0,1,2,8
1035,2022/09/04,23,6,5,0,28
1084,2022/09/04,5,5,6,0,11
1111,2022/09/04,4,0,1,0,5
1112,2022/09/04,8,0,0,0,8
1113,2022/09/04,7,0,1,0,8
1114,2022/09/04,13,6,2,0,15
1115,2022/09/04,10,0,1,0,11
1117,2022/09/04,9,0,2,0,11
1118,2022/09/04,10,0,3,0,13
1119,2022/09/04,6,0,0,0,6
1692,2022/09/04,0,0,0,0,0
1693,2022/09/04,16,6,10,0,26
1747,2022/09/04,7,10,8,0,15
1772,2022/09/04,3,0,0,2,3
1773,2022/09/04,8,0,0,0,8
1774,2022/09/04,11,0,0,0,11
1782,2022/09/04,9,9,9,0,18
1795,2022/09/04,20,0,12,0,32
1914,2022/09/04,7,0,0,0,7
1915,2022/09/04,9,0,0,0,9
1923,2022/09/04,7,0,2,0,9
1934,2022/09/04,5,0,4,1,9
1963,2022/09/04,17,24,15,0,32
1984,2022/09/04,11,0,0,2,11
2135,2022/09/04,5,0,1,0,6
2136,2022/09/04,8,0,0,0,8
2148,2022/09/04,11,0,2,0,13
2183,2022/09/04,10,0,2,0,12
2193,2022/09/04,39,9,11,0,50
2237,2022/09/04,6,6,3,0,9
2358,2022/09/04,25,16,0,0,25
2361,2022/09/04,5,0,3,1,8
2445,2022/09/04,7,6,4,0,11
2449,2022/09/04,19,6,15,0,34
2451,2022/09/04,32,30,12,0,44
2475,2022/09/04,8,0,1,0,9
2476,2022/09/04,10,0,1,0,11
2507,2022/09/04,12,12,7,0,19
2525,2022/09/04,8,0,3,0,11
2562,2022/09/04,20,12,6,0,26
2582,2022/09/04,5,4,2,0,7
2586,2022/09/04,8,8,8,0,16
2602,2022/09/04,9,0,0,0,9
2631,2022/09/04,14,6,2,0,16
2685,2022/09/04,4,4,4,0,8
2723,2022/09/04,5,0,0,0,5
2730,2022/09/04,2,0,2,0,4
2731,2022/09/04,6,0,1,0,7
2732,2022/09/04,11,0,0,0,11
2734,2022/09/04,6,4,5,0,11
2735,2022/09/04,9,0,2,0,11
2761,2022/09/04,15,10,14,0,29
2788,2022/09/04,12,12,9,0,21
2812,2022/09/04,4,0,0,0,4
2813,2022/09/04,9,0,1,0,10
2814,2022/09/04,7,0,0,0,7
2913,2022/09/04,1,0,0,0,1
2914,2022/09/04,4,0,0,0,4
3015,2022/09/04,11,0,2,0,13
3033,2022/09/04,9,0,0,0,9
3035,2022/09/04,10,0,0,0,10
4446,2022/09/04,6,6,5,0,11
12136,2022/09/04,18,15,10,0,28
12516,2022/09/04,12,0,0,0,12
12518,2022/09/04,22,10,6,0,28
12523,2022/09/04,14,4,1,0,15
16062,2022/09/04,12,6,1,0,13
16063,2022/09/04,4,0,1,0,5
19322,2022/09/04,6,0,0,0,6
19516,2022/09/04,20,18,6,0,26
19521,2022/09/04,10,0,1,0,11
75,2022/09/05,49,48,27,2,76
76,2022/09/05,50,40,28,1,78
99,2022/09/05,15,0,1,0,16
117,2022/09/05,6,0,0,0,6
118,2022/09/05,11,4,4,0,15
119,2022/09/05,8,4,1,1,9
120,2022/09/05,2,0,0,0,2
149,2022/09/05,9,0,2,0,11
184,2022/09/05,6,6,6,0,12
195,2022/09/05,45,36,26,1,71
218,2022/09/05,28,24,18,3,46
296,2022/09/05,9,0,2,0,11
300,2022/09/05,14,8,2,0,16
304,2022/09/05,12,0,7,0,19
317,2022/09/05,13,12,11,0,24
343,2022/09/05,3,0,1,0,4
353,2022/09/05,11,0,0,0,11
373,2022/09/05,12,0,7,0,19
374,2022/09/05,18,0,2,0,20
388,2022/09/05,28,24,25,0,53
419,2022/09/05,14,12,11,0,25
420,2022/09/05,7,6,6,0,13
462,2022/09/05,7,0,4,0,11
519,2022/09/05,11,6,3,0,14
525,2022/09/05,6,5,2,0,8
596,2022/09/05,8,8,4,0,12
597,2022/09/05,12,12,7,0,19
598,2022/09/05,4,0,0,0,4
1035,2022/09/05,25,6,4,0,29
1084,2022/09/05,9,10,5,0,14
1111,2022/09/05,9,6,1,0,10
1112,2022/09/05,8,0,0,0,8
1113,2022/09/05,6,0,0,0,6
1114,2022/09/05,11,0,1,0,12
1115,2022/09/05,15,6,1,0,16
1117,2022/09/05,7,0,1,0,8
1118,2022/09/05,7,0,2,0,9
1119,2022/09/05,6,0,0,0,6
1692,2022/09/05,12,12,14,0,26
1693,2022/09/05,19,12,9,0,28
1747,2022/09/05,14,15,13,0,27
1772,2022/09/05,9,8,1,0,10
1773,2022/09/05,14,6,1,0,15
1774,2022/09/05,11,0,0,0,11
1782,2022/09/05,24,24,17,0,41
1795,2022/09/05,22,14,20,1,42
1914,2022/09/05,7,0,0,0,7
1915,2022/09/05,9,0,2,0,11
1923,2022/09/05,12,6,2,0,14
1934,2022/09/05,5,5,3,0,8
1963,2022/09/05,14,12,16,0,30
1984,2022/09/05,15,6,0,0,15
2135,2022/09/05,4,0,0,0,4
2136,2022/09/05,8,0,1,0,9
2148,2022/09/05,9,0,0,0,9
2183,2022/09/05,14,6,2,0,16
2193,2022/09/05,49,21,10,0,59
2237,2022/09/05,9,6,0,0,9
2358,2022/09/05,25,0,3,0,28
2361,2022/09/05,8,7,5,0,13
2445,2022/09/05,11,6,2,0,13
2449,2022/09/05,17,12,14,0,31
2451,2022/09/05,22,0,10,0,32
2475,2022/09/05,7,0,0,0,7
2476,2022/09/05,9,0,1,0,10
2507,2022/09/05,17,12,5,0,22
2525,2022/09/05,5,0,0,0,5
2562,2022/09/05,27,12,11,0,38
2582,2022/09/05,3,0,1,0,4
2586,2022/09/05,21,20,7,0,28
2602,2022/09/05,17,8,0,0,17
2631,2022/09/05,18,6,1,0,19
2685,2022/09/05,8,8,3,0,11
2723,2022/09/05,5,0,0,0,5
2730,2022/09/05,6,6,3,0,9
2731,2022/09/05,5,0,2,0,7
2732,2022/09/05,11,0,0,0,11
2734,2022/09/05,1,0,1,0,2
2735,2022/09/05,8,0,2,0,10
2761,2022/09/05,17,15,15,0,32
2788,2022/09/05,23,20,15,3,38
2812,2022/09/05,10,6,1,0,11
2813,2022/09/05,8,0,0,0,8
2814,2022/09/05,7,0,1,0,8
2913,2022/09/05,1,0,1,0,2
2914,2022/09/05,4,0,0,0,4
3015,2022/09/05,9,0,1,0,10
3033,2022/09/05,15,6,0,0,15
3035,2022/09/05,10,0,0,0,10
4446,2022/09/05,13,12,10,0,23
12136,2022/09/05,30,21,15,3,45
12516,2022/09/05,12,0,3,0,15
12518,2022/09/05,16,0,1,0,17
12523,2022/09/05,13,0,3,0,16
16062,2022/09/05,11,0,0,0,11
16063,2022/09/05,9,6,1,0,10
19322,2022/09/05,6,0,0,0,6
19516,2022/09/05,14,0,12,0,26
19521,2022/09/05,9,0,0,0,9
75,2022/09/06,56,36,33,11,89
76,2022/09/06,60,40,35,8,95
99,2022/09/06,14,0,1,0,15
117,2022/09/06,6,0,1,0,7
118,2022/09/06,11,4,2,0,13
119,2022/09/06,6,0,3,0,9
120,2022/09/06,2,0,1,0,3
149,2022/09/06,6,0,0,0,6
184,2022/09/06,12,12,2,0,14
195,2022/09/06,51,36,18,14,69
218,2022/09/06,31,24,23,3,54
296,2022/09/06,7,0,1,1,8
300,2022/09/06,12,0,2,0,14
304,2022/09/06,5,0,3,0,8
317,2022/09/06,14,12,13,0,27
343,2022/09/06,6,4,2,0,8
353,2022/09/06,11,0,0,0,11
373,2022/09/06,4,0,3,0,7
374,2022/09/06,20,4,3,0,23
388,2022/09/06,26,24,19,0,45
419,2022/09/06,2,0,1,0,3
420,2022/09/06,13,12,11,0,24
462,2022/09/06,10,8,5,2,15
519,2022/09/06,13,6,5,0,18
525,2022/09/06,4,0,2,0,6
596,2022/09/06,12,8,4,0,16
597,2022/09/06,23,18,17,0,40
598,2022/09/06,10,6,5,0,15
1035,2022/09/06,20,0,5,5,25
1084,2022/09/06,14,10,9,0,23
1111,2022/09/06,8,0,0,0,8
1112,2022/09/06,8,0,0,0,8
1113,2022/09/06,6,0,0,0,6
1114,2022/09/06,10,0,3,0,13
1115,2022/09/06,14,0,0,0,14
1117,2022/09/06,6,0,1,0,7
1118,2022/09/06,5,0,0,0,5
1119,2022/09/06,6,0,0,0,6
1692,2022/09/06,4,6,4,0,8
1693,2022/09/06,15,6,14,0,29
1747,2022/09/06,21,20,17,0,38
1772,2022/09/06,8,0,1,0,9
1773,2022/09/06,13,0,0,0,13
1774,2022/09/06,11,0,2,0,13
1782,2022/09/06,28,21,23,1,51
1795,2022/09/06,15,14,5,1,20
1914,2022/09/06,7,0,2,0,9
1915,2022/09/06,7,0,0,0,7
1923,2022/09/06,9,0,0,0,9
1934,2022/09/06,7,5,4,0,11
1963,2022/09/06,-2,0,2,0,0
1984,2022/09/06,15,0,0,5,15
2135,2022/09/06,10,6,1,0,11
2136,2022/09/06,7,0,0,0,7
2148,2022/09/06,13,4,4,0,17
2183,2022/09/06,18,6,2,1,20
2193,2022/09/06,54,15,12,8,66
2237,2022/09/06,9,0,1,0,10
2358,2022/09/06,30,8,3,0,33
2361,2022/09/06,10,7,4,0,14
2445,2022/09/06,13,6,4,0,17
2449,2022/09/06,14,12,10,0,24
2451,2022/09/06,10,0,4,0,14
2475,2022/09/06,7,0,0,0,7
2476,2022/09/06,8,0,0,0,8
2507,2022/09/06,24,12,11,0,35
2525,2022/09/06,5,0,0,0,5
2562,2022/09/06,21,6,18,0,39
2582,2022/09/06,6,4,2,0,8
2586,2022/09/06,29,16,10,0,39
2602,2022/09/06,17,0,5,0,22
2631,2022/09/06,17,0,2,0,19
2685,2022/09/06,9,4,6,0,15
2723,2022/09/06,5,0,0,0,5
2730,2022/09/06,9,6,0,0,9
2731,2022/09/06,3,0,1,0,4
2732,2022/09/06,11,0,1,0,12
2734,2022/09/06,4,4,3,0,7
2735,2022/09/06,5,0,0,0,5
2761,2022/09/06,16,15,15,0,31
2788,2022/09/06,25,20,15,4,40
2812,2022/09/06,9,0,0,0,9
2813,2022/09/06,8,0,2,0,10
2814,2022/09/06,12,6,4,0,16
2913,2022/09/06,6,6,0,0,6
2914,2022/09/06,10,6,0,0,10
3015,2022/09/06,8,0,0,0,8
3033,2022/09/06,15,0,0,0,15
3035,2022/09/06,10,0,1,0,11
4446,2022/09/06,15,12,9,0,24
12136,2022/09/06,29,18,17,2,46
12516,2022/09/06,9,0,1,0,10
12518,2022/09/06,15,0,1,0,16
12523,2022/09/06,14,4,1,0,15
16062,2022/09/06,11,0,0,0,11
16063,2022/09/06,8,0,0,0,8
19322,2022/09/06,6,0,1,0,7
19516,2022/09/06,2,0,0,0,2
19521,2022/09/06,9,0,2,0,11
75,2022/09/07,44,32,48,0,92
76,2022/09/07,49,32,41,3,90
99,2022/09/07,13,0,0,0,13
117,2022/09/07,5,4,1,0,6
118,2022/09/07,9,0,2,0,11
119,2022/09/07,3,0,1,0,4
120,2022/09/07,-1,0,0,0,-1
149,2022/09/07,6,0,0,0,6
184,2022/09/07,19,9,9,0,28
195,2022/09/07,49,30,34,10,83
218,2022/09/07,23,18,25,0,48
296,2022/09/07,11,6,3,0,14
300,2022/09/07,10,0,3,0,13
304,2022/09/07,8,6,2,0,10
317,2022/09/07,11,12,5,0,16
343,2022/09/07,8,4,0,0,8
353,2022/09/07,11,0,1,0,12
373,2022/09/07,6,6,4,0,10
374,2022/09/07,17,0,1,0,18
388,2022/09/07,28,21,8,0,36
419,2022/09/07,11,12,6,0,17
420,2022/09/07,8,6,3,0,11
462,2022/09/07,3,0,11,0,14
519,2022/09/07,14,6,2,0,16
525,2022/09/07,2,0,0,0,2
596,2022/09/07,16,8,1,0,17
597,2022/09/07,18,12,15,0,33
598,2022/09/07,5,0,2,0,7
1035,2022/09/07,10,0,3,0,13
1084,2022/09/07,15,10,12,0,27
1111,2022/09/07,8,0,1,0,9
1112,2022/09/07,8,0,0,0,8
1113,2022/09/07,6,0,2,0,8
1114,2022/09/07,7,0,3,0,10
1115,2022/09/07,14,0,1,0,15
1117,2022/09/07,5,0,0,0,5
1118,2022/09/07,11,6,1,0,12
1119,2022/09/07,6,0,0,0,6
1692,2022/09/07,5,6,5,0,10
1693,2022/09/07,2,0,1,0,3
1747,2022/09/07,24,20,24,0,48
1772,2022/09/07,7,0,2,0,9
1773,2022/09/07,13,0,1,0,14
1774,2022/09/07,9,0,3,0,12
1782,2022/09/07,22,18,17,1,39
1795,2022/09/07,23,14,19,0,42
1914,2022/09/07,5,0,0,0,5
1915,2022/09/07,7,0,0,0,7
1923,2022/09/07,9,0,0,0,9
1934,2022/09/07,3,0,1,0,4
1963,2022/09/07,16,18,9,0,25
1984,2022/09/07,10,0,1,3,11
2135,2022/09/07,9,0,2,0,11
2136,2022/09/07,7,0,0,0,7
2148,2022/09/07,9,0,2,0,11
2183,2022/09/07,15,0,2,1,17
2193,2022/09/07,34,0,5,0,39
2237,2022/09/07,8,0,2,0,10
2358,2022/09/07,27,0,4,0,31
2361,2022/09/07,13,7,1,0,14
2445,2022/09/07,15,6,5,0,20
2449,2022/09/07,4,0,5,0,9
2451,2022/09/07,6,0,2,0,8
2475,2022/09/07,7,0,0,0,7
2476,2022/09/07,8,0,1,0,9
2507,2022/09/07,31,18,8,0,39
2525,2022/09/07,11,6,3,0,14
2562,2022/09/07,3,0,2,0,5
2582,2022/09/07,8,4,0,0,8
2586,2022/09/07,31,12,24,0,55
2602,2022/09/07,12,0,1,0,13
2631,2022/09/07,15,0,1,0,16
2685,2022/09/07,7,4,3,0,10
2723,2022/09/07,5,0,1,0,6
2730,2022/09/07,9,0,1,0,10
2731,2022/09/07,8,6,0,0,8
2732,2022/09/07,10,0,1,0,11
2734,2022/09/07,5,4,0,0,5
2735,2022/09/07,5,0,4,0,9
2761,2022/09/07,16,15,15,0,31
2788,2022/09/07,14,8,14,0,28
2812,2022/09/07,9,0,1,0,10
2813,2022/09/07,6,0,1,0,7
2814,2022/09/07,8,0,0,0,8
2913,2022/09/07,6,0,0,0,6
2914,2022/09/07,10,0,1,0,11
3015,2022/09/07,8,0,0,0,8
3033,2022/09/07,15,0,0,0,15
3035,2022/09/07,9,0,0,0,9
4446,2022/09/07,12,6,10,2,22
12136,2022/09/07,28,18,26,0,54
12516,2022/09/07,8,0,0,0,8
12518,2022/09/07,14,0,3,0,17
12523,2022/09/07,13,0,6,0,19
16062,2022/09/07,11,0,0,0,11
16063,2022/09/07,8,0,0,0,8
19322,2022/09/07,5,0,0,0,5
19521,2022/09/07,7,0,1,0,8
75,2022/09/08,36,40,32,0,68
76,2022/09/08,41,36,50,0,91
99,2022/09/08,13,0,0,0,13
117,2022/09/08,4,0,2,0,6
118,2022/09/08,7,0,0,1,7
119,2022/09/08,2,0,2,0,4
120,2022/09/08,3,4,4,0,7
149,2022/09/08,12,6,1,0,13
184,2022/09/08,22,12,8,0,30
195,2022/09/08,35,30,28,2,63
218,2022/09/08,22,24,28,0,50
296,2022/09/08,14,6,4,0,18
300,2022/09/08,15,8,3,0,18
304,2022/09/08,12,6,2,0,14
317,2022/09/08,18,12,6,0,24
343,2022/09/08,8,0,1,0,9
353,2022/09/08,10,0,0,0,10
373,2022/09/08,14,12,7,0,21
374,2022/09/08,16,0,6,0,22
388,2022/09/08,44,24,27,0,71
419,2022/09/08,17,12,6,0,23
420,2022/09/08,17,12,3,0,20
462,2022/09/08,0,8,6,0,6
519,2022/09/08,18,6,6,0,24
525,2022/09/08,7,5,3,0,10
596,2022/09/08,23,8,6,0,29
597,2022/09/08,21,18,4,0,25
598,2022/09/08,3,0,1,0,4
1035,2022/09/08,7,0,4,0,11
1084,2022/09/08,18,15,8,0,26
1111,2022/09/08,7,0,1,0,8
1112,2022/09/08,8,0,0,0,8
1113,2022/09/08,4,0,0,0,4
1114,2022/09/08,4,0,4,0,8
1115,2022/09/08,13,0,1,0,14
1117,2022/09/08,13,8,0,0,13
1118,2022/09/08,10,0,1,0,11
1119,2022/09/08,6,0,0,0,6
1692,2022/09/08,6,6,3,0,9
1693,2022/09/08,1,0,0,0,1
1747,2022/09/08,25,25,15,0,40
1772,2022/09/08,5,0,1,0,6
1773,2022/09/08,12,0,0,0,12
1774,2022/09/08,6,0,2,0,8
1782,2022/09/08,25,21,20,0,45
1795,2022/09/08,11,7,10,0,21
1914,2022/09/08,5,0,0,0,5
1915,2022/09/08,7,0,0,0,7
1923,2022/09/08,15,6,1,0,16
1934,2022/09/08,7,5,2,0,9
1963,2022/09/08,25,18,4,0,29
1984,2022/09/08,6,0,3,0,9
2135,2022/09/08,7,0,1,0,8
2136,2022/09/08,7,0,2,0,9
2148,2022/09/08,11,4,3,0,14
2183,2022/09/08,12,0,4,0,16
2193,2022/09/08,41,12,17,0,58
2237,2022/09/08,6,0,2,0,8
2358,2022/09/08,23,0,3,0,26
2361,2022/09/08,19,7,3,0,22
2445,2022/09/08,16,6,2,0,18
2449,2022/09/08,11,12,1,0,12
2451,2022/09/08,14,10,7,0,21
2475,2022/09/08,7,0,0,0,7
2476,2022/09/08,7,0,1,0,8
2507,2022/09/08,35,12,10,0,45
2525,2022/09/08,8,0,0,0,8
2562,2022/09/08,7,6,4,0,11
2582,2022/09/08,12,4,5,0,17
2586,2022/09/08,27,20,20,1,47
2602,2022/09/08,11,0,1,0,12
2631,2022/09/08,14,0,1,8,15
2685,2022/09/08,12,8,3,0,15
2723,2022/09/08,4,0,1,0,5
2730,2022/09/08,8,0,0,0,8
2731,2022/09/08,8,0,0,0,8
2732,2022/09/08,9,0,1,0,10
2734,2022/09/08,9,4,3,0,12
2735,2022/09/08,9,8,2,0,11
2761,2022/09/08,16,15,14,0,30
2788,2022/09/08,16,16,16,0,32
2802,2022/09/08,6,6,2,0,8
2812,2022/09/08,8,0,0,0,8
2813,2022/09/08,5,0,0,0,5
2814,2022/09/08,8,0,1,0,9
2913,2022/09/08,12,6,2,0,14
2914,2022/09/08,9,0,0,0,9
3015,2022/09/08,8,0,2,0,10
3033,2022/09/08,15,0,0,0,15
3035,2022/09/08,9,0,0,0,9
4446,2022/09/08,15,15,9,1,24
12136,2022/09/08,23,21,20,0,43
12516,2022/09/08,8,0,1,0,9
12518,2022/09/08,11,0,4,0,15
12523,2022/09/08,7,0,2,0,9
16062,2022/09/08,11,0,1,0,12
16063,2022/09/08,8,0,1,0,9
19322,2022/09/08,5,0,0,0,5
19521,2022/09/08,6,0,0,0,6
75,2022/09/09,17,12,16,0,33
76,2022/09/09,3,12,5,0,8
99,2022/09/09,13,0,0,0,13
117,2022/09/09,2,0,0,0,2
118,2022/09/09,6,0,1,0,7
119,2022/09/09,0,0,0,0,0
120,2022/09/09,-1,0,0,0,-1
149,2022/09/09,11,0,1,0,12
184,2022/09/09,17,3,16,0,33
195,2022/09/09,17,12,20,0,37
218,2022/09/09,3,9,8,0,11
296,2022/09/09,10,0,4,0,14
300,2022/09/09,12,0,0,0,12
304,2022/09/09,10,0,2,0,12
317,2022/09/09,18,6,6,0,24
343,2022/09/09,11,4,4,0,15
353,2022/09/09,10,0,0,0,10
373,2022/09/09,13,6,2,0,15
374,2022/09/09,14,4,2,0,16
388,2022/09/09,26,9,3,0,29
419,2022/09/09,17,6,8,0,25
420,2022/09/09,20,6,1,0,21
462,2022/09/09,2,8,6,0,8
519,2022/09/09,18,6,7,0,25
525,2022/09/09,4,0,4,0,8
596,2022/09/09,21,4,21,0,42
597,2022/09/09,23,6,23,0,46
598,2022/09/09,8,6,1,0,9
1035,2022/09/09,9,6,11,0,20
1084,2022/09/09,15,5,15,0,30
1111,2022/09/09,6,0,1,0,7
1112,2022/09/09,8,0,2,0,10
1113,2022/09/09,4,0,0,0,4
1114,2022/09/09,6,6,6,0,12
1115,2022/09/09,12,0,1,0,13
1117,2022/09/09,13,0,3,0,16
1118,2022/09/09,15,6,0,0,15
1119,2022/09/09,6,0,1,0,7
1692,2022/09/09,9,6,1,0,10
1693,2022/09/09,7,6,0,0,7
1747,2022/09/09,15,5,16,0,31
1772,2022/09/09,4,0,1,0,5
1773,2022/09/09,12,0,1,0,13
1774,2022/09/09,4,0,1,0,5
1782,2022/09/09,11,6,12,0,23
1795,2022/09/09,8,7,10,0,18
1914,2022/09/09,5,0,1,0,6
1915,2022/09/09,7,0,1,0,8
1923,2022/09/09,14,0,4,0,18
1934,2022/09/09,5,0,1,1,6
1963,2022/09/09,27,6,12,0,39
1984,2022/09/09,3,0,3,0,6
2135,2022/09/09,12,6,3,0,15
2136,2022/09/09,5,0,2,0,7
2148,2022/09/09,8,0,6,0,14
2183,2022/09/09,14,6,11,0,25
2193,2022/09/09,30,6,0,0,30
2237,2022/09/09,10,6,2,0,12
2358,2022/09/09,28,8,6,0,34
2361,2022/09/09,16,0,9,1,25
2445,2022/09/09,14,0,15,0,29
2449,2022/09/09,16,6,0,1,16
2451,2022/09/09,12,5,8,0,20
2475,2022/09/09,7,0,1,0,8
2476,2022/09/09,6,0,1,0,7
2507,2022/09/09,25,0,25,0,50
2525,2022/09/09,8,0,2,0,10
2562,2022/09/09,9,6,4,0,13
2582,2022/09/09,7,0,1,0,8
2586,2022/09/09,6,0,6,0,12
2602,2022/09/09,10,0,0,0,10
2631,2022/09/09,11,6,8,3,19
2685,2022/09/09,13,4,15,0,28
2723,2022/09/09,3,0,0,0,3
2730,2022/09/09,8,0,0,0,8
2731,2022/09/09,8,0,1,0,9
2732,2022/09/09,8,0,3,0,11
2734,2022/09/09,6,0,3,0,9
2735,2022/09/09,7,0,5,0,12
2761,2022/09/09,7,5,5,0,12
2788,2022/09/09,4,4,5,0,9
2802,2022/09/09,4,0,1,0,5
2812,2022/09/09,8,0,0,0,8
2813,2022/09/09,5,0,1,0,6
2814,2022/09/09,13,6,2,0,15
2913,2022/09/09,10,0,3,0,13
2914,2022/09/09,9,0,2,0,11
3015,2022/09/09,6,0,3,0,9
3033,2022/09/09,15,0,1,0,16
3035,2022/09/09,9,0,2,0,11
4446,2022/09/09,8,3,10,0,18
12136,2022/09/09,9,6,5,0,14
12516,2022/09/09,11,4,2,0,13
12518,2022/09/09,17,10,2,0,19
12523,2022/09/09,9,4,1,0,10
16062,2022/09/09,10,0,2,0,12
16063,2022/09/09,7,0,2,0,9
19322,2022/09/09,5,0,0,0,5
19521,2022/09/09,6,0,1,0,7
75,2022/09/10,23,24,25,0,48
76,2022/09/10,25,28,28,0,53
99,2022/09/10,13,0,0,0,13
117,2022/09/10,6,4,0,0,6
118,2022/09/10,5,0,3,2,8
119,2022/09/10,0,0,0,0,0
120,2022/09/10,4,4,3,0,7
149,2022/09/10,10,0,1,0,11
184,2022/09/10,17,18,16,0,33
195,2022/09/10,20,21,24,0,44
218,2022/09/10,16,21,26,0,42
296,2022/09/10,6,0,4,2,10
300,2022/09/10,12,0,6,0,18
304,2022/09/10,8,0,5,0,13
317,2022/09/10,30,18,10,0,40
343,2022/09/10,7,0,2,0,9
353,2022/09/10,10,0,1,0,11
373,2022/09/10,17,6,5,0,22
374,2022/09/10,12,0,2,0,14
388,2022/09/10,18,18,28,0,46
419,2022/09/10,21,12,5,0,26
420,2022/09/10,25,6,4,0,29
462,2022/09/10,4,8,5,0,9
519,2022/09/10,17,6,11,0,28
525,2022/09/10,5,5,1,0,6
596,2022/09/10,0,0,3,0,3
597,2022/09/10,1,0,0,0,1
598,2022/09/10,13,6,4,0,17
1035,2022/09/10,12,12,11,0,23
1084,2022/09/10,1,0,0,0,1
1111,2022/09/10,5,0,1,0,6
1112,2022/09/10,6,0,0,0,6
1113,2022/09/10,4,0,2,0,6
1114,2022/09/10,0,0,0,0,0
1115,2022/09/10,11,0,4,0,15
1117,2022/09/10,10,0,1,0,11
1118,2022/09/10,15,0,3,0,18
1119,2022/09/10,5,0,1,0,6
1692,2022/09/10,14,6,5,0,19
1693,2022/09/10,13,6,3,0,16
1747,2022/09/10,22,20,26,0,48
1772,2022/09/10,3,0,2,0,5
1773,2022/09/10,11,0,1,0,12
1774,2022/09/10,11,8,2,0,13
1782,2022/09/10,25,21,23,0,48
1795,2022/09/10,23,21,20,0,43
1914,2022/09/10,4,0,1,0,5
1915,2022/09/10,6,0,2,0,8
1923,2022/09/10,10,0,0,0,10
1934,2022/09/10,7,5,5,0,12
1963,2022/09/10,39,24,10,0,49
1984,2022/09/10,0,0,0,0,0
2135,2022/09/10,15,6,3,0,18
2136,2022/09/10,3,0,0,0,3
2148,2022/09/10,2,0,2,0,4
2183,2022/09/10,9,6,7,0,16
2193,2022/09/10,12,12,12,0,24
2237,2022/09/10,8,0,2,0,10
2358,2022/09/10,22,0,5,13,27
2361,2022/09/10,12,7,9,0,21
2445,2022/09/10,5,6,4,0,9
2449,2022/09/10,27,12,4,0,31
2451,2022/09/10,11,10,8,0,19
2475,2022/09/10,6,0,0,0,6
2476,2022/09/10,5,0,2,0,7
2507,2022/09/10,13,12,12,0,25
2525,2022/09/10,6,0,3,0,9
2562,2022/09/10,17,12,7,0,24
2582,2022/09/10,6,0,2,0,8
2586,2022/09/10,14,12,13,0,27
2602,2022/09/10,10,0,2,0,12
2631,2022/09/10,6,6,4,0,10
2685,2022/09/10,6,8,6,0,12
2723,2022/09/10,3,0,0,0,3
2730,2022/09/10,8,0,0,0,8
2731,2022/09/10,7,0,2,0,9
2732,2022/09/10,5,0,2,0,7
2734,2022/09/10,7,4,3,0,10
2735,2022/09/10,2,0,1,0,3
2761,2022/09/10,11,10,11,0,22
2788,2022/09/10,15,16,15,0,30
2802,2022/09/10,3,0,1,0,4
2812,2022/09/10,8,0,0,0,8
2813,2022/09/10,4,0,0,0,4
2814,2022/09/10,11,0,1,0,12
2913,2022/09/10,7,0,2,0,9
2914,2022/09/10,7,0,2,0,9
3015,2022/09/10,3,0,1,0,4
3033,2022/09/10,14,0,0,0,14
3035,2022/09/10,7,0,0,0,7
4446,2022/09/10,10,9,11,0,21
12136,2022/09/10,17,18,19,0,36
12516,2022/09/10,13,4,1,0,14
12518,2022/09/10,15,0,4,0,19
12523,2022/09/10,12,4,4,0,16
16062,2022/09/10,8,0,1,0,9
16063,2022/09/10,5,0,0,0,5
19322,2022/09/10,5,0,1,0,6
19521,2022/09/10,5,0,1,0,6
75,2022/09/11,22,24,23,0,45
76,2022/09/11,26,28,25,0,51
99,2022/09/11,13,0,0,0,13
117,2022/09/11,10,4,2,0,12
118,2022/09/11,2,4,3,0,5
119,2022/09/11,0,0,0,0,0
120,2022/09/11,1,0,1,0,2
149,2022/09/11,9,0,0,0,9
184,2022/09/11,1,0,0,0,1
195,2022/09/11,20,24,21,0,41
218,2022/09/11,2,12,4,0,6
296,2022/09/11,4,6,4,1,8
300,2022/09/11,14,8,2,0,16
304,2022/09/11,3,0,3,0,6
317,2022/09/11,32,12,12,1,44
343,2022/09/11,5,0,3,1,8
353,2022/09/11,9,0,0,0,9
373,2022/09/11,18,6,4,0,22
374,2022/09/11,14,4,2,0,16
388,2022/09/11,17,27,15,0,32
419,2022/09/11,28,12,9,0,37
420,2022/09/11,27,6,10,0,37
462,2022/09/11,15,16,9,0,24
519,2022/09/11,12,6,6,0,18
525,2022/09/11,4,0,4,0,8
596,2022/09/11,5,8,5,0,10
597,2022/09/11,13,12,13,0,26
598,2022/09/11,9,0,3,0,12
1035,2022/09/11,7,6,5,0,12
1084,2022/09/11,11,10,10,0,21
1111,2022/09/11,10,6,1,0,11
1112,2022/09/11,6,0,0,0,6
1113,2022/09/11,8,6,0,0,8
1114,2022/09/11,6,6,3,0,9
1115,2022/09/11,7,0,0,0,7
1117,2022/09/11,9,0,0,0,9
1118,2022/09/11,12,0,3,0,15
1119,2022/09/11,4,0,1,0,5
1692,2022/09/11,15,6,5,0,20
1693,2022/09/11,16,6,5,0,21
1747,2022/09/11,16,20,13,0,29
1772,2022/09/11,9,8,3,0,12
1773,2022/09/11,10,0,0,0,10
1774,2022/09/11,9,0,3,0,12
1782,2022/09/11,14,12,9,0,23
1795,2022/09/11,3,0,1,0,4
1914,2022/09/11,3,0,0,0,3
1915,2022/09/11,4,0,1,0,5
1923,2022/09/11,10,0,2,0,12
1934,2022/09/11,7,5,6,0,13
1963,2022/09/11,41,12,18,0,59
1984,2022/09/11,6,6,2,0,8
2135,2022/09/11,12,0,1,0,13
2136,2022/09/11,3,0,0,0,3
2148,2022/09/11,4,4,3,0,7
2183,2022/09/11,8,6,7,0,15
2193,2022/09/11,0,0,1,0,1
2237,2022/09/11,6,0,2,0,8
2358,2022/09/11,12,8,4,0,16
2361,2022/09/11,3,0,3,0,6
2445,2022/09/11,1,0,0,0,1
2449,2022/09/11,35,12,9,0,44
2451,2022/09/11,23,20,8,0,31
2475,2022/09/11,6,0,0,0,6
2476,2022/09/11,3,0,1,0,4
2507,2022/09/11,7,6,10,0,17
2525,2022/09/11,3,0,2,0,5
2562,2022/09/11,16,6,6,0,22
2582,2022/09/11,4,0,1,0,5
2586,2022/09/11,17,16,15,0,32
2602,2022/09/11,8,0,0,0,8
2631,2022/09/11,2,0,2,0,4
2685,2022/09/11,0,0,0,0,0
2723,2022/09/11,11,8,0,0,11
2730,2022/09/11,14,6,3,0,17
2731,2022/09/11,5,0,0,0,5
2732,2022/09/11,3,0,0,0,3
2734,2022/09/11,4,0,2,0,6
2735,2022/09/11,9,8,3,0,12
2761,2022/09/11,15,15,8,0,23
2788,2022/09/11,8,8,11,0,19
2802,2022/09/11,8,6,0,0,8
2812,2022/09/11,8,0,2,0,10
2813,2022/09/11,10,6,3,0,13
2814,2022/09/11,10,0,0,0,10
2913,2022/09/11,5,0,2,3,7
2914,2022/09/11,5,0,0,0,5
3015,2022/09/11,2,0,0,0,2
3033,2022/09/11,14,0,0,0,14
3035,2022/09/11,7,0,0,0,7
4446,2022/09/11,8,9,7,0,15
12136,2022/09/11,7,9,6,0,13
12516,2022/09/11,12,0,4,0,16
12518,2022/09/11,21,10,3,0,24
12523,2022/09/11,16,8,6,0,22
16062,2022/09/11,7,0,1,0,8
16063,2022/09/11,5,0,0,0,5
19322,2022/09/11,4,0,0,0,4
19521,2022/09/11,4,0,1,0,5
75,2022/09/12,35,36,31,1,66
76,2022/09/12,32,32,35,0,67
99,2022/09/12,13,0,1,0,14
117,2022/09/12,8,0,2,0,10
118,2022/09/12,9,8,1,0,10
119,2022/09/12,4,4,0,0,4
120,2022/09/12,4,4,3,0,7
149,2022/09/12,9,0,0,0,9
184,2022/09/12,7,6,5,0,12
195,2022/09/12,29,30,26,0,55
218,2022/09/12,25,27,18,0,43
296,2022/09/12,7,6,5,0,12
300,2022/09/12,12,0,0,0,12
304,2022/09/12,6,6,2,0,8
317,2022/09/12,31,12,10,0,41
343,2022/09/12,1,0,1,0,2
353,2022/09/12,9,0,0,0,9
373,2022/09/12,20,6,4,0,24
374,2022/09/12,12,0,3,0,15
388,2022/09/12,26,24,23,1,49
419,2022/09/12,25,6,10,0,35
420,2022/09/12,23,6,2,0,25
462,2022/09/12,14,8,5,0,19
519,2022/09/12,12,6,4,0,16
525,2022/09/12,0,0,0,0,0
596,2022/09/12,0,0,0,0,0
597,2022/09/12,14,12,10,0,24
598,2022/09/12,6,0,1,0,7
1035,2022/09/12,8,6,3,0,11
1084,2022/09/12,6,5,4,0,10
1111,2022/09/12,9,0,1,0,10
1112,2022/09/12,6,0,0,0,6
1113,2022/09/12,8,0,1,0,9
1114,2022/09/12,9,6,1,0,10
1115,2022/09/12,7,0,0,0,7
1117,2022/09/12,9,0,0,0,9
1118,2022/09/12,9,0,0,0,9
1119,2022/09/12,3,0,0,0,3
1692,2022/09/12,16,6,3,0,19
1693,2022/09/12,23,12,4,0,27
1747,2022/09/12,18,15,16,0,34
1772,2022/09/12,6,0,1,0,7
1773,2022/09/12,10,0,1,0,11
1774,2022/09/12,6,0,0,0,6
1782,2022/09/12,26,21,18,0,44
1795,2022/09/12,23,21,6,0,29
1914,2022/09/12,9,6,0,0,9
1915,2022/09/12,3,0,0,0,3
1923,2022/09/12,14,6,0,0,14
1934,2022/09/12,1,0,0,2,1
1963,2022/09/12,35,12,7,0,42
1984,2022/09/12,4,0,2,0,6
2135,2022/09/12,11,0,1,0,12
2136,2022/09/12,9,6,0,0,9
2148,2022/09/12,1,0,1,0,2
2183,2022/09/12,1,0,0,0,1
2193,2022/09/12,11,12,11,0,22
2237,2022/09/12,4,0,0,0,4
2358,2022/09/12,8,0,8,0,16
2361,2022/09/12,0,0,0,0,0
2445,2022/09/12,7,6,6,0,13
2449,2022/09/12,38,12,3,0,41
2451,2022/09/12,15,0,8,0,23
2475,2022/09/12,6,0,1,0,7
2476,2022/09/12,2,0,0,0,2
2507,2022/09/12,9,12,5,0,14
2525,2022/09/12,7,6,1,0,8
2562,2022/09/12,22,12,4,0,26
2582,2022/09/12,3,0,1,0,4
2586,2022/09/12,18,16,13,0,31
2602,2022/09/12,8,0,1,0,9
2631,2022/09/12,6,6,2,0,8
2685,2022/09/12,0,0,0,0,0
2723,2022/09/12,11,0,0,0,11
2730,2022/09/12,11,0,5,0,16
2731,2022/09/12,11,6,0,0,11
2732,2022/09/12,11,8,0,0,11
2734,2022/09/12,2,0,1,0,3
2735,2022/09/12,6,0,2,0,8
2761,2022/09/12,22,15,11,0,33
2788,2022/09/12,17,20,15,0,32
2802,2022/09/12,8,0,0,0,8
2812,2022/09/12,6,0,0,0,6
2813,2022/09/12,7,0,0,0,7
2814,2022/09/12,10,0,0,0,10
2913,2022/09/12,0,0,0,0,0
2914,2022/09/12,11,6,0,0,11
3015,2022/09/12,10,8,0,0,10
3033,2022/09/12,14,0,1,0,15
3035,2022/09/12,7,0,0,0,7
4446,2022/09/12,10,9,11,0,21
12136,2022/09/12,19,18,20,0,39
12516,2022/09/12,8,0,0,0,8
12518,2022/09/12,18,0,4,0,22
12523,2022/09/12,10,0,3,0,13
16062,2022/09/12,6,0,0,0,6
16063,2022/09/12,11,6,0,0,11
19322,2022/09/12,10,6,1,0,11
19521,2022/09/12,3,0,0,0,3
20901,2022/09/12,6,6,1,0,7
75,2022/09/13,35,32,30,1,65
76,2022/09/13,37,40,42,0,79
99,2022/09/13,12,0,0,0,12
117,2022/09/13,6,0,1,1,7
118,2022/09/13,8,0,3,0,11
119,2022/09/13,4,0,2,0,6
120,2022/09/13,1,0,1,0,2
149,2022/09/13,9,0,0,0,9
184,2022/09/13,11,9,3,0,14
195,2022/09/13,24,21,24,0,48
218,2022/09/13,25,18,27,0,52
296,2022/09/13,8,6,3,0,11
300,2022/09/13,12,0,4,0,16
304,2022/09/13,10,6,7,0,17
317,2022/09/13,27,6,11,0,38
343,2022/09/13,8,8,3,0,11
353,2022/09/13,9,0,0,0,9
373,2022/09/13,16,0,3,0,19
374,2022/09/13,13,4,1,0,14
388,2022/09/13,20,18,22,0,42
419,2022/09/13,15,0,6,0,21
420,2022/09/13,33,12,3,0,36
462,2022/09/13,17,8,9,0,26
519,2022/09/13,8,0,6,0,14
525,2022/09/13,5,5,3,0,8
596,2022/09/13,8,8,4,1,12
597,2022/09/13,20,18,5,0,25
598,2022/09/13,5,0,1,0,6
1035,2022/09/13,11,6,0,0,11
1084,2022/09/13,12,10,3,0,15
1111,2022/09/13,8,0,1,0,9
1112,2022/09/13,6,0,0,0,6
1113,2022/09/13,7,0,1,0,8
1114,2022/09/13,8,0,2,0,10
1115,2022/09/13,7,0,0,0,7
1117,2022/09/13,9,0,0,0,9
1118,2022/09/13,9,0,1,0,10
1119,2022/09/13,9,6,0,0,9
1692,2022/09/13,19,6,4,1,23
1693,2022/09/13,25,6,0,0,25
1747,2022/09/13,22,20,20,0,42
1772,2022/09/13,5,0,1,0,6
1773,2022/09/13,9,0,2,0,11
1774,2022/09/13,6,0,3,0,9
1782,2022/09/13,26,18,23,0,49
1795,2022/09/13,31,14,4,0,35
1914,2022/09/13,9,0,1,0,10
1915,2022/09/13,9,6,1,0,10
1923,2022/09/13,14,0,0,0,14
1934,2022/09/13,4,5,5,0,9
1963,2022/09/13,28,0,5,0,33
1984,2022/09/13,8,6,1,0,9
2135,2022/09/13,10,0,1,0,11
2136,2022/09/13,9,0,1,0,10
2148,2022/09/13,4,4,4,0,8
2183,2022/09/13,1,0,0,0,1
2193,2022/09/13,15,15,11,0,26
2237,2022/09/13,10,6,3,0,13
2358,2022/09/13,0,0,0,0,0
2361,2022/09/13,7,7,2,0,9
2445,2022/09/13,7,6,3,0,10
2449,2022/09/13,35,0,5,0,40
2451,2022/09/13,7,0,4,0,11
2475,2022/09/13,5,0,0,0,5
2476,2022/09/13,8,6,1,0,9
2507,2022/09/13,16,12,8,0,24
2525,2022/09/13,6,0,0,0,6
2562,2022/09/13,30,12,2,0,32
2582,2022/09/13,6,4,0,0,6
2586,2022/09/13,17,12,10,0,27
2602,2022/09/13,7,0,1,0,8
2631,2022/09/13,4,0,2,0,6
2685,2022/09/13,8,8,1,0,9
2723,2022/09/13,11,0,1,0,12
2730,2022/09/13,6,0,0,0,6
2731,2022/09/13,11,0,0,0,11
2732,2022/09/13,11,0,2,0,13
2734,2022/09/13,5,4,2,0,7
2735,2022/09/13,4,0,3,0,7
2761,2022/09/13,26,15,18,0,44
2788,2022/09/13,18,16,16,2,34
2802,2022/09/13,8,0,0,0,8
2812,2022/09/13,6,0,0,0,6
2813,2022/09/13,7,0,0,0,7
2814,2022/09/13,10,0,1,0,11
2913,2022/09/13,6,6,1,0,7
2914,2022/09/13,11,0,0,0,11
3015,2022/09/13,10,0,0,0,10
3033,2022/09/13,13,0,0,0,13
3035,2022/09/13,7,0,1,0,8
4446,2022/09/13,8,9,8,0,16
12136,2022/09/13,17,18,18,0,35
12516,2022/09/13,8,0,4,0,12
12518,2022/09/13,14,0,1,0,15
12523,2022/09/13,7,0,3,0,10
16062,2022/09/13,6,0,1,0,7
16063,2022/09/13,11,0,2,0,13
19322,2022/09/13,9,0,0,0,9
19521,2022/09/13,11,8,0,0,11
20901,2022/09/13,11,6,0,0,11
75,2022/09/14,40,36,39,0,79
76,2022/09/14,35,40,44,0,79
99,2022/09/14,12,0,0,0,12
117,2022/09/14,4,0,0,0,4
118,2022/09/14,13,8,0,0,13
119,2022/09/14,6,4,1,0,7
120,2022/09/14,4,4,1,0,5
149,2022/09/14,9,0,4,0,13
184,2022/09/14,20,12,7,0,27
195,2022/09/14,34,33,31,0,65
218,2022/09/14,19,21,19,0,38
296,2022/09/14,11,6,2,0,13
300,2022/09/14,16,8,5,1,21
304,2022/09/14,9,6,1,0,10
317,2022/09/14,28,12,5,0,33
343,2022/09/14,5,0,3,0,8
353,2022/09/14,9,0,2,0,11
373,2022/09/14,19,6,2,0,21
374,2022/09/14,12,0,2,0,14
388,2022/09/14,20,21,21,0,41
419,2022/09/14,15,6,7,0,22
420,2022/09/14,30,0,5,0,35
462,2022/09/14,16,8,8,0,24
519,2022/09/14,8,6,3,0,11
525,2022/09/14,2,0,1,0,3
596,2022/09/14,7,4,2,0,9
597,2022/09/14,27,12,9,0,36
598,2022/09/14,10,6,1,0,11
1035,2022/09/14,17,6,2,0,19
1084,2022/09/14,19,10,6,0,25
1111,2022/09/14,7,0,2,0,9
1112,2022/09/14,6,0,0,0,6
1113,2022/09/14,6,0,0,0,6
1114,2022/09/14,12,6,4,0,16
1115,2022/09/14,13,6,0,0,13
1117,2022/09/14,9,0,0,0,9
1118,2022/09/14,8,0,1,0,9
1119,2022/09/14,9,0,0,0,9
1692,2022/09/14,14,0,7,0,21
1693,2022/09/14,25,0,2,0,27
1747,2022/09/14,22,20,22,0,44
1772,2022/09/14,12,8,1,0,13
1773,2022/09/14,7,0,1,0,8
1774,2022/09/14,11,8,2,0,13
1782,2022/09/14,22,18,17,0,39
1795,2022/09/14,41,14,26,0,67
1914,2022/09/14,8,0,1,0,9
1915,2022/09/14,8,0,1,0,9
1923,2022/09/14,14,0,2,0,16
1934,2022/09/14,4,5,5,0,9
1963,2022/09/14,35,12,3,0,38
1984,2022/09/14,7,0,1,0,8
2135,2022/09/14,9,0,3,0,12
2136,2022/09/14,8,0,0,0,8
2148,2022/09/14,4,4,4,0,8
2183,2022/09/14,7,6,1,0,8
2193,2022/09/14,16,12,15,1,31
2237,2022/09/14,7,0,2,0,9
2358,2022/09/14,8,8,6,0,14
2361,2022/09/14,12,7,2,0,14
2445,2022/09/14,10,6,4,0,14
2449,2022/09/14,30,0,3,0,33
2451,2022/09/14,3,0,1,0,4
2475,2022/09/14,5,0,1,0,6
2476,2022/09/14,13,6,2,0,15
2507,2022/09/14,20,12,9,0,29
2525,2022/09/14,12,6,0,0,12
2562,2022/09/14,28,0,1,0,29
2582,2022/09/14,6,0,2,0,8
2586,2022/09/14,23,16,20,0,43
2602,2022/09/14,6,0,2,0,8
2631,2022/09/14,8,6,2,0,10
2685,2022/09/14,11,4,6,0,17
2723,2022/09/14,10,0,1,0,11
2730,2022/09/14,6,0,0,0,6
2731,2022/09/14,11,0,0,0,11
2732,2022/09/14,9,0,2,0,11
2734,2022/09/14,7,4,3,0,10
2735,2022/09/14,9,8,5,0,14
2761,2022/09/14,26,15,11,0,37
2788,2022/09/14,16,16,17,0,33
2802,2022/09/14,8,0,0,0,8
2812,2022/09/14,6,0,0,0,6
2813,2022/09/14,7,0,1,0,8
2814,2022/09/14,9,0,0,0,9
2913,2022/09/14,5,0,0,0,5
2914,2022/09/14,11,0,2,0,13
3015,2022/09/14,10,0,5,0,15
3033,2022/09/14,13,0,0,0,13
3035,2022/09/14,6,0,0,0,6
4446,2022/09/14,12,12,11,0,23
12136,2022/09/14,23,24,23,0,46
12516,2022/09/14,4,0,0,0,4
12518,2022/09/14,13,0,5,0,18
12523,2022/09/14,4,0,1,0,5
16062,2022/09/14,5,0,0,0,5
16063,2022/09/14,9,0,2,0,11
19322,2022/09/14,9,0,0,0,9
19521,2022/09/14,11,0,0,0,11
20901,2022/09/14,11,0,0,0,11
20920,2022/09/14,12,0,1,0,13
75,2022/09/15,33,32,33,0,66
76,2022/09/15,31,40,37,0,68
99,2022/09/15,12,0,0,0,12
117,2022/09/15,4,0,1,3,5
118,2022/09/15,13,0,2,0,15
119,2022/09/15,5,0,3,0,8
120,2022/09/15,3,0,3,0,6
149,2022/09/15,5,0,0,0,5
184,2022/09/15,22,9,16,0,38
195,2022/09/15,35,33,35,0,70
218,2022/09/15,27,27,27,0,54
296,2022/09/15,9,0,1,0,10
300,2022/09/15,10,0,3,0,13
304,2022/09/15,8,0,1,0,9
317,2022/09/15,35,12,6,0,41
343,2022/09/15,10,8,3,0,13
353,2022/09/15,7,0,0,0,7
373,2022/09/15,23,6,2,0,25
374,2022/09/15,14,4,2,0,16
388,2022/09/15,25,27,25,0,50
419,2022/09/15,14,6,4,0,18
420,2022/09/15,31,6,1,0,32
462,2022/09/15,8,0,4,0,12
519,2022/09/15,11,6,8,0,19
525,2022/09/15,6,5,2,0,8
596,2022/09/15,9,4,3,0,12
597,2022/09/15,30,12,11,0,41
598,2022/09/15,9,0,2,0,11
1035,2022/09/15,21,6,6,0,27
1084,2022/09/15,23,10,4,0,27
1111,2022/09/15,5,0,2,0,7
1112,2022/09/15,6,0,1,0,7
1113,2022/09/15,6,0,2,0,8
1114,2022/09/15,8,0,6,0,14
1115,2022/09/15,13,0,1,0,14
1117,2022/09/15,9,0,1,0,10
1118,2022/09/15,7,0,2,0,9
1119,2022/09/15,9,0,1,0,10
1692,2022/09/15,13,6,2,0,15
1693,2022/09/15,29,6,4,0,33
1747,2022/09/15,15,15,12,0,27
1772,2022/09/15,11,0,0,0,11
1773,2022/09/15,6,0,1,0,7
1774,2022/09/15,9,0,0,0,9
1782,2022/09/15,22,18,17,0,39
1795,2022/09/15,29,14,23,0,52
1914,2022/09/15,7,0,0,0,7
1915,2022/09/15,7,0,1,0,8
1923,2022/09/15,12,0,2,0,14
1934,2022/09/15,4,5,4,0,8
1963,2022/09/15,44,12,7,0,51
1984,2022/09/15,12,6,1,0,13
2135,2022/09/15,6,0,2,0,8
2136,2022/09/15,8,0,1,0,9
2148,2022/09/15,4,4,3,0,7
2183,2022/09/15,12,6,8,0,20
2193,2022/09/15,12,12,12,0,24
2237,2022/09/15,5,0,2,0,7
2358,2022/09/15,10,8,7,0,17
2361,2022/09/15,17,7,12,0,29
2445,2022/09/15,12,6,2,0,14
2449,2022/09/15,33,6,3,0,36
2451,2022/09/15,17,15,10,0,27
2475,2022/09/15,4,0,0,0,4
2476,2022/09/15,11,0,1,0,12
2507,2022/09/15,23,12,12,0,35
2525,2022/09/15,12,0,0,0,12
2562,2022/09/15,33,6,5,0,38
2582,2022/09/15,8,4,4,0,12
2586,2022/09/15,23,20,16,0,39
2602,2022/09/15,12,8,3,0,15
2631,2022/09/15,6,0,1,0,7
2685,2022/09/15,9,4,6,0,15
2723,2022/09/15,9,0,0,0,9
2730,2022/09/15,12,6,1,0,13
2731,2022/09/15,11,0,3,0,14
2732,2022/09/15,7,0,0,0,7
2734,2022/09/15,8,4,0,0,8
2735,2022/09/15,4,0,2,0,6
2761,2022/09/15,27,15,20,0,47
2788,2022/09/15,15,16,17,0,32
2802,2022/09/15,8,0,1,0,9
2812,2022/09/15,6,0,0,0,6
2813,2022/09/15,6,0,0,0,6
2814,2022/09/15,9,0,2,0,11
2913,2022/09/15,5,0,1,0,6
2914,2022/09/15,9,0,0,0,9
3015,2022/09/15,5,0,1,0,6
3033,2022/09/15,13,0,0,0,13
3035,2022/09/15,6,0,1,0,7
4446,2022/09/15,10,9,9,0,19
12136,2022/09/15,18,18,17,0,35
12516,2022/09/15,8,4,2,0,10
12518,2022/09/15,8,0,1,0,9
12523,2022/09/15,7,4,1,0,8
16062,2022/09/15,5,0,1,0,6
16063,2022/09/15,7,0,1,0,8
19322,2022/09/15,9,0,1,0,10
19521,2022/09/15,11,0,1,0,12
20901,2022/09/15,11,0,0,0,11
20920,2022/09/15,11,0,0,0,11
75,2022/09/16,36,36,33,0,69
76,2022/09/16,41,40,34,0,75
99,2022/09/16,12,0,0,0,12
117,2022/09/16,8,8,0,0,8
118,2022/09/16,11,0,0,0,11
119,2022/09/16,6,4,2,0,8
120,2022/09/16,4,4,2,0,6
149,2022/09/16,5,0,1,0,6
184,2022/09/16,24,18,7,0,31
195,2022/09/16,23,24,24,0,47
218,2022/09/16,24,24,24,0,48
296,2022/09/16,14,6,3,0,17
300,2022/09/16,7,0,1,0,8
304,2022/09/16,13,6,3,0,16
317,2022/09/16,29,0,3,0,32
343,2022/09/16,7,0,3,0,10
373,2022/09/16,21,0,4,2,25
374,2022/09/16,12,0,5,0,17
388,2022/09/16,20,18,19,0,39
419,2022/09/16,16,6,1,0,17
420,2022/09/16,30,0,1,0,31
462,2022/09/16,12,8,6,0,18
519,2022/09/16,15,12,7,0,22
525,2022/09/16,4,0,3,0,7
596,2022/09/16,14,8,5,0,19
597,2022/09/16,43,24,16,0,59
598,2022/09/16,7,0,3,0,10
1035,2022/09/16,27,12,11,0,38
1084,2022/09/16,34,15,10,0,44
1111,2022/09/16,9,6,0,0,9
1112,2022/09/16,11,6,0,0,11
1113,2022/09/16,10,6,0,0,10
1114,2022/09/16,2,0,2,0,4
1115,2022/09/16,12,0,1,0,13
1117,2022/09/16,8,0,1,0,9
1118,2022/09/16,11,6,3,0,14
1119,2022/09/16,8,0,0,0,8
1692,2022/09/16,11,0,3,0,14
1693,2022/09/16,25,0,4,0,29
1747,2022/09/16,21,20,18,0,39
1772,2022/09/16,11,0,1,0,12
1773,2022/09/16,5,0,1,0,6
1774,2022/09/16,9,0,2,0,11
1782,2022/09/16,5,18,1,0,6
1795,2022/09/16,20,14,14,0,34
1914,2022/09/16,7,0,2,0,9
1915,2022/09/16,6,0,0,0,6
1923,2022/09/16,10,0,1,0,11
1934,2022/09/16,0,0,1,0,1
1963,2022/09/16,49,12,5,0,54
1984,2022/09/16,11,0,1,0,12
2135,2022/09/16,4,0,3,0,7
2136,2022/09/16,7,0,0,0,7
2148,2022/09/16,5,4,4,0,9
2183,2022/09/16,16,12,6,0,22
2193,2022/09/16,2,12,0,0,2
2237,2022/09/16,9,6,3,0,12
2358,2022/09/16,11,8,8,0,19
2361,2022/09/16,13,7,7,0,20
2445,2022/09/16,22,12,4,0,26
2449,2022/09/16,30,0,2,4,32
2451,2022/09/16,22,15,9,0,31
2475,2022/09/16,4,0,0,0,4
2476,2022/09/16,10,0,0,0,10
2507,2022/09/16,23,12,19,0,42
2525,2022/09/16,12,0,0,0,12
2562,2022/09/16,34,6,3,0,37
2582,2022/09/16,4,0,3,0,7
2586,2022/09/16,7,16,3,0,10
2602,2022/09/16,9,0,0,0,9
2631,2022/09/16,11,6,6,0,17
2685,2022/09/16,11,8,10,0,21
2730,2022/09/16,11,0,4,0,15
2731,2022/09/16,8,0,1,0,9
2732,2022/09/16,7,0,1,0,8
2734,2022/09/16,12,4,4,0,16
2735,2022/09/16,10,8,3,0,13
2761,2022/09/16,7,0,6,0,13
2788,2022/09/16,14,16,14,0,28
2802,2022/09/16,7,0,0,0,7
2812,2022/09/16,6,0,0,0,6
2813,2022/09/16,6,0,0,0,6
2814,2022/09/16,7,0,0,0,7
2913,2022/09/16,10,6,2,0,12
2914,2022/09/16,9,0,1,0,10
3015,2022/09/16,4,0,0,0,4
3033,2022/09/16,13,0,0,0,13
3035,2022/09/16,5,0,0,0,5
4446,2022/09/16,1,12,0,0,1
12136,2022/09/16,1,18,3,0,4
12516,2022/09/16,6,0,0,0,6
12518,2022/09/16,17,10,0,0,17
12523,2022/09/16,10,4,6,0,16
16062,2022/09/16,10,6,0,0,10
16063,2022/09/16,6,0,2,0,8
16276,2022/09/16,6,0,1,0,7
19322,2022/09/16,8,0,1,0,9
19521,2022/09/16,10,0,0,0,10
20901,2022/09/16,11,0,0,0,11
20920,2022/09/16,11,0,1,0,12
75,2022/09/17,27,24,24,0,51
76,2022/09/17,39,32,36,0,75
99,2022/09/17,12,0,0,0,12
117,2022/09/17,8,0,2,0,10
118,2022/09/17,11,0,3,2,14
119,2022/09/17,4,0,0,0,4
120,2022/09/17,6,4,0,0,6
149,2022/09/17,10,6,0,0,10
184,2022/09/17,17,0,11,3,28
195,2022/09/17,26,27,19,0,45
218,2022/09/17,18,18,15,0,33
296,2022/09/17,11,0,3,0,14
300,2022/09/17,6,0,5,0,11
304,2022/09/17,10,0,1,0,11
317,2022/09/17,32,6,2,2,34
343,2022/09/17,4,0,3,1,7
373,2022/09/17,21,6,5,3,26
374,2022/09/17,7,0,1,0,8
388,2022/09/17,25,24,22,0,47
419,2022/09/17,27,12,11,0,38
420,2022/09/17,29,0,2,1,31
462,2022/09/17,14,8,4,0,18
519,2022/09/17,14,6,8,0,22
525,2022/09/17,6,5,3,0,9
596,2022/09/17,9,0,2,0,11
597,2022/09/17,27,0,11,0,38
598,2022/09/17,4,0,0,0,4
1035,2022/09/17,22,6,6,3,28
1084,2022/09/17,24,0,6,7,30
1111,2022/09/17,9,0,4,0,13
1112,2022/09/17,11,0,0,0,11
1113,2022/09/17,10,0,0,0,10
1114,2022/09/17,6,6,3,0,9
1115,2022/09/17,11,0,1,0,12
1117,2022/09/17,7,0,1,0,8
1118,2022/09/17,8,0,3,0,11
1119,2022/09/17,8,0,0,0,8
1692,2022/09/17,8,0,6,1,14
1693,2022/09/17,21,0,3,0,24
1747,2022/09/17,23,20,17,0,40
1772,2022/09/17,10,0,1,0,11
1773,2022/09/17,4,0,0,0,4
1774,2022/09/17,7,0,1,0,8
1782,2022/09/17,22,18,16,0,38
1795,2022/09/17,27,21,20,0,47
1914,2022/09/17,5,0,1,0,6
1915,2022/09/17,6,0,0,0,6
1923,2022/09/17,9,0,3,0,12
1934,2022/09/17,4,5,3,0,7
1963,2022/09/17,62,18,5,2,67
1984,2022/09/17,16,6,1,2,17
2135,2022/09/17,7,6,2,0,9
2136,2022/09/17,7,0,1,0,8
2148,2022/09/17,5,4,0,0,5
2183,2022/09/17,16,6,1,0,17
2193,2022/09/17,8,6,6,0,14
2237,2022/09/17,6,0,4,0,10
2358,2022/09/17,3,0,2,0,5
2361,2022/09/17,12,7,1,0,13
2445,2022/09/17,24,6,7,0,31
2449,2022/09/17,30,6,3,14,33
2451,2022/09/17,18,5,3,0,21
2475,2022/09/17,10,6,0,0,10
2476,2022/09/17,10,0,1,0,11
2507,2022/09/17,16,12,5,0,21
2525,2022/09/17,12,0,1,0,13
2562,2022/09/17,31,0,6,0,37
2582,2022/09/17,1,0,1,0,2
2586,2022/09/17,4,0,2,0,6
2602,2022/09/17,9,0,1,0,10
2631,2022/09/17,5,0,2,0,7
2685,2022/09/17,5,4,4,0,9
2730,2022/09/17,7,0,1,0,8
2731,2022/09/17,7,0,1,0,8
2732,2022/09/17,6,0,0,0,6
2734,2022/09/17,8,0,3,0,11
2735,2022/09/17,7,0,0,0,7
2761,2022/09/17,16,15,15,0,31
2788,2022/09/17,8,8,8,0,16
2802,2022/09/17,7,0,0,0,7
2812,2022/09/17,6,0,0,0,6
2813,2022/09/17,6,0,2,1,8
2814,2022/09/17,7,0,3,0,10
2913,2022/09/17,8,0,0,0,8
2914,2022/09/17,8,0,0,0,8
3015,2022/09/17,12,8,2,0,14
3033,2022/09/17,13,0,1,0,14
3035,2022/09/17,5,0,2,0,7
4446,2022/09/17,13,12,6,0,19
12136,2022/09/17,13,15,14,0,27
12516,2022/09/17,10,4,1,0,11
12518,2022/09/17,17,0,3,0,20
12523,2022/09/17,8,4,1,0,9
16062,2022/09/17,10,0,1,0,11
16063,2022/09/17,10,6,0,0,10
16276,2022/09/17,5,0,2,0,7
19322,2022/09/17,7,0,0,0,7
19521,2022/09/17,10,0,0,0,10
20901,2022/09/17,11,0,0,0,11
20920,2022/09/17,10,0,0,0,10
75,2022/09/18,27,24,23,0,50
76,2022/09/18,23,20,17,0,40
99,2022/09/18,12,0,0,0,12
117,2022/09/18,6,0,3,0,9
118,2022/09/18,6,0,2,0,8
119,2022/09/18,4,0,0,0,4
120,2022/09/18,6,0,2,0,8
149,2022/09/18,10,0,0,0,10
184,2022/09/18,9,6,9,0,18
195,2022/09/18,28,21,14,2,42
218,2022/09/18,15,12,13,0,28
296,2022/09/18,14,6,4,0,18
300,2022/09/18,9,8,5,0,14
304,2022/09/18,15,6,3,0,18
317,2022/09/18,34,6,5,0,39
343,2022/09/18,8,8,0,0,8
373,2022/09/18,13,0,1,2,14
374,2022/09/18,14,8,2,0,16
388,2022/09/18,15,12,12,2,27
419,2022/09/18,28,12,6,1,34
420,2022/09/18,26,0,2,0,28
462,2022/09/18,18,8,7,0,25
519,2022/09/18,12,6,4,0,16
525,2022/09/18,3,0,2,0,5
596,2022/09/18,11,4,1,2,12
597,2022/09/18,28,12,10,4,38
598,2022/09/18,10,6,1,2,11
1035,2022/09/18,13,0,1,0,14
1084,2022/09/18,21,10,10,0,31
1111,2022/09/18,5,0,0,0,5
1112,2022/09/18,11,0,0,0,11
1113,2022/09/18,10,0,0,0,10
1114,2022/09/18,9,6,4,0,13
1115,2022/09/18,10,0,2,0,12
1117,2022/09/18,6,0,0,0,6
1118,2022/09/18,5,0,0,0,5
1119,2022/09/18,8,0,0,0,8
1692,2022/09/18,7,6,5,0,12
1693,2022/09/18,18,0,7,0,25
1747,2022/09/18,26,20,21,0,47
1772,2022/09/18,9,0,2,0,11
1773,2022/09/18,10,6,0,0,10
1774,2022/09/18,6,0,3,0,9
1782,2022/09/18,27,21,16,0,43
1795,2022/09/18,7,0,7,0,14
1914,2022/09/18,4,0,0,0,4
1915,2022/09/18,6,0,1,0,7
1923,2022/09/18,6,0,1,0,7
1934,2022/09/18,6,5,0,0,6
1963,2022/09/18,73,18,9,14,82
1984,2022/09/18,13,0,1,0,14
2135,2022/09/18,5,0,1,0,6
2136,2022/09/18,6,0,0,0,6
2148,2022/09/18,13,8,1,0,14
2183,2022/09/18,21,6,1,0,22
2193,2022/09/18,14,12,10,0,24
2237,2022/09/18,2,0,1,0,3
2358,2022/09/18,9,8,5,0,14
2361,2022/09/18,11,0,8,0,19
2445,2022/09/18,23,6,6,0,29
2449,2022/09/18,13,0,6,1,19
2451,2022/09/18,40,25,10,2,50
2475,2022/09/18,10,0,1,0,11
2476,2022/09/18,9,0,0,0,9
2507,2022/09/18,23,12,10,1,33
2525,2022/09/18,11,0,2,0,13
2562,2022/09/18,25,0,2,0,27
2582,2022/09/18,4,4,2,0,6
2586,2022/09/18,18,16,7,0,25
2602,2022/09/18,8,0,0,0,8
2631,2022/09/18,9,6,1,0,10
2685,2022/09/18,5,4,4,0,9
2730,2022/09/18,6,0,2,0,8
2731,2022/09/18,12,6,1,0,13
2732,2022/09/18,6,0,1,0,7
2734,2022/09/18,5,0,2,0,7
2735,2022/09/18,15,8,2,0,17
2761,2022/09/18,11,10,11,0,22
2788,2022/09/18,12,12,13,1,25
2802,2022/09/18,7,0,0,0,7
2812,2022/09/18,6,0,1,0,7
2813,2022/09/18,3,0,1,0,4
2814,2022/09/18,4,0,3,0,7
2913,2022/09/18,14,6,1,2,15
2914,2022/09/18,8,0,0,0,8
3015,2022/09/18,10,0,1,0,11
3033,2022/09/18,12,0,2,0,14
3035,2022/09/18,3,0,0,0,3
4446,2022/09/18,16,9,4,0,20
12136,2022/09/18,14,15,14,0,28
12516,2022/09/18,9,0,2,0,11
12518,2022/09/18,14,0,3,0,17
12523,2022/09/18,11,4,4,0,15
16062,2022/09/18,9,0,0,0,9
16063,2022/09/18,10,0,1,0,11
16276,2022/09/18,3,0,3,0,6
19322,2022/09/18,7,0,1,0,8
19521,2022/09/18,10,0,2,0,12
20901,2022/09/18,11,0,0,0,11
20920,2022/09/18,10,0,1,0,11
75,2022/09/19,40,36,34,0,74
76,2022/09/19,46,40,39,0,85
99,2022/09/19,12,0,1,0,13
117,2022/09/19,3,0,1,0,4
118,2022/09/19,4,0,4,0,8
119,2022/09/19,8,4,2,0,10
120,2022/09/19,8,4,2,0,10
149,2022/09/19,10,0,0,0,10
184,2022/09/19,6,6,4,0,10
195,2022/09/19,45,33,27,3,72
218,2022/09/19,25,24,24,0,49
296,2022/09/19,16,6,1,0,17
300,2022/09/19,12,8,4,0,16
304,2022/09/19,12,0,5,0,17
317,2022/09/19,35,6,14,0,49
343,2022/09/19,8,0,4,0,12
373,2022/09/19,16,6,7,0,23
374,2022/09/19,12,0,2,2,14
388,2022/09/19,25,24,22,0,47
419,2022/09/19,27,6,6,0,33
420,2022/09/19,24,0,6,5,30
462,2022/09/19,19,8,6,0,25
519,2022/09/19,14,6,7,0,21
525,2022/09/19,6,5,0,0,6
596,2022/09/19,12,4,4,1,16
597,2022/09/19,26,12,12,1,38
598,2022/09/19,7,0,2,0,9
1035,2022/09/19,12,0,1,1,13
1084,2022/09/19,16,5,9,0,25
1111,2022/09/19,5,0,1,0,6
1112,2022/09/19,11,0,0,0,11
1113,2022/09/19,10,0,0,0,10
1114,2022/09/19,5,0,1,0,6
1115,2022/09/19,8,0,0,0,8
1117,2022/09/19,6,0,0,0,6
1118,2022/09/19,11,6,0,0,11
1119,2022/09/19,8,0,0,0,8
1692,2022/09/19,8,6,1,0,9
1693,2022/09/19,11,0,2,4,13
1747,2022/09/19,20,15,21,0,41
1772,2022/09/19,7,0,1,0,8
1773,2022/09/19,10,0,0,0,10
1774,2022/09/19,3,0,0,0,3
1782,2022/09/19,29,18,15,1,44
1795,2022/09/19,14,14,12,0,26
1914,2022/09/19,10,6,0,0,10
1915,2022/09/19,5,0,0,0,5
1923,2022/09/19,5,0,1,0,6
1934,2022/09/19,11,5,3,0,14
1963,2022/09/19,50,0,9,0,59
1984,2022/09/19,12,0,2,0,14
2135,2022/09/19,4,0,1,0,5
2136,2022/09/19,6,0,0,0,6
2148,2022/09/19,12,0,0,0,12
2183,2022/09/19,20,0,0,0,20
2193,2022/09/19,16,12,14,0,30
2237,2022/09/19,7,6,3,0,10
2358,2022/09/19,4,0,3,0,7
2361,2022/09/19,10,7,5,0,15
2445,2022/09/19,17,0,3,1,20
2449,2022/09/19,12,6,4,4,16
2451,2022/09/19,28,0,8,0,36
2475,2022/09/19,9,0,0,0,9
2476,2022/09/19,9,0,0,0,9
2507,2022/09/19,23,12,7,0,30
2525,2022/09/19,9,0,0,0,9
2562,2022/09/19,23,0,7,0,30
2582,2022/09/19,2,0,1,0,3
2586,2022/09/19,27,16,13,0,40
2602,2022/09/19,8,0,3,0,11
2631,2022/09/19,8,0,1,0,9
2685,2022/09/19,9,8,3,0,12
2723,2022/09/19,9,0,0,0,9
2730,2022/09/19,10,6,3,0,13
2731,2022/09/19,11,0,1,0,12
2732,2022/09/19,5,0,2,0,7
2734,2022/09/19,3,0,2,0,5
2735,2022/09/19,13,0,1,0,14
2761,2022/09/19,20,20,13,0,33
2788,2022/09/19,18,20,15,0,33
2802,2022/09/19,7,0,0,0,7
2812,2022/09/19,5,0,1,0,6
2813,2022/09/19,2,0,0,0,2
2814,2022/09/19,1,0,0,0,1
2913,2022/09/19,11,0,2,0,13
2914,2022/09/19,8,0,1,0,9
3015,2022/09/19,9,0,1,0,10
3033,2022/09/19,10,0,0,0,10
3035,2022/09/19,3,0,0,0,3
4446,2022/09/19,24,12,14,2,38
12136,2022/09/19,21,21,19,0,40
12516,2022/09/19,7,0,2,0,9
12518,2022/09/19,11,0,1,0,12
12523,2022/09/19,7,0,4,0,11
16062,2022/09/19,9,0,0,0,9
16063,2022/09/19,9,0,0,0,9
16276,2022/09/19,0,0,0,0,0
19322,2022/09/19,6,0,0,0,6
19521,2022/09/19,8,0,0,0,8
20901,2022/09/19,11,0,0,0,11
20920,2022/09/19,9,0,0,0,9
75,2022/09/20,42,36,35,2,77
76,2022/09/20,47,40,36,0,83
99,2022/09/20,11,0,0,0,11
117,2022/09/20,2,0,2,0,4
118,2022/09/20,8,8,4,0,12
119,2022/09/20,6,0,1,0,7
120,2022/09/20,6,0,1,0,7
149,2022/09/20,10,0,0,0,10
184,2022/09/20,2,0,1,0,3
195,2022/09/20,48,33,15,4,63
218,2022/09/20,26,24,19,0,45
296,2022/09/20,15,0,4,0,19
300,2022/09/20,8,0,2,0,10
304,2022/09/20,13,6,4,0,17
317,2022/09/20,21,0,5,6,26
343,2022/09/20,4,0,1,0,5
373,2022/09/20,9,0,2,0,11
374,2022/09/20,12,4,3,0,15
388,2022/09/20,27,24,19,0,46
419,2022/09/20,21,0,9,3,30
420,2022/09/20,13,0,2,5,15
462,2022/09/20,21,8,7,0,28
519,2022/09/20,7,0,2,0,9
525,2022/09/20,6,0,0,0,6
596,2022/09/20,11,4,6,1,17
597,2022/09/20,13,0,12,0,25
598,2022/09/20,11,6,0,0,11
1035,2022/09/20,16,6,1,0,17
1084,2022/09/20,7,0,5,0,12
1111,2022/09/20,10,6,0,0,10
1112,2022/09/20,11,0,0,0,11
1113,2022/09/20,10,0,1,0,11
1114,2022/09/20,10,6,2,0,12
1115,2022/09/20,8,0,1,0,9
1117,2022/09/20,6,0,1,0,7
1118,2022/09/20,11,0,0,0,11
1119,2022/09/20,8,0,0,0,8
1692,2022/09/20,7,0,3,0,10
1693,2022/09/20,11,6,0,4,11
1747,2022/09/20,19,20,11,0,30
1772,2022/09/20,6,0,1,0,7
1773,2022/09/20,10,0,0,0,10
1774,2022/09/20,11,8,1,0,12
1782,2022/09/20,34,21,20,0,54
1795,2022/09/20,23,21,10,0,33
1914,2022/09/20,10,0,0,0,10
1915,2022/09/20,5,0,2,0,7
1923,2022/09/20,10,6,1,0,11
1934,2022/09/20,13,5,2,0,15
1963,2022/09/20,41,0,9,14,50
1984,2022/09/20,10,0,3,1,13
2135,2022/09/20,3,0,1,0,4
2136,2022/09/20,6,0,2,0,8
2148,2022/09/20,16,4,2,0,18
2183,2022/09/20,20,0,1,0,21
2193,2022/09/20,14,12,14,0,28
2237,2022/09/20,10,6,1,0,11
2358,2022/09/20,9,8,3,0,12
2361,2022/09/20,5,0,2,0,7
2445,2022/09/20,13,0,1,3,14
2449,2022/09/20,10,6,2,3,12
2451,2022/09/20,20,0,9,0,29
2475,2022/09/20,9,0,0,0,9
2476,2022/09/20,9,0,0,0,9
2507,2022/09/20,29,12,6,0,35
2525,2022/09/20,9,0,0,0,9
2562,2022/09/20,22,6,2,10,24
2582,2022/09/20,5,4,2,0,7
2586,2022/09/20,26,12,6,0,32
2602,2022/09/20,5,0,2,0,7
2631,2022/09/20,13,6,3,0,16
2685,2022/09/20,10,4,5,0,15
2723,2022/09/20,9,0,0,0,9
2730,2022/09/20,7,0,1,0,8
2731,2022/09/20,10,0,0,0,10
2732,2022/09/20,3,0,0,0,3
2734,2022/09/20,5,4,1,0,6
2735,2022/09/20,12,0,6,0,18
2761,2022/09/20,22,15,6,0,28
2788,2022/09/20,19,16,14,1,33
2802,2022/09/20,7,0,0,0,7
2812,2022/09/20,4,0,1,0,5
2813,2022/09/20,8,6,2,0,10
2814,2022/09/20,7,6,3,0,10
2913,2022/09/20,9,0,1,0,10
2914,2022/09/20,7,0,1,0,8
3015,2022/09/20,8,0,3,0,11
3033,2022/09/20,10,0,1,0,11
3035,2022/09/20,9,6,0,0,9
4446,2022/09/20,17,9,12,1,29
12136,2022/09/20,20,18,21,0,41
12516,2022/09/20,9,4,0,0,9
12518,2022/09/20,10,0,0,0,10
12523,2022/09/20,7,4,2,0,9
16062,2022/09/20,9,0,0,0,9
16063,2022/09/20,9,0,3,0,12
16276,2022/09/20,0,0,0,0,0
19322,2022/09/20,6,0,0,0,6
19521,2022/09/20,8,0,0,0,8
20901,2022/09/20,11,0,0,0,11
20920,2022/09/20,9,0,1,0,10
75,2022/09/21,41,36,29,1,70
76,2022/09/21,51,40,50,0,101
99,2022/09/21,11,0,0,0,11
117,2022/09/21,8,8,1,0,9
118,2022/09/21,4,0,2,0,6
119,2022/09/21,9,4,1,3,10
120,2022/09/21,5,0,1,0,6
149,2022/09/21,10,0,0,0,10
184,2022/09/21,13,12,6,0,19
195,2022/09/21,59,30,33,15,92
218,2022/09/21,28,21,19,3,47
296,2022/09/21,11,0,5,0,16
300,2022/09/21,6,0,3,0,9
304,2022/09/21,15,6,1,0,16
317,2022/09/21,16,6,5,0,21
343,2022/09/21,11,8,4,0,15
373,2022/09/21,13,6,3,0,16
374,2022/09/21,9,0,1,0,10
388,2022/09/21,32,24,33,1,65
419,2022/09/21,21,12,4,0,25
420,2022/09/21,12,6,6,0,18
462,2022/09/21,14,0,9,0,23
519,2022/09/21,11,6,2,0,13
525,2022/09/21,11,5,1,0,12
596,2022/09/21,8,4,6,0,14
597,2022/09/21,13,12,10,1,23
598,2022/09/21,11,0,6,1,17
1035,2022/09/21,21,6,4,4,25
1084,2022/09/21,7,5,1,0,8
1111,2022/09/21,10,0,1,0,11
1112,2022/09/21,11,0,0,0,11
1113,2022/09/21,9,0,0,0,9
1114,2022/09/21,14,6,3,0,17
1115,2022/09/21,7,0,0,0,7
1117,2022/09/21,5,0,0,0,5
1118,2022/09/21,11,0,1,0,12
1119,2022/09/21,8,0,0,0,8
1692,2022/09/21,16,12,1,0,17
1693,2022/09/21,13,6,0,0,13
1747,2022/09/21,23,15,18,0,41
1772,2022/09/21,5,0,1,0,6
1773,2022/09/21,10,0,0,0,10
1774,2022/09/21,10,0,1,0,11
1782,2022/09/21,32,18,22,1,54
1795,2022/09/21,27,14,13,0,40
1914,2022/09/21,10,0,0,0,10
1915,2022/09/21,9,6,1,0,10
1923,2022/09/21,9,0,0,0,9
1934,2022/09/21,16,5,6,3,22
1963,2022/09/21,24,6,6,0,30
1984,2022/09/21,6,0,1,4,7
2135,2022/09/21,2,0,0,0,2
2136,2022/09/21,4,0,0,0,4
2148,2022/09/21,14,0,2,0,16
2183,2022/09/21,25,6,2,11,27
2193,2022/09/21,12,12,8,0,20
2237,2022/09/21,9,0,0,0,9
2358,2022/09/21,14,8,4,0,18
2361,2022/09/21,10,7,0,3,10
2445,2022/09/21,9,0,1,1,10
2449,2022/09/21,11,6,6,0,17
2451,2022/09/21,11,0,6,0,17
2475,2022/09/21,9,0,0,0,9
2476,2022/09/21,9,0,0,0,9
2507,2022/09/21,23,0,4,0,27
2525,2022/09/21,9,0,1,0,10
2562,2022/09/21,16,6,6,0,22
2582,2022/09/21,7,4,2,0,9
2586,2022/09/21,40,20,23,1,63
2602,2022/09/21,3,0,2,0,5
2631,2022/09/21,10,0,2,0,12
2685,2022/09/21,9,4,2,1,11
2723,2022/09/21,9,0,0,0,9
2730,2022/09/21,6,0,1,0,7
2731,2022/09/21,10,0,1,0,11
2732,2022/09/21,11,8,0,0,11
2734,2022/09/21,8,4,4,0,12
2735,2022/09/21,14,8,2,0,16
2761,2022/09/21,31,15,17,0,48
2788,2022/09/21,20,16,13,0,33
2802,2022/09/21,7,0,0,0,7
2812,2022/09/21,3,0,0,0,3
2813,2022/09/21,6,0,0,0,6
2814,2022/09/21,10,6,1,0,11
2913,2022/09/21,8,0,0,3,8
2914,2022/09/21,6,0,0,0,6
3015,2022/09/21,5,0,0,0,5
3033,2022/09/21,9,0,0,0,9
3035,2022/09/21,9,0,0,0,9
4446,2022/09/21,13,9,8,1,21
12136,2022/09/21,23,24,22,0,45
12516,2022/09/21,13,4,2,0,15
12518,2022/09/21,20,10,0,0,20
12523,2022/09/21,9,4,2,0,11
16062,2022/09/21,9,0,0,0,9
16063,2022/09/21,6,0,1,0,7
16276,2022/09/21,6,6,5,0,11
19322,2022/09/21,6,0,1,0,7
19521,2022/09/21,8,0,1,0,9
20901,2022/09/21,11,0,1,0,12
20920,2022/09/21,8,0,0,0,8
75,2022/09/22,43,32,39,0,82
76,2022/09/22,41,40,35,0,76
99,2022/09/22,11,0,1,0,12
117,2022/09/22,7,0,2,0,9
118,2022/09/22,2,0,1,0,3
119,2022/09/22,5,0,2,0,7
120,2022/09/22,8,4,1,1,9
149,2022/09/22,10,0,1,0,11
184,2022/09/22,22,15,20,0,42
195,2022/09/22,41,30,41,0,82
218,2022/09/22,30,24,28,0,58
296,2022/09/22,12,6,3,0,15
300,2022/09/22,11,8,0,1,11
304,2022/09/22,14,0,1,0,15
317,2022/09/22,17,6,7,0,24
343,2022/09/22,7,0,7,0,14
373,2022/09/22,16,6,6,0,22
374,2022/09/22,8,0,1,0,9
388,2022/09/22,25,27,24,0,49
419,2022/09/22,23,6,11,0,34
420,2022/09/22,6,0,1,0,7
462,2022/09/22,13,8,2,0,15
519,2022/09/22,15,6,6,0,21
525,2022/09/22,10,0,0,0,10
596,2022/09/22,6,4,6,0,12
597,2022/09/22,14,12,12,0,26
598,2022/09/22,4,0,0,0,4
1035,2022/09/22,19,6,7,0,26
1084,2022/09/22,16,10,16,0,32
1111,2022/09/22,9,0,0,0,9
1112,2022/09/22,11,0,0,0,11
1113,2022/09/22,9,0,2,0,11
1114,2022/09/22,17,6,1,0,18
1115,2022/09/22,7,0,2,0,9
1117,2022/09/22,5,0,1,0,6
1118,2022/09/22,10,0,0,0,10
1119,2022/09/22,8,0,0,0,8
1692,2022/09/22,15,0,9,0,24
1693,2022/09/22,19,6,2,0,21
1747,2022/09/22,20,15,19,0,39
1772,2022/09/22,4,0,1,0,5
1773,2022/09/22,10,0,0,0,10
1774,2022/09/22,9,0,3,0,12
1782,2022/09/22,18,9,16,0,34
1795,2022/09/22,35,21,18,0,53
1914,2022/09/22,10,0,0,0,10
1915,2022/09/22,8,0,0,0,8
1923,2022/09/22,9,0,3,0,12
1934,2022/09/22,7,0,0,5,7
1963,2022/09/22,24,6,10,0,34
1984,2022/09/22,1,0,0,0,1
2135,2022/09/22,2,0,0,0,2
2136,2022/09/22,4,0,0,0,4
2148,2022/09/22,12,0,5,0,17
2183,2022/09/22,12,0,5,1,17
2193,2022/09/22,16,12,12,1,28
2237,2022/09/22,9,0,0,0,9
2358,2022/09/22,18,8,9,0,27
2361,2022/09/22,14,7,4,0,18
2445,2022/09/22,13,6,9,1,22
2449,2022/09/22,17,12,5,0,22
2451,2022/09/22,20,15,14,0,34
2475,2022/09/22,9,0,0,0,9
2476,2022/09/22,9,0,0,0,9
2507,2022/09/22,31,12,10,0,41
2525,2022/09/22,8,0,2,0,10
2562,2022/09/22,10,0,8,0,18
2582,2022/09/22,9,4,2,0,11
2586,2022/09/22,16,0,11,0,27
2602,2022/09/22,9,8,0,0,9
2631,2022/09/22,8,0,5,1,13
2685,2022/09/22,14,8,6,2,20
2723,2022/09/22,9,0,0,0,9
2730,2022/09/22,11,6,13,0,24
2731,2022/09/22,9,0,0,0,9
2732,2022/09/22,11,0,0,0,11
2734,2022/09/22,8,4,1,0,9
2735,2022/09/22,12,0,2,0,14
2761,2022/09/22,29,15,11,1,40
2788,2022/09/22,23,16,25,0,48
2802,2022/09/22,7,0,1,0,8
2812,2022/09/22,9,6,0,0,9
2813,2022/09/22,6,0,1,0,7
2814,2022/09/22,9,0,0,0,9
2913,2022/09/22,5,0,2,0,7
2914,2022/09/22,6,0,1,0,7
3015,2022/09/22,13,8,0,0,13
3035,2022/09/22,9,0,0,0,9
4446,2022/09/22,13,9,12,0,25
12136,2022/09/22,19,18,18,0,37
12516,2022/09/22,11,0,0,0,11
12518,2022/09/22,20,0,0,0,20
12523,2022/09/22,11,4,6,0,17
16062,2022/09/22,9,0,0,0,9
16063,2022/09/22,5,0,1,0,6
16276,2022/09/22,1,0,1,0,2
19322,2022/09/22,5,0,0,0,5
19521,2022/09/22,7,0,0,0,7
20901,2022/09/22,10,0,0,0,10
20920,2022/09/22,8,0,1,0,9
75,2022/09/23,46,32,34,0,80
76,2022/09/23,42,36,37,0,79
99,2022/09/23,10,0,1,0,11
117,2022/09/23,5,0,1,0,6
118,2022/09/23,8,8,1,0,9
119,2022/09/23,6,0,4,0,10
120,2022/09/23,2,0,0,0,2
149,2022/09/23,9,0,0,0,9
184,2022/09/23,11,9,10,0,21
195,2022/09/23,19,15,14,0,33
218,2022/09/23,30,24,23,0,53
296,2022/09/23,9,0,1,4,10
300,2022/09/23,10,0,4,0,14
304,2022/09/23,19,6,4,0,23
317,2022/09/23,16,6,3,0,19
343,2022/09/23,8,8,2,0,10
373,2022/09/23,16,6,4,0,20
374,2022/09/23,11,4,4,0,15
388,2022/09/23,21,18,17,0,38
419,2022/09/23,12,0,8,0,20
420,2022/09/23,17,12,1,0,18
462,2022/09/23,11,0,3,3,14
519,2022/09/23,21,12,16,0,37
525,2022/09/23,15,5,4,0,19
596,2022/09/23,6,4,3,0,9
597,2022/09/23,25,24,21,0,46
598,2022/09/23,4,0,2,0,6
1035,2022/09/23,12,0,10,0,22
1084,2022/09/23,17,15,14,0,31
1111,2022/09/23,9,0,2,0,11
1112,2022/09/23,11,0,0,0,11
1113,2022/09/23,7,0,4,0,11
1114,2022/09/23,16,0,5,0,21
1115,2022/09/23,5,0,1,0,6
1117,2022/09/23,4,0,1,0,5
1118,2022/09/23,10,0,0,0,10
1119,2022/09/23,8,0,4,0,12
1692,2022/09/23,12,6,1,0,13
1693,2022/09/23,17,0,3,0,20
1747,2022/09/23,25,20,20,0,45
1772,2022/09/23,3,0,0,0,3
1773,2022/09/23,10,0,1,0,11
1774,2022/09/23,6,0,0,0,6
1782,2022/09/23,20,15,15,0,35
1795,2022/09/23,31,14,10,0,41
1914,2022/09/23,10,0,1,0,11
1915,2022/09/23,8,0,2,0,10
1923,2022/09/23,6,0,1,0,7
1934,2022/09/23,3,0,3,0,6
1963,2022/09/23,20,6,12,0,32
1984,2022/09/23,1,0,0,0,1
2135,2022/09/23,2,0,0,0,2
2136,2022/09/23,4,0,0,0,4
2148,2022/09/23,11,4,2,0,13
2183,2022/09/23,6,0,5,0,11
2193,2022/09/23,21,15,16,0,37
2237,2022/09/23,9,0,3,0,12
2358,2022/09/23,17,8,4,0,21
2361,2022/09/23,16,7,7,0,23
2445,2022/09/23,9,6,5,0,14
2449,2022/09/23,24,12,3,0,27
2451,2022/09/23,14,10,6,0,20
2475,2022/09/23,9,0,0,0,9
2476,2022/09/23,9,0,1,0,10
2507,2022/09/23,33,12,18,0,51
2525,2022/09/23,6,0,0,0,6
2562,2022/09/23,8,6,2,0,10
2582,2022/09/23,11,4,5,0,16
2586,2022/09/23,12,8,8,0,20
2602,2022/09/23,17,8,0,0,17
2631,2022/09/23,8,6,4,0,12
2685,2022/09/23,14,8,11,0,25
2730,2022/09/23,-2,0,0,0,-2
2731,2022/09/23,9,0,2,0,11
2732,2022/09/23,11,0,0,0,11
2734,2022/09/23,11,4,1,0,12
2735,2022/09/23,10,0,1,0,11
2761,2022/09/23,34,15,30,0,64
2788,2022/09/23,11,12,11,0,22
2802,2022/09/23,6,0,0,0,6
2812,2022/09/23,9,0,0,0,9
2813,2022/09/23,5,0,1,0,6
2814,2022/09/23,9,0,2,0,11
2913,2022/09/23,3,0,1,2,4
2914,2022/09/23,5,0,0,0,5
3015,2022/09/23,13,0,3,0,16
3033,2022/09/23,9,0,0,0,9
3035,2022/09/23,9,0,0,0,9
4446,2022/09/23,14,9,9,0,23
12136,2022/09/23,38,18,21,0,59
12516,2022/09/23,11,0,1,0,12
12518,2022/09/23,20,0,2,0,22
12523,2022/09/23,9,4,2,0,11
16062,2022/09/23,9,0,0,0,9
16063,2022/09/23,4,0,1,0,5
16276,2022/09/23,6,6,1,0,7
19322,2022/09/23,5,0,0,0,5
19521,2022/09/23,7,0,0,0,7
20901,2022/09/23,10,0,2,0,12
20920,2022/09/23,7,0,0,0,7
75,2022/09/24,40,28,28,0,68
76,2022/09/24,25,20,23,0,48
99,2022/09/24,9,0,0,0,9
117,2022/09/24,4,0,4,0,8
118,2022/09/24,7,0,2,0,9
119,2022/09/24,2,0,0,0,2
120,2022/09/24,2,0,3,0,5
149,2022/09/24,9,0,1,0,10
184,2022/09/24,7,6,6,0,13
195,2022/09/24,17,12,11,0,28
218,2022/09/24,19,12,11,0,30
296,2022/09/24,4,0,6,0,10
300,2022/09/24,14,8,1,0,15
304,2022/09/24,15,0,2,1,17
317,2022/09/24,25,12,4,1,29
343,2022/09/24,6,0,3,0,9
373,2022/09/24,18,6,1,0,19
374,2022/09/24,11,4,2,0,13
388,2022/09/24,19,15,17,0,36
419,2022/09/24,16,12,2,0,18
420,2022/09/24,16,0,1,0,17
462,2022/09/24,13,8,1,0,14
519,2022/09/24,11,6,9,0,20
525,2022/09/24,11,0,1,0,12
596,2022/09/24,3,0,1,0,4
597,2022/09/24,4,0,3,0,7
598,2022/09/24,2,0,0,0,2
1035,2022/09/24,8,6,6,0,14
1084,2022/09/24,3,0,1,0,4
1111,2022/09/24,7,0,4,0,11
1112,2022/09/24,11,0,1,0,12
1113,2022/09/24,3,0,0,0,3
1114,2022/09/24,11,0,3,0,14
1115,2022/09/24,4,0,1,0,5
1117,2022/09/24,3,0,1,0,4
1118,2022/09/24,10,0,5,0,15
1119,2022/09/24,4,0,0,0,4
1692,2022/09/24,17,6,1,0,18
1693,2022/09/24,20,6,2,0,22
1747,2022/09/24,25,20,21,0,46
1772,2022/09/24,3,0,1,0,4
1773,2022/09/24,9,0,2,0,11
1774,2022/09/24,6,0,0,0,6
1782,2022/09/24,20,15,12,0,32
1795,2022/09/24,42,21,22,2,64
1914,2022/09/24,9,0,1,0,10
1915,2022/09/24,6,0,3,0,9
1923,2022/09/24,5,0,3,0,8
1934,2022/09/24,0,0,0,0,0
1963,2022/09/24,14,6,7,0,21
1984,2022/09/24,7,6,4,0,11
2135,2022/09/24,8,6,4,0,12
2136,2022/09/24,4,0,1,0,5
2148,2022/09/24,9,0,2,0,11
2183,2022/09/24,1,0,0,0,1
2193,2022/09/24,14,9,11,0,25
2237,2022/09/24,6,0,3,0,9
2358,2022/09/24,13,0,0,0,13
2361,2022/09/24,16,7,10,0,26
2445,2022/09/24,10,6,7,0,17
2449,2022/09/24,21,0,2,0,23
2451,2022/09/24,8,0,4,0,12
2475,2022/09/24,9,0,1,0,10
2476,2022/09/24,8,0,0,0,8
2507,2022/09/24,21,6,12,1,33
2525,2022/09/24,6,0,2,0,8
2562,2022/09/24,18,12,4,0,22
2582,2022/09/24,6,0,2,0,8
2586,2022/09/24,12,8,8,0,20
2602,2022/09/24,17,0,5,0,22
2631,2022/09/24,4,0,3,0,7
2685,2022/09/24,3,0,4,0,7
2730,2022/09/24,-2,0,0,0,-2
2731,2022/09/24,7,0,1,0,8
2732,2022/09/24,11,0,0,0,11
2734,2022/09/24,10,0,1,0,11
2735,2022/09/24,17,8,5,0,22
2761,2022/09/24,4,0,1,0,5
2788,2022/09/24,8,8,7,0,15
2802,2022/09/24,6,0,0,0,6
2812,2022/09/24,9,0,1,0,10
2813,2022/09/24,4,0,0,0,4
2814,2022/09/24,7,0,2,0,9
2913,2022/09/24,0,0,0,0,0
2914,2022/09/24,5,0,0,0,5
3015,2022/09/24,10,0,0,0,10
3033,2022/09/24,9,0,0,0,9
3035,2022/09/24,9,0,0,0,9
4446,2022/09/24,14,9,9,0,23
12136,2022/09/24,32,15,13,0,45
12516,2022/09/24,10,0,2,0,12
12518,2022/09/24,18,0,0,0,18
12523,2022/09/24,7,0,4,0,11
16062,2022/09/24,9,0,2,0,11
16063,2022/09/24,3,0,2,0,5
16276,2022/09/24,5,0,0,0,5
19322,2022/09/24,5,0,1,0,6
19521,2022/09/24,7,0,1,0,8
20901,2022/09/24,8,0,0,0,8
20920,2022/09/24,7,0,0,0,7
75,2022/09/25,28,16,15,0,43
76,2022/09/25,26,24,21,0,47
99,2022/09/25,9,0,0,0,9
117,2022/09/25,0,0,0,0,0
118,2022/09/25,13,8,5,0,18
119,2022/09/25,6,4,1,0,7
120,2022/09/25,3,4,3,0,6
149,2022/09/25,8,0,0,0,8
184,2022/09/25,7,6,4,0,11
195,2022/09/25,27,21,17,0,44
218,2022/09/25,23,15,15,0,38
296,2022/09/25,4,6,6,0,10
300,2022/09/25,13,0,3,0,16
304,2022/09/25,12,0,7,0,19
317,2022/09/25,26,6,4,1,30
343,2022/09/25,3,0,3,0,6
373,2022/09/25,17,0,1,0,18
374,2022/09/25,17,8,3,0,20
388,2022/09/25,23,21,19,0,42
419,2022/09/25,26,12,6,0,32
420,2022/09/25,21,6,5,0,26
462,2022/09/25,28,16,7,0,35
519,2022/09/25,2,0,3,0,5
525,2022/09/25,10,0,3,0,13
596,2022/09/25,10,8,7,0,17
597,2022/09/25,13,12,5,0,18
598,2022/09/25,8,6,3,0,11
1035,2022/09/25,8,6,6,0,14
1084,2022/09/25,12,10,9,0,21
1111,2022/09/25,3,0,0,0,3
1112,2022/09/25,10,0,0,0,10
1113,2022/09/25,3,0,1,0,4
1114,2022/09/25,8,0,0,0,8
1115,2022/09/25,9,6,3,0,12
1117,2022/09/25,2,0,0,0,2
1118,2022/09/25,11,6,2,0,13
1119,2022/09/25,4,0,0,0,4
1692,2022/09/25,16,0,2,1,18
1693,2022/09/25,18,0,2,0,20
1747,2022/09/25,19,15,15,0,34
1772,2022/09/25,10,8,2,0,12
1773,2022/09/25,7,0,4,0,11
1774,2022/09/25,14,8,3,0,17
1782,2022/09/25,26,18,13,0,39
1795,2022/09/25,18,0,11,0,29
1914,2022/09/25,8,0,1,0,9
1915,2022/09/25,3,0,2,0,5
1923,2022/09/25,8,6,1,0,9
1934,2022/09/25,5,5,1,0,6
1963,2022/09/25,19,12,2,0,21
1984,2022/09/25,3,0,2,0,5
2135,2022/09/25,4,0,4,0,8
2136,2022/09/25,9,6,3,0,12
2148,2022/09/25,7,0,3,0,10
2183,2022/09/25,7,6,5,0,12
2193,2022/09/25,12,9,7,0,19
2237,2022/09/25,9,6,3,0,12
2358,2022/09/25,21,8,2,0,23
2361,2022/09/25,13,7,6,0,19
2445,2022/09/25,3,0,2,0,5
2449,2022/09/25,25,6,5,0,30
2451,2022/09/25,39,35,2,0,41
2475,2022/09/25,8,0,0,0,8
2476,2022/09/25,8,0,2,0,10
2507,2022/09/25,8,0,5,0,13
2525,2022/09/25,10,6,3,0,13
2562,2022/09/25,14,0,3,0,17
2582,2022/09/25,4,0,3,0,7
2586,2022/09/25,16,12,11,0,27
2602,2022/09/25,12,0,0,0,12
2631,2022/09/25,1,0,0,0,1
2685,2022/09/25,3,4,3,0,6
2730,2022/09/25,4,6,0,0,4
2731,2022/09/25,6,0,3,0,9
2732,2022/09/25,11,0,1,0,12
2734,2022/09/25,13,4,4,0,17
2735,2022/09/25,12,0,2,0,14
2761,2022/09/25,13,10,9,0,22
2788,2022/09/25,13,12,7,0,20
2802,2022/09/25,6,0,1,0,7
2812,2022/09/25,8,0,1,0,9
2813,2022/09/25,10,6,2,0,12
2814,2022/09/25,5,0,2,0,7
2913,2022/09/25,6,6,0,0,6
2914,2022/09/25,5,0,2,0,7
3015,2022/09/25,10,0,3,0,13
3033,2022/09/25,9,0,0,0,9
3035,2022/09/25,9,0,2,0,11
4446,2022/09/25,11,6,6,0,17
12136,2022/09/25,31,12,11,0,42
12516,2022/09/25,8,0,0,0,8
12518,2022/09/25,18,0,5,0,23
12523,2022/09/25,7,4,5,0,12
16062,2022/09/25,7,0,2,0,9
16063,2022/09/25,7,6,1,0,8
16276,2022/09/25,11,6,0,0,11
19322,2022/09/25,4,0,2,0,6
19521,2022/09/25,6,0,0,0,6
20901,2022/09/25,8,0,1,0,9
20920,2022/09/25,7,0,1,0,8
75,2022/09/26,49,36,32,0,81
76,2022/09/26,41,36,29,0,70
99,2022/09/26,9,0,0,0,9
117,2022/09/26,8,8,1,0,9
118,2022/09/26,8,0,4,0,12
119,2022/09/26,5,0,0,0,5
120,2022/09/26,4,4,1,0,5
149,2022/09/26,8,0,0,0,8
184,2022/09/26,12,9,7,0,19
195,2022/09/26,49,39,28,4,77
218,2022/09/26,32,24,25,0,57
296,2022/09/26,-2,0,0,0,-2
300,2022/09/26,18,8,6,0,24
304,2022/09/26,5,0,4,0,9
317,2022/09/26,27,6,13,0,40
343,2022/09/26,8,8,0,0,8
373,2022/09/26,22,6,15,0,37
374,2022/09/26,14,0,5,0,19
388,2022/09/26,31,27,25,0,56
419,2022/09/26,26,6,16,0,42
420,2022/09/26,22,6,8,0,30
462,2022/09/26,21,0,15,0,36
519,2022/09/26,5,6,5,0,10
525,2022/09/26,7,0,0,3,7
596,2022/09/26,7,4,2,0,9
597,2022/09/26,20,12,18,0,38
598,2022/09/26,5,0,0,0,5
1035,2022/09/26,8,6,4,1,12
1084,2022/09/26,13,10,7,0,20
1111,2022/09/26,3,0,0,0,3
1112,2022/09/26,10,0,0,0,10
1113,2022/09/26,8,6,0,0,8
1114,2022/09/26,14,6,1,0,15
1115,2022/09/26,6,0,2,0,8
1117,2022/09/26,2,0,0,0,2
1118,2022/09/26,9,0,0,0,9
1119,2022/09/26,10,6,0,0,10
1692,2022/09/26,19,6,6,0,25
1693,2022/09/26,16,0,3,0,19
1747,2022/09/26,24,20,19,0,43
1772,2022/09/26,8,0,1,0,9
1773,2022/09/26,3,0,0,0,3
1774,2022/09/26,11,0,0,0,11
1782,2022/09/26,28,15,21,0,49
1795,2022/09/26,21,14,12,1,33
1914,2022/09/26,7,0,1,0,8
1915,2022/09/26,7,6,0,0,7
1923,2022/09/26,7,0,1,0,8
1934,2022/09/26,9,5,7,0,16
1963,2022/09/26,29,12,16,0,45
1984,2022/09/26,7,6,4,0,11
2135,2022/09/26,0,0,0,0,0
2136,2022/09/26,6,0,0,0,6
2148,2022/09/26,4,0,3,0,7
2183,2022/09/26,8,6,0,0,8
2193,2022/09/26,20,15,15,0,35
2237,2022/09/26,6,0,2,0,8
2358,2022/09/26,19,0,4,0,23
2361,2022/09/26,7,0,4,0,11
2445,2022/09/26,7,6,5,0,12
2449,2022/09/26,26,6,7,0,33
2451,2022/09/26,37,0,11,0,48
2475,2022/09/26,8,0,0,0,8
2476,2022/09/26,6,0,0,0,6
2507,2022/09/26,15,12,11,0,26
2525,2022/09/26,7,0,0,0,7
2562,2022/09/26,17,6,9,0,26
2582,2022/09/26,1,0,1,0,2
2586,2022/09/26,21,16,17,0,38
2602,2022/09/26,12,0,1,0,13
2631,2022/09/26,7,6,2,0,9
2685,2022/09/26,4,4,6,0,10
2723,2022/09/26,9,0,1,0,10
2730,2022/09/26,10,6,1,0,11
2731,2022/09/26,3,0,0,0,3
2732,2022/09/26,10,0,2,0,12
2734,2022/09/26,9,0,7,0,16
2735,2022/09/26,10,0,3,0,13
2761,2022/09/26,19,15,9,0,28
2788,2022/09/26,22,16,14,2,36
2802,2022/09/26,5,0,1,0,6
2812,2022/09/26,7,0,0,0,7
2813,2022/09/26,8,0,0,0,8
2814,2022/09/26,3,0,0,0,3
2913,2022/09/26,6,0,3,0,9
2914,2022/09/26,3,0,0,0,3
3015,2022/09/26,7,0,0,0,7
3033,2022/09/26,9,0,0,0,9
3035,2022/09/26,7,0,0,0,7
4446,2022/09/26,17,12,12,0,29
12136,2022/09/26,38,18,15,0,53
12516,2022/09/26,8,0,0,0,8
12518,2022/09/26,13,0,7,0,20
12523,2022/09/26,2,0,1,0,3
16062,2022/09/26,5,0,0,0,5
16063,2022/09/26,6,0,0,0,6
16276,2022/09/26,11,0,0,0,11
19322,2022/09/26,2,0,0,0,2
19521,2022/09/26,6,0,1,0,7
20901,2022/09/26,7,0,0,0,7
20920,2022/09/26,6,0,2,0,8
75,2022/09/27,53,36,37,2,90
76,2022/09/27,52,40,42,0,94
99,2022/09/27,9,0,0,0,9
117,2022/09/27,7,0,3,0,10
118,2022/09/27,4,0,2,0,6
119,2022/09/27,9,4,2,0,11
120,2022/09/27,3,0,2,0,5
149,2022/09/27,8,0,1,0,9
184,2022/09/27,17,12,11,0,28
195,2022/09/27,41,24,30,5,71
218,2022/09/27,31,24,28,0,59
296,2022/09/27,-2,0,0,0,-2
300,2022/09/27,12,0,2,0,14
304,2022/09/27,7,6,6,0,13
317,2022/09/27,26,12,3,0,29
343,2022/09/27,8,0,2,0,10
373,2022/09/27,13,6,9,0,22
374,2022/09/27,9,0,6,0,15
388,2022/09/27,30,24,27,2,57
419,2022/09/27,22,12,5,0,27
420,2022/09/27,20,6,1,0,21
462,2022/09/27,6,0,3,0,9
519,2022/09/27,6,6,2,0,8
525,2022/09/27,4,0,0,0,4
596,2022/09/27,13,8,6,0,19
597,2022/09/27,20,18,6,0,26
598,2022/09/27,11,6,2,0,13
1035,2022/09/27,9,6,3,0,12
1084,2022/09/27,16,10,14,0,30
1111,2022/09/27,9,6,0,0,9
1112,2022/09/27,10,0,2,0,12
1113,2022/09/27,8,0,0,0,8
1114,2022/09/27,13,0,1,0,14
1115,2022/09/27,4,0,0,0,4
1117,2022/09/27,2,0,1,0,3
1118,2022/09/27,9,0,1,0,10
1119,2022/09/27,10,0,0,0,10
1692,2022/09/27,13,0,2,0,15
1693,2022/09/27,19,6,2,0,21
1747,2022/09/27,20,15,12,0,32
1772,2022/09/27,7,0,1,0,8
1773,2022/09/27,3,0,1,0,4
1774,2022/09/27,11,0,2,0,13
1782,2022/09/27,28,21,18,0,46
1795,2022/09/27,22,14,3,0,25
1914,2022/09/27,6,0,0,0,6
1915,2022/09/27,7,0,1,0,8
1923,2022/09/27,6,0,1,0,7
1934,2022/09/27,7,5,2,0,9
1963,2022/09/27,25,12,7,0,32
1984,2022/09/27,3,0,0,0,3
2135,2022/09/27,6,6,0,0,6
2136,2022/09/27,6,0,1,0,7
2148,2022/09/27,5,4,2,0,7
2183,2022/09/27,8,0,1,0,9
2193,2022/09/27,20,15,16,0,36
2237,2022/09/27,4,0,2,0,6
2358,2022/09/27,15,0,5,0,20
2361,2022/09/27,10,7,0,2,10
2445,2022/09/27,8,6,7,0,15
2449,2022/09/27,25,6,1,1,26
2451,2022/09/27,26,0,10,0,36
2475,2022/09/27,8,0,1,0,9
2476,2022/09/27,6,0,2,0,8
2507,2022/09/27,16,12,4,0,20
2525,2022/09/27,7,0,0,0,7
2562,2022/09/27,14,6,4,0,18
2582,2022/09/27,4,4,0,0,4
2586,2022/09/27,20,16,17,0,37
2602,2022/09/27,11,0,0,0,11
2631,2022/09/27,11,6,3,0,14
2685,2022/09/27,6,8,5,0,11
2723,2022/09/27,8,0,1,0,9
2730,2022/09/27,9,0,2,0,11
2731,2022/09/27,3,0,0,0,3
2732,2022/09/27,8,0,3,0,11
2734,2022/09/27,6,4,3,0,9
2735,2022/09/27,7,0,1,0,8
2761,2022/09/27,30,20,17,0,47
2788,2022/09/27,22,16,21,0,43
2802,2022/09/27,4,0,1,0,5
2812,2022/09/27,7,0,0,0,7
2813,2022/09/27,8,0,0,0,8
2913,2022/09/27,3,0,0,0,3
2914,2022/09/27,3,0,0,0,3
3015,2022/09/27,7,0,0,0,7
3033,2022/09/27,9,0,0,0,9
3035,2022/09/27,7,0,1,0,8
4446,2022/09/27,17,12,8,0,25
12136,2022/09/27,44,21,22,0,66
12516,2022/09/27,8,0,0,0,8
12518,2022/09/27,6,0,2,0,8
12523,2022/09/27,5,4,4,0,9
16062,2022/09/27,5,0,0,0,5
16063,2022/09/27,6,0,1,0,7
16276,2022/09/27,11,0,2,0,13
19521,2022/09/27,5,0,0,0,5
20901,2022/09/27,7,0,0,0,7
20920,2022/09/27,4,0,0,0,4
75,2022/09/28,34,36,39,0,73
76,2022/09/28,43,44,43,0,86
99,2022/09/28,9,0,0,0,9
117,2022/09/28,4,0,3,0,7
118,2022/09/28,2,0,2,0,4
119,2022/09/28,7,0,0,0,7
120,2022/09/28,5,4,1,0,6
149,2022/09/28,7,0,1,0,8
184,2022/09/28,10,6,7,0,17
195,2022/09/28,30,30,36,0,66
218,2022/09/28,14,18,24,0,38
296,2022/09/28,4,6,3,0,7
300,2022/09/28,10,0,3,0,13
304,2022/09/28,1,0,0,0,1
317,2022/09/28,29,6,4,0,33
343,2022/09/28,14,8,5,0,19
373,2022/09/28,10,6,4,0,14
374,2022/09/28,7,4,1,0,8
388,2022/09/28,21,24,24,0,45
419,2022/09/28,23,6,9,0,32
420,2022/09/28,19,0,5,0,24
462,2022/09/28,3,0,5,0,8
519,2022/09/28,11,6,7,0,18
525,2022/09/28,4,0,1,3,5
596,2022/09/28,12,8,6,0,18
597,2022/09/28,25,12,14,0,39
598,2022/09/28,9,0,1,0,10
1035,2022/09/28,4,0,1,0,5
1084,2022/09/28,9,10,7,0,16
1111,2022/09/28,9,0,0,0,9
1112,2022/09/28,8,0,0,0,8
1113,2022/09/28,8,0,0,0,8
1114,2022/09/28,12,0,0,0,12
1115,2022/09/28,10,6,1,0,11
1117,2022/09/28,1,0,0,0,1
1118,2022/09/28,8,0,0,0,8
1119,2022/09/28,10,0,0,0,10
1692,2022/09/28,11,0,4,0,15
1693,2022/09/28,23,6,4,0,27
1747,2022/09/28,23,20,23,0,46
1772,2022/09/28,6,0,2,0,8
1773,2022/09/28,8,6,0,0,8
1774,2022/09/28,9,0,0,0,9
1782,2022/09/28,17,15,18,0,35
1795,2022/09/28,32,14,15,0,47
1914,2022/09/28,6,0,1,0,7
1915,2022/09/28,12,6,2,0,14
1923,2022/09/28,5,0,4,0,9
1934,2022/09/28,10,5,3,0,13
1963,2022/09/28,24,6,5,0,29
1984,2022/09/28,2,0,2,0,4
2135,2022/09/28,12,6,3,0,15
2136,2022/09/28,11,6,1,0,12
2148,2022/09/28,3,0,3,0,6
2183,2022/09/28,6,0,1,0,7
2193,2022/09/28,13,12,13,0,26
2237,2022/09/28,8,6,3,0,11
2358,2022/09/28,18,8,1,0,19
2361,2022/09/28,15,7,6,0,21
2445,2022/09/28,0,0,0,0,0
2449,2022/09/28,23,0,3,1,26
2451,2022/09/28,12,0,13,0,25
2475,2022/09/28,7,0,0,0,7
2476,2022/09/28,4,0,0,0,4
2507,2022/09/28,24,12,10,0,34
2525,2022/09/28,13,6,0,0,13
2562,2022/09/28,16,6,5,0,21
2582,2022/09/28,8,4,5,0,13
2586,2022/09/28,15,16,15,0,30
2602,2022/09/28,11,0,3,0,14
2631,2022/09/28,7,0,3,0,10
2685,2022/09/28,5,4,6,0,11
2723,2022/09/28,7,0,0,0,7
2730,2022/09/28,7,0,1,0,8
2731,2022/09/28,9,6,1,0,10
2732,2022/09/28,5,0,0,0,5
2734,2022/09/28,3,0,2,0,5
2735,2022/09/28,14,8,5,0,19
2761,2022/09/28,24,15,13,0,37
2788,2022/09/28,12,12,14,0,26
2802,2022/09/28,3,0,0,0,3
2812,2022/09/28,7,0,0,0,7
2813,2022/09/28,8,0,0,0,8
2913,2022/09/28,9,6,0,0,9
2914,2022/09/28,9,6,0,0,9
3015,2022/09/28,7,0,0,0,7
3033,2022/09/28,9,0,0,0,9
3035,2022/09/28,6,0,0,0,6
4446,2022/09/28,13,9,10,0,23
12136,2022/09/28,17,18,20,0,37
12516,2022/09/28,12,4,0,0,12
12518,2022/09/28,4,0,2,0,6
12523,2022/09/28,5,4,1,0,6
16062,2022/09/28,11,6,0,0,11
16063,2022/09/28,5,0,2,0,7
16276,2022/09/28,9,0,1,0,10
19521,2022/09/28,5,0,1,0,6
20901,2022/09/28,7,0,1,0,8
20920,2022/09/28,4,0,1,0,5
75,2022/09/29,23,28,28,0,51
76,2022/09/29,40,40,49,0,89
99,2022/09/29,9,0,0,0,9
117,2022/09/29,9,8,0,0,9
118,2022/09/29,8,8,3,0,11
119,2022/09/29,7,0,1,0,8
120,2022/09/29,4,0,2,0,6
149,2022/09/29,6,0,0,0,6
184,2022/09/29,15,12,12,0,27
195,2022/09/29,24,30,27,0,51
218,2022/09/29,17,27,20,0,37
296,2022/09/29,7,6,2,0,9
300,2022/09/29,7,0,3,0,10
304,2022/09/29,7,6,2,0,9
317,2022/09/29,31,6,7,0,38
343,2022/09/29,9,0,2,0,11
373,2022/09/29,6,0,1,0,7
374,2022/09/29,6,0,1,0,7
388,2022/09/29,21,24,22,0,43
419,2022/09/29,14,0,7,0,21
420,2022/09/29,14,0,2,0,16
462,2022/09/29,6,8,5,0,11
519,2022/09/29,10,6,4,0,14
525,2022/09/29,5,5,0,0,5
596,2022/09/29,14,8,3,0,17
597,2022/09/29,23,12,14,0,37
598,2022/09/29,14,6,1,0,15
1035,2022/09/29,9,6,6,0,15
1084,2022/09/29,12,10,12,0,24
1111,2022/09/29,9,0,0,0,9
1112,2022/09/29,8,0,1,0,9
1113,2022/09/29,8,0,0,0,8
1114,2022/09/29,12,0,1,0,13
1115,2022/09/29,9,0,1,0,10
1117,2022/09/29,1,0,0,0,1
1118,2022/09/29,8,0,1,0,9
1119,2022/09/29,10,0,0,0,10
1692,2022/09/29,13,6,1,0,14
1693,2022/09/29,19,0,2,1,21
1747,2022/09/29,20,20,22,0,42
1772,2022/09/29,4,0,0,0,4
1773,2022/09/29,8,0,1,0,9
1774,2022/09/29,9,0,2,0,11
1782,2022/09/29,14,15,17,0,31
1795,2022/09/29,31,14,20,0,51
1914,2022/09/29,5,0,0,0,5
1915,2022/09/29,10,0,0,0,10
1923,2022/09/29,1,0,2,0,3
1934,2022/09/29,12,5,7,0,19
1963,2022/09/29,31,12,6,0,37
1984,2022/09/29,6,6,2,0,8
2135,2022/09/29,9,0,2,0,11
2136,2022/09/29,10,0,1,0,11
2148,2022/09/29,4,4,3,0,7
2183,2022/09/29,11,6,0,0,11
2193,2022/09/29,12,12,16,0,28
2237,2022/09/29,5,0,0,0,5
2358,2022/09/29,17,0,4,0,21
2361,2022/09/29,16,7,6,0,22
2445,2022/09/29,6,6,4,0,10
2449,2022/09/29,19,0,3,13,22
2451,2022/09/29,4,5,4,0,8
2476,2022/09/29,4,0,1,0,5
2507,2022/09/29,20,6,14,0,34
2525,2022/09/29,13,0,1,0,14
2562,2022/09/29,17,6,4,0,21
2582,2022/09/29,7,4,1,0,8
2586,2022/09/29,12,12,16,0,28
2602,2022/09/29,8,0,0,0,8
2631,2022/09/29,4,0,0,0,4
2685,2022/09/29,3,4,4,0,7
2723,2022/09/29,7,0,1,0,8
2730,2022/09/29,12,6,3,0,15
2731,2022/09/29,8,0,0,0,8
2732,2022/09/29,5,0,0,0,5
2734,2022/09/29,1,0,2,0,3
2735,2022/09/29,9,0,2,0,11
2761,2022/09/29,21,10,20,0,41
2788,2022/09/29,22,24,24,0,46
2812,2022/09/29,7,0,1,0,8
2813,2022/09/29,8,0,2,0,10
2913,2022/09/29,9,0,1,0,10
2914,2022/09/29,9,0,0,0,9
3015,2022/09/29,7,0,0,0,7
3035,2022/09/29,6,0,0,0,6
4446,2022/09/29,12,9,11,1,23
12136,2022/09/29,0,3,5,0,5
12516,2022/09/29,12,0,4,0,16
12518,2022/09/29,12,10,3,0,15
12523,2022/09/29,8,4,4,0,12
16062,2022/09/29,11,0,0,0,11
16063,2022/09/29,9,6,1,0,10
16276,2022/09/29,8,0,2,0,10
19329,2022/09/29,13,6,1,0,14
19521,2022/09/29,4,0,0,0,4
20901,2022/09/29,6,0,0,0,6
20920,2022/09/29,15,12,1,0,16
75,2022/09/30,27,32,36,0,63
76,2022/09/30,23,32,32,0,55
99,2022/09/30,9,0,1,0,10
117,2022/09/30,9,0,4,0,13
118,2022/09/30,5,0,2,0,7
119,2022/09/30,10,4,1,3,11
120,2022/09/30,6,4,0,3,6
149,2022/09/30,6,0,2,0,8
184,2022/09/30,9,6,9,0,18
195,2022/09/30,18,21,24,0,42
218,2022/09/30,15,18,17,0,32
296,2022/09/30,11,6,4,0,15
300,2022/09/30,12,8,4,0,16
304,2022/09/30,11,6,8,0,19
317,2022/09/30,30,6,6,1,36
343,2022/09/30,7,0,7,0,14
373,2022/09/30,5,0,2,0,7
374,2022/09/30,9,4,4,0,13
388,2022/09/30,17,18,20,0,37
419,2022/09/30,13,6,4,0,17
420,2022/09/30,18,6,4,0,22
462,2022/09/30,9,8,3,0,12
519,2022/09/30,18,12,13,0,31
525,2022/09/30,5,0,2,0,7
596,2022/09/30,11,0,8,0,19
597,2022/09/30,33,24,26,0,59
598,2022/09/30,13,0,3,0,16
1035,2022/09/30,15,12,7,0,22
1084,2022/09/30,10,10,8,0,18
1111,2022/09/30,9,0,0,0,9
1112,2022/09/30,7,0,0,0,7
1113,2022/09/30,8,0,2,0,10
1114,2022/09/30,11,0,3,0,14
1115,2022/09/30,8,0,5,0,13
1117,2022/09/30,1,0,0,0,1
1118,2022/09/30,13,6,1,0,14
1119,2022/09/30,10,0,1,0,11
1692,2022/09/30,18,6,1,0,19
1693,2022/09/30,16,0,0,1,16
1747,2022/09/30,18,20,19,0,37
1772,2022/09/30,4,0,2,0,6
1773,2022/09/30,7,0,1,0,8
1774,2022/09/30,7,0,1,0,8
1782,2022/09/30,12,15,12,0,24
1795,2022/09/30,32,21,26,0,58
1914,2022/09/30,5,0,0,0,5
1915,2022/09/30,10,0,1,0,11
1923,2022/09/30,5,6,0,0,5
1934,2022/09/30,5,0,3,0,8
1963,2022/09/30,37,12,6,0,43
1984,2022/09/30,10,6,5,0,15
2135,2022/09/30,7,0,2,0,9
2136,2022/09/30,9,0,0,0,9
2148,2022/09/30,5,4,5,0,10
2183,2022/09/30,17,6,5,4,22
2193,2022/09/30,8,12,10,0,18
2237,2022/09/30,11,6,2,0,13
2358,2022/09/30,13,0,3,0,16
2361,2022/09/30,17,7,3,0,20
2445,2022/09/30,14,12,6,0,20
2449,2022/09/30,9,6,4,0,13
2451,2022/09/30,10,10,7,0,17
2476,2022/09/30,9,6,1,0,10
2507,2022/09/30,18,12,17,0,35
2525,2022/09/30,12,0,1,0,13
2562,2022/09/30,19,6,1,0,20
2582,2022/09/30,6,0,3,0,9
2586,2022/09/30,8,12,12,0,20
2602,2022/09/30,8,0,0,0,8
2631,2022/09/30,10,6,4,0,14
2685,2022/09/30,11,12,10,0,21
2723,2022/09/30,6,0,1,0,7
2730,2022/09/30,15,6,4,0,19
2731,2022/09/30,8,0,1,0,9
2732,2022/09/30,13,8,0,0,13
2734,2022/09/30,3,4,2,0,5
2735,2022/09/30,7,0,3,0,10
2761,2022/09/30,16,15,15,0,31
2788,2022/09/30,10,12,16,0,26
2812,2022/09/30,6,0,0,0,6
2813,2022/09/30,6,0,0,0,6
2913,2022/09/30,8,0,2,1,10
2914,2022/09/30,9,0,0,0,9
3015,2022/09/30,7,0,0,0,7
3033,2022/09/30,9,0,1,0,10
3035,2022/09/30,6,0,1,0,7
4446,2022/09/30,9,9,9,0,18
12136,2022/09/30,13,18,16,0,29
12516,2022/09/30,8,0,0,0,8
12518,2022/09/30,9,0,1,0,10
12523,2022/09/30,12,8,5,0,17
16062,2022/09/30,11,0,0,0,11
16063,2022/09/30,8,0,0,0,8
16276,2022/09/30,6,0,0,0,6
19329,2022/09/30,12,0,2,0,14
19521,2022/09/30,4,0,1,0,5
20901,2022/09/30,6,0,1,0,7
20920,2022/09/30,14,0,0,0,14
75,2022/10/01,15,24,22,0,37
76,2022/10/01,19,28,22,0,41
99,2022/10/01,8,0,0,0,8
117,2022/10/01,5,0,1,0,6
118,2022/10/01,11,8,3,0,14
119,2022/10/01,6,0,1,0,7
120,2022/10/01,3,0,0,0,3
149,2022/10/01,4,0,1,0,5
184,2022/10/01,12,12,10,0,22
195,2022/10/01,12,18,19,0,31
218,2022/10/01,13,15,13,0,26
296,2022/10/01,13,6,5,0,18
300,2022/10/01,8,0,2,0,10
304,2022/10/01,9,6,1,0,10
317,2022/10/01,23,0,6,0,29
343,2022/10/01,0,0,0,0,0
373,2022/10/01,9,6,0,0,9
374,2022/10/01,13,8,3,0,16
388,2022/10/01,15,18,17,0,32
419,2022/10/01,21,12,7,0,28
420,2022/10/01,14,0,1,0,15
462,2022/10/01,14,8,3,0,17
519,2022/10/01,11,6,7,0,18
525,2022/10/01,8,5,1,0,9
596,2022/10/01,3,0,3,0,6
597,2022/10/01,7,0,9,0,16
598,2022/10/01,10,0,1,0,11
1035,2022/10/01,14,6,6,0,20
1084,2022/10/01,2,0,2,0,4
1111,2022/10/01,9,0,2,0,11
1112,2022/10/01,7,0,0,0,7
1113,2022/10/01,6,0,1,0,7
1114,2022/10/01,8,0,0,0,8
1115,2022/10/01,3,0,0,0,3
1117,2022/10/01,1,0,0,0,1
1118,2022/10/01,12,0,0,0,12
1119,2022/10/01,9,0,0,0,9
1692,2022/10/01,17,0,7,1,24
1693,2022/10/01,15,0,1,0,16
1747,2022/10/01,19,20,18,1,37
1772,2022/10/01,2,0,2,0,4
1773,2022/10/01,6,0,1,0,7
1774,2022/10/01,6,0,0,0,6
1782,2022/10/01,15,15,16,0,31
1795,2022/10/01,34,28,25,0,59
1914,2022/10/01,5,0,1,0,6
1915,2022/10/01,9,0,3,0,12
1923,2022/10/01,5,0,2,0,7
1934,2022/10/01,2,0,1,0,3
1963,2022/10/01,43,12,6,0,49
1984,2022/10/01,5,0,3,0,8
2135,2022/10/01,5,0,0,0,5
2136,2022/10/01,9,0,0,0,9
2148,2022/10/01,4,4,0,0,4
2183,2022/10/01,14,6,1,0,15
2193,2022/10/01,10,12,8,0,18
2237,2022/10/01,9,0,4,0,13
2358,2022/10/01,18,8,2,0,20
2361,2022/10/01,14,0,10,0,24
2445,2022/10/01,14,6,4,0,18
2449,2022/10/01,11,6,4,0,15
2451,2022/10/01,13,10,7,0,20
2476,2022/10/01,8,0,1,0,9
2507,2022/10/01,13,12,12,0,25
2525,2022/10/01,11,0,2,0,13
2562,2022/10/01,18,0,5,0,23
2582,2022/10/01,3,0,4,0,7
2586,2022/10/01,8,12,9,0,17
2602,2022/10/01,8,0,0,0,8
2631,2022/10/01,12,6,5,0,17
2685,2022/10/01,5,4,4,1,9
2723,2022/10/01,5,0,1,0,6
2730,2022/10/01,11,0,1,0,12
2731,2022/10/01,7,0,3,0,10
2732,2022/10/01,13,0,0,0,13
2734,2022/10/01,1,0,0,0,1
2735,2022/10/01,4,0,2,0,6
2761,2022/10/01,11,10,11,0,22
2788,2022/10/01,2,8,4,0,6
2812,2022/10/01,6,0,0,0,6
2813,2022/10/01,6,0,0,0,6
2913,2022/10/01,5,0,2,0,7
2914,2022/10/01,9,0,1,0,10
3015,2022/10/01,7,0,0,0,7
3033,2022/10/01,8,0,3,0,11
3035,2022/10/01,5,0,3,0,8
4446,2022/10/01,9,9,9,0,18
12136,2022/10/01,12,15,13,0,25
12516,2022/10/01,8,0,0,0,8
12518,2022/10/01,8,0,1,0,9
12523,2022/10/01,7,0,3,0,10
16062,2022/10/01,11,0,4,0,15
16063,2022/10/01,8,0,3,0,11
16276,2022/10/01,12,6,0,0,12
19329,2022/10/01,10,0,0,0,10
19521,2022/10/01,3,0,0,0,3
20901,2022/10/01,5,0,0,0,5
20920,2022/10/01,14,0,0,0,14
75,2022/10/02,21,28,22,0,43
76,2022/10/02,21,24,22,1,43
99,2022/10/02,8,0,0,0,8
117,2022/10/02,4,0,4,0,8
118,2022/10/02,8,0,1,0,9
119,2022/10/02,5,0,0,1,5
120,2022/10/02,7,4,1,0,8
149,2022/10/02,3,0,1,0,4
184,2022/10/02,5,3,3,0,8
195,2022/10/02,20,27,22,0,42
218,2022/10/02,21,21,21,0,42
296,2022/10/02,8,0,2,0,10
300,2022/10/02,14,8,1,0,15
304,2022/10/02,14,6,6,0,20
317,2022/10/02,23,6,7,0,30
343,2022/10/02,8,8,4,0,12
373,2022/10/02,15,6,5,0,20
374,2022/10/02,18,8,1,0,19
388,2022/10/02,19,21,20,0,39
419,2022/10/02,20,6,3,0,23
420,2022/10/02,19,6,3,0,22
462,2022/10/02,19,8,12,0,31
519,2022/10/02,4,0,2,0,6
525,2022/10/02,7,0,1,0,8
596,2022/10/02,8,8,5,0,13
597,2022/10/02,4,6,7,0,11
598,2022/10/02,9,0,1,0,10
1035,2022/10/02,14,6,5,0,19
1084,2022/10/02,10,10,8,0,18
1111,2022/10/02,13,6,2,0,15
1112,2022/10/02,7,0,0,0,7
1113,2022/10/02,5,0,2,0,7
1114,2022/10/02,8,0,0,0,8
1115,2022/10/02,3,0,1,0,4
1117,2022/10/02,1,0,0,0,1
1118,2022/10/02,12,0,0,0,12
1119,2022/10/02,9,0,0,0,9
1692,2022/10/02,15,6,3,0,18
1693,2022/10/02,20,6,4,0,24
1747,2022/10/02,15,15,15,0,30
1772,2022/10/02,0,0,1,0,1
1773,2022/10/02,11,6,1,0,12
1774,2022/10/02,6,0,3,0,9
1782,2022/10/02,20,21,22,0,42
1795,2022/10/02,9,0,9,0,18
1914,2022/10/02,10,6,0,0,10
1915,2022/10/02,6,0,1,0,7
1923,2022/10/02,9,6,1,0,10
1934,2022/10/02,6,5,5,0,11
1963,2022/10/02,49,12,8,0,57
1984,2022/10/02,8,6,2,0,10
2135,2022/10/02,11,6,3,0,14
2136,2022/10/02,9,0,1,0,10
2148,2022/10/02,12,8,1,0,13
2183,2022/10/02,19,6,0,0,19
2193,2022/10/02,14,12,12,0,26
2237,2022/10/02,11,6,4,0,15
2358,2022/10/02,24,8,3,0,27
2361,2022/10/02,11,7,3,0,14
2445,2022/10/02,10,0,3,0,13
2449,2022/10/02,7,0,2,0,9
2451,2022/10/02,26,20,10,0,36
2475,2022/10/02,7,0,0,0,7
2476,2022/10/02,7,0,1,0,8
2507,2022/10/02,1,0,0,0,1
2525,2022/10/02,9,0,3,0,12
2562,2022/10/02,19,6,2,0,21
2582,2022/10/02,3,4,0,0,3
2586,2022/10/02,11,12,12,0,23
2602,2022/10/02,16,8,3,0,19
2631,2022/10/02,7,0,1,0,8
2685,2022/10/02,0,0,0,0,0
2723,2022/10/02,12,8,1,0,13
2730,2022/10/02,10,0,2,0,12
2731,2022/10/02,10,6,2,0,12
2732,2022/10/02,13,0,1,0,14
2734,2022/10/02,9,8,2,0,11
2735,2022/10/02,10,8,1,0,11
2761,2022/10/02,10,10,12,0,22
2788,2022/10/02,10,12,10,0,20
2812,2022/10/02,6,0,1,0,7
2813,2022/10/02,6,0,2,0,8
2913,2022/10/02,3,0,2,0,5
2914,2022/10/02,8,0,0,0,8
3015,2022/10/02,15,8,1,0,16
3033,2022/10/02,5,0,0,0,5
3035,2022/10/02,2,0,1,0,3
4446,2022/10/02,6,6,7,0,13
12136,2022/10/02,11,12,11,0,22
12516,2022/10/02,8,0,2,0,10
12518,2022/10/02,17,10,8,0,25
12523,2022/10/02,12,8,4,0,16
16062,2022/10/02,7,0,4,0,11
16063,2022/10/02,5,0,3,0,8
16276,2022/10/02,12,0,1,0,13
19521,2022/10/02,11,8,1,0,12
20901,2022/10/02,5,0,0,0,5
20920,2022/10/02,14,0,0,0,14
75,2022/10/03,41,36,31,0,72
76,2022/10/03,37,40,26,0,63
99,2022/10/03,8,0,1,0,9
117,2022/10/03,0,0,0,0,0
118,2022/10/03,15,8,7,2,22
119,2022/10/03,4,0,1,0,5
120,2022/10/03,10,4,0,1,10
149,2022/10/03,2,0,0,0,2
184,2022/10/03,9,9,9,0,18
195,2022/10/03,28,30,20,0,48
218,2022/10/03,23,24,17,0,40
296,2022/10/03,12,6,8,0,20
300,2022/10/03,13,0,2,0,15
304,2022/10/03,14,6,3,0,17
317,2022/10/03,28,12,6,0,34
343,2022/10/03,4,0,3,0,7
373,2022/10/03,22,12,6,0,28
374,2022/10/03,17,0,4,0,21
388,2022/10/03,26,27,17,0,43
419,2022/10/03,29,12,6,0,35
420,2022/10/03,22,6,4,0,26
462,2022/10/03,15,8,9,0,24
519,2022/10/03,8,6,4,0,12
525,2022/10/03,11,5,1,0,12
596,2022/10/03,7,4,4,0,11
597,2022/10/03,16,18,12,0,28
598,2022/10/03,8,0,0,0,8
1035,2022/10/03,15,6,3,0,18
1084,2022/10/03,10,10,8,0,18
1111,2022/10/03,11,0,1,0,12
1112,2022/10/03,7,0,2,0,9
1113,2022/10/03,3,0,1,0,4
1114,2022/10/03,14,6,1,0,15
1115,2022/10/03,8,6,1,0,9
1117,2022/10/03,9,8,0,0,9
1118,2022/10/03,12,0,0,0,12
1119,2022/10/03,9,0,1,0,10
1692,2022/10/03,12,0,7,0,19
1693,2022/10/03,24,6,6,0,30
1747,2022/10/03,20,20,17,0,37
1772,2022/10/03,-1,0,0,0,-1
1773,2022/10/03,10,0,3,0,13
1774,2022/10/03,11,8,1,0,12
1782,2022/10/03,16,18,17,0,33
1795,2022/10/03,7,7,8,0,15
1914,2022/10/03,10,0,0,0,10
1915,2022/10/03,5,0,0,0,5
1923,2022/10/03,8,0,0,0,8
1934,2022/10/03,5,5,0,1,5
1963,2022/10/03,38,6,11,0,49
1984,2022/10/03,6,0,1,0,7
2135,2022/10/03,8,0,1,0,9
2136,2022/10/03,8,0,0,0,8
2148,2022/10/03,11,0,1,0,12
2183,2022/10/03,19,0,3,0,22
2193,2022/10/03,15,15,18,0,33
2237,2022/10/03,7,0,1,0,8
2358,2022/10/03,21,0,5,0,26
2361,2022/10/03,15,7,5,0,20
2445,2022/10/03,13,6,3,0,16
2449,2022/10/03,17,12,3,0,20
2451,2022/10/03,16,0,5,0,21
2475,2022/10/03,7,0,0,0,7
2476,2022/10/03,6,0,0,0,6
2507,2022/10/03,12,12,10,0,22
2525,2022/10/03,6,0,0,0,6
2562,2022/10/03,23,6,5,0,28
2582,2022/10/03,3,0,1,0,4
2586,2022/10/03,15,16,13,0,28
2602,2022/10/03,13,0,2,0,15
2631,2022/10/03,12,6,1,0,13
2685,2022/10/03,8,8,4,0,12
2723,2022/10/03,11,0,0,0,11
2730,2022/10/03,8,0,0,0,8
2731,2022/10/03,8,0,0,0,8
2732,2022/10/03,12,0,0,0,12
2734,2022/10/03,7,0,3,0,10
2735,2022/10/03,9,0,4,0,13
2761,2022/10/03,17,20,17,0,34
2788,2022/10/03,19,20,17,0,36
2812,2022/10/03,5,0,0,0,5
2813,2022/10/03,4,0,0,0,4
2913,2022/10/03,1,0,1,0,2
3015,2022/10/03,14,0,1,0,15
3033,2022/10/03,5,0,0,0,5
3035,2022/10/03,1,0,0,0,1
4446,2022/10/03,11,12,11,0,22
12136,2022/10/03,21,21,21,0,42
12516,2022/10/03,6,0,0,0,6
12518,2022/10/03,19,10,0,0,19
12523,2022/10/03,8,0,3,0,11
16062,2022/10/03,3,0,0,0,3
16063,2022/10/03,2,0,1,0,3
16276,2022/10/03,11,0,0,3,11
19521,2022/10/03,10,0,0,0,10
20901,2022/10/03,5,0,1,0,6
20920,2022/10/03,14,0,1,0,15
75,2022/10/04,46,36,2,0,48
76,2022/10/04,51,40,2,0,53
99,2022/10/04,7,0,0,0,7
117,2022/10/04,8,8,0,0,8
118,2022/10/04,6,0,0,0,6
119,2022/10/04,3,0,0,0,3
120,2022/10/04,9,0,0,0,9
149,2022/10/04,8,6,0,0,8
184,2022/10/04,12,12,1,0,13
195,2022/10/04,29,21,1,2,30
218,2022/10/04,30,24,4,0,34
296,2022/10/04,4,0,0,0,4
300,2022/10/04,11,0,0,0,11
304,2022/10/04,11,0,0,0,11
317,2022/10/04,28,6,0,2,28
343,2022/10/04,1,0,0,0,1
373,2022/10/04,28,12,0,0,28
374,2022/10/04,13,0,0,0,13
388,2022/10/04,33,24,3,2,36
419,2022/10/04,29,6,0,0,29
420,2022/10/04,18,0,0,0,18
462,2022/10/04,6,0,0,0,6
519,2022/10/04,10,6,0,0,10
525,2022/10/04,10,0,1,0,11
596,2022/10/04,11,8,1,0,12
597,2022/10/04,16,12,0,0,16
598,2022/10/04,8,0,0,0,8
1035,2022/10/04,12,0,0,0,12
1084,2022/10/04,12,10,1,0,13
1111,2022/10/04,10,0,0,0,10
1112,2022/10/04,5,0,0,0,5
1113,2022/10/04,8,6,0,0,8
1114,2022/10/04,13,0,0,0,13
1115,2022/10/04,7,0,0,0,7
1117,2022/10/04,9,0,0,0,9
1118,2022/10/04,12,0,0,0,12
1119,2022/10/04,8,0,0,0,8
1692,2022/10/04,5,0,0,0,5
1693,2022/10/04,18,0,0,2,18
1747,2022/10/04,23,20,0,0,23
1772,2022/10/04,-1,0,0,0,-1
1773,2022/10/04,7,0,0,0,7
1774,2022/10/04,10,0,0,0,10
1782,2022/10/04,20,21,0,0,20
1795,2022/10/04,13,14,3,1,16
1914,2022/10/04,10,0,0,0,10
1915,2022/10/04,11,6,0,0,11
1923,2022/10/04,8,0,0,0,8
1934,2022/10/04,9,5,0,0,9
1963,2022/10/04,33,6,0,5,33
1984,2022/10/04,5,0,0,0,5
2135,2022/10/04,7,0,0,0,7
2136,2022/10/04,8,0,0,0,8
2148,2022/10/04,10,0,0,0,10
2183,2022/10/04,16,0,0,1,16
2193,2022/10/04,12,15,0,0,12
2237,2022/10/04,12,6,0,0,12
2358,2022/10/04,16,0,0,0,16
2361,2022/10/04,10,0,0,1,10
2445,2022/10/04,10,0,0,1,10
2449,2022/10/04,20,6,0,0,20
2451,2022/10/04,11,0,0,0,11
2475,2022/10/04,7,0,0,0,7
2476,2022/10/04,12,6,0,0,12
2507,2022/10/04,14,12,1,0,15
2525,2022/10/04,6,0,0,0,6
2562,2022/10/04,18,0,0,0,18
2582,2022/10/04,6,4,0,0,6
2586,2022/10/04,18,16,0,0,18
2602,2022/10/04,11,0,0,0,11
2631,2022/10/04,11,0,0,0,11
2685,2022/10/04,12,8,0,0,12
2723,2022/10/04,11,0,0,0,11
2730,2022/10/04,8,0,0,0,8
2731,2022/10/04,8,0,0,0,8
2732,2022/10/04,12,0,0,0,12
2734,2022/10/04,8,4,0,0,8
2735,2022/10/04,5,0,0,0,5
2761,2022/10/04,15,15,2,0,17
2788,2022/10/04,22,20,0,2,22
2812,2022/10/04,5,0,0,0,5
2813,2022/10/04,4,0,0,0,4
2913,2022/10/04,6,6,0,0,6
2914,2022/10/04,8,0,0,0,8
3015,2022/10/04,13,0,0,0,13
3033,2022/10/04,11,6,0,0,11
3035,2022/10/04,7,6,0,0,7
4446,2022/10/04,9,9,0,0,9
12136,2022/10/04,21,21,3,0,24
12516,2022/10/04,10,4,0,0,10
12518,2022/10/04,19,0,0,0,19
12523,2022/10/04,9,4,0,0,9
16062,2022/10/04,9,6,0,0,9
16063,2022/10/04,7,6,0,0,7
16276,2022/10/04,8,0,0,1,8
19329,2022/10/04,10,0,0,0,10
19521,2022/10/04,10,0,0,0,10
20901,2022/10/04,4,0,0,0,4
20920,2022/10/04,13,0,0,0,13
75,2022/10/05,57,44,34,0,91
76,2022/10/05,67,48,35,10,102
99,2022/10/05,7,0,1,0,8
117,2022/10/05,8,0,0,0,8
118,2022/10/05,12,8,5,0,17
119,2022/10/05,7,4,0,6,7
120,2022/10/05,7,0,1,0,8
149,2022/10/05,8,0,0,0,8
184,2022/10/05,13,12,9,0,22
195,2022/10/05,48,39,17,4,65
218,2022/10/05,33,27,26,4,59
296,2022/10/05,3,6,2,0,5
300,2022/10/05,15,8,3,0,18
304,2022/10/05,14,6,6,0,20
317,2022/10/05,26,6,7,1,33
343,2022/10/05,8,8,3,0,11
373,2022/10/05,27,0,5,1,32
374,2022/10/05,8,0,5,0,13
388,2022/10/05,39,27,27,9,66
419,2022/10/05,30,6,2,0,32
420,2022/10/05,24,6,1,0,25
462,2022/10/05,11,8,10,0,21
519,2022/10/05,12,6,6,0,18
525,2022/10/05,9,0,1,0,10
596,2022/10/05,11,8,5,0,16
597,2022/10/05,24,18,7,0,31
598,2022/10/05,11,6,0,0,11
1035,2022/10/05,16,6,5,0,21
1084,2022/10/05,14,15,4,0,18
1111,2022/10/05,10,0,1,0,11
1112,2022/10/05,5,0,0,0,5
1113,2022/10/05,8,0,0,0,8
1114,2022/10/05,13,0,2,0,15
1115,2022/10/05,3,0,0,0,3
1117,2022/10/05,9,0,1,0,10
1118,2022/10/05,12,0,0,0,12
1119,2022/10/05,8,0,0,0,8
1692,2022/10/05,8,6,3,1,11
1693,2022/10/05,15,0,2,0,17
1747,2022/10/05,27,30,18,0,45
1772,2022/10/05,0,0,0,0,0
1773,2022/10/05,7,0,0,0,7
1774,2022/10/05,10,0,2,0,12
1782,2022/10/05,21,18,18,0,39
1795,2022/10/05,29,28,12,0,41
1914,2022/10/05,10,0,0,0,10
1915,2022/10/05,11,0,0,0,11
1923,2022/10/05,8,0,0,0,8
1934,2022/10/05,13,5,3,0,16
1963,2022/10/05,28,6,3,0,31
1984,2022/10/05,8,6,2,0,10
2135,2022/10/05,13,6,3,0,16
2136,2022/10/05,8,0,2,0,10
2148,2022/10/05,12,4,5,0,17
2183,2022/10/05,14,0,1,3,15
2193,2022/10/05,18,18,18,0,36
2237,2022/10/05,12,0,2,0,14
2358,2022/10/05,12,0,2,7,14
2361,2022/10/05,14,7,4,0,18
2445,2022/10/05,13,6,2,1,15
2449,2022/10/05,31,12,2,0,33
2451,2022/10/05,3,0,1,0,4
2475,2022/10/05,7,0,0,0,7
2476,2022/10/05,12,0,3,0,15
2507,2022/10/05,19,18,8,0,27
2525,2022/10/05,11,6,1,0,12
2562,2022/10/05,25,12,4,0,29
2582,2022/10/05,9,4,1,0,10
2586,2022/10/05,24,16,12,0,36
2602,2022/10/05,11,0,0,0,11
2631,2022/10/05,9,0,1,1,10
2685,2022/10/05,15,8,6,0,21
2723,2022/10/05,11,0,0,0,11
2730,2022/10/05,7,0,1,0,8
2731,2022/10/05,7,0,1,0,8
2732,2022/10/05,10,0,0,0,10
2734,2022/10/05,11,4,0,0,11
2735,2022/10/05,11,8,3,0,14
2761,2022/10/05,25,20,5,0,30
2788,2022/10/05,30,20,16,8,46
2812,2022/10/05,5,0,0,0,5
2813,2022/10/05,10,6,2,0,12
2913,2022/10/05,6,0,1,0,7
2914,2022/10/05,8,0,0,0,8
3015,2022/10/05,12,0,0,0,12
3033,2022/10/05,11,0,1,0,12
3035,2022/10/05,6,0,0,0,6
4446,2022/10/05,13,12,5,0,18
12136,2022/10/05,26,24,19,1,45
12516,2022/10/05,13,4,2,0,15
12518,2022/10/05,18,0,1,0,19
12523,2022/10/05,10,4,6,0,16
16062,2022/10/05,8,0,0,0,8
16063,2022/10/05,12,6,0,0,12
16276,2022/10/05,6,0,1,1,7
19329,2022/10/05,10,0,0,0,10
19521,2022/10/05,10,0,0,0,10
20901,2022/10/05,4,0,0,0,4
20920,2022/10/05,13,0,2,0,15
75,2022/10/06,44,24,41,0,85
76,2022/10/06,67,44,43,16,110
99,2022/10/06,6,0,1,0,7
117,2022/10/06,16,8,6,0,22
118,2022/10/06,7,0,4,0,11
119,2022/10/06,1,0,0,0,1
120,2022/10/06,6,0,0,2,6
149,2022/10/06,8,0,0,0,8
184,2022/10/06,16,12,13,0,29
195,2022/10/06,63,36,29,12,92
218,2022/10/06,30,27,27,4,57
296,2022/10/06,1,0,4,0,5
300,2022/10/06,12,0,3,0,15
304,2022/10/06,14,6,4,0,18
317,2022/10/06,24,6,5,1,29
343,2022/10/06,5,0,2,0,7
373,2022/10/06,21,0,3,0,24
374,2022/10/06,3,0,2,0,5
388,2022/10/06,30,27,28,2,58
419,2022/10/06,34,6,8,0,42
420,2022/10/06,23,0,7,0,30
462,2022/10/06,9,8,5,0,14
519,2022/10/06,12,6,5,0,17
525,2022/10/06,8,0,0,3,8
596,2022/10/06,14,8,2,0,16
597,2022/10/06,34,18,8,0,42
598,2022/10/06,11,0,3,0,14
1035,2022/10/06,17,6,3,2,20
1084,2022/10/06,21,10,7,0,28
1111,2022/10/06,9,0,0,0,9
1112,2022/10/06,11,6,1,0,12
1113,2022/10/06,8,0,0,0,8
1114,2022/10/06,11,0,3,0,14
1115,2022/10/06,3,0,0,0,3
1117,2022/10/06,8,0,0,0,8
1118,2022/10/06,12,0,0,0,12
1119,2022/10/06,8,0,0,0,8
1692,2022/10/06,10,6,3,0,13
1693,2022/10/06,13,0,4,1,17
1747,2022/10/06,34,20,29,0,63
1772,2022/10/06,8,8,0,0,8
1773,2022/10/06,7,0,1,0,8
1774,2022/10/06,8,0,2,0,10
1782,2022/10/06,28,24,20,0,48
1795,2022/10/06,38,21,13,0,51
1914,2022/10/06,10,0,0,0,10
1915,2022/10/06,11,0,1,0,12
1923,2022/10/06,8,0,1,0,9
1934,2022/10/06,16,5,0,0,16
1963,2022/10/06,31,6,12,1,43
1984,2022/10/06,6,0,3,0,9
2135,2022/10/06,10,0,0,0,10
2136,2022/10/06,6,0,0,0,6
2148,2022/10/06,7,0,2,0,9
2183,2022/10/06,10,0,3,7,13
2193,2022/10/06,20,18,15,2,35
2237,2022/10/06,10,0,1,0,11
2358,2022/10/06,3,0,2,0,5
2361,2022/10/06,17,7,5,0,22
2445,2022/10/06,16,6,6,0,22
2449,2022/10/06,29,0,2,0,31
2451,2022/10/06,15,15,10,0,25
2476,2022/10/06,9,0,0,0,9
2507,2022/10/06,23,12,18,0,41
2525,2022/10/06,10,0,0,0,10
2562,2022/10/06,21,0,5,0,26
2582,2022/10/06,12,4,0,0,12
2586,2022/10/06,27,16,21,1,48
2602,2022/10/06,11,0,0,0,11
2631,2022/10/06,7,0,2,3,9
2685,2022/10/06,17,8,4,0,21
2723,2022/10/06,11,0,1,0,12
2730,2022/10/06,12,6,0,0,12
2731,2022/10/06,6,0,0,0,6
2732,2022/10/06,10,0,0,0,10
2734,2022/10/06,11,0,5,0,16
2735,2022/10/06,8,0,1,0,9
2761,2022/10/06,39,20,18,0,57
2788,2022/10/06,27,20,10,3,37
2812,2022/10/06,5,0,0,0,5
2813,2022/10/06,8,0,1,0,9
2913,2022/10/06,5,0,1,0,6
2914,2022/10/06,8,0,0,0,8
3015,2022/10/06,12,0,1,0,13
3033,2022/10/06,10,0,1,0,11
3035,2022/10/06,6,0,2,0,8
4446,2022/10/06,20,12,12,1,32
12136,2022/10/06,18,12,18,1,36
12516,2022/10/06,11,0,1,0,12
12518,2022/10/06,17,0,5,0,22
12523,2022/10/06,4,0,2,0,6
16062,2022/10/06,8,0,0,0,8
16063,2022/10/06,12,0,3,0,15
16276,2022/10/06,4,0,0,0,4
19329,2022/10/06,10,0,0,0,10
19521,2022/10/06,10,0,0,0,10
20901,2022/10/06,10,6,0,0,10
20920,2022/10/06,11,0,1,0,12
75,2022/10/07,39,36,34,0,73
76,2022/10/07,36,28,35,1,71
99,2022/10/07,5,0,0,0,5
117,2022/10/07,10,0,3,0,13
118,2022/10/07,3,0,2,0,5
119,2022/10/07,1,0,2,0,3
120,2022/10/07,4,0,1,2,5
149,2022/10/07,8,0,0,0,8
184,2022/10/07,15,12,14,0,29
195,2022/10/07,40,18,26,8,66
218,2022/10/07,17,18,19,0,36
296,2022/10/07,3,6,0,0,3
300,2022/10/07,9,0,2,0,11
304,2022/10/07,16,6,2,0,18
317,2022/10/07,24,6,5,8,29
343,2022/10/07,11,8,4,0,15
373,2022/10/07,24,6,4,0,28
374,2022/10/07,5,4,2,0,7
388,2022/10/07,24,24,24,0,48
419,2022/10/07,26,0,4,0,30
420,2022/10/07,16,0,3,1,19
462,2022/10/07,12,8,9,0,21
519,2022/10/07,19,12,9,0,28
525,2022/10/07,5,0,0,0,5
596,2022/10/07,20,8,2,0,22
597,2022/10/07,50,24,10,0,60
598,2022/10/07,8,0,1,3,9
1035,2022/10/07,18,6,3,0,21
1084,2022/10/07,29,15,8,0,37
1111,2022/10/07,9,0,0,0,9
1112,2022/10/07,10,0,0,0,10
1113,2022/10/07,8,0,0,0,8
1114,2022/10/07,8,0,0,0,8
1115,2022/10/07,9,6,0,0,9
1117,2022/10/07,8,0,1,0,9
1118,2022/10/07,12,0,0,0,12
1119,2022/10/07,8,0,1,0,9
1692,2022/10/07,13,6,7,0,20
1693,2022/10/07,8,0,2,2,10
1747,2022/10/07,15,10,15,0,30
1772,2022/10/07,8,0,2,0,10
1773,2022/10/07,6,0,0,0,6
1774,2022/10/07,6,0,0,0,6
1782,2022/10/07,26,18,25,0,51
1795,2022/10/07,53,28,8,0,61
1914,2022/10/07,10,0,0,0,10
1915,2022/10/07,10,0,0,0,10
1923,2022/10/07,7,0,1,0,8
1934,2022/10/07,21,5,6,3,27
1963,2022/10/07,24,6,3,7,27
1984,2022/10/07,9,6,4,0,13
2135,2022/10/07,10,0,4,0,14
2136,2022/10/07,6,0,0,0,6
2148,2022/10/07,5,0,1,0,6
2183,2022/10/07,0,0,0,0,0
2193,2022/10/07,21,18,9,1,30
2237,2022/10/07,9,0,1,0,10
2358,2022/10/07,9,8,2,0,11
2361,2022/10/07,19,7,1,1,20
2445,2022/10/07,16,6,4,0,20
2449,2022/10/07,27,0,2,3,29
2451,2022/10/07,20,15,1,0,21
2476,2022/10/07,9,0,0,0,9
2507,2022/10/07,24,18,13,0,37
2525,2022/10/07,10,0,1,0,11
2562,2022/10/07,16,0,5,1,21
2582,2022/10/07,12,0,1,0,13
2586,2022/10/07,21,16,19,0,40
2602,2022/10/07,11,0,0,0,11
2631,2022/10/07,8,6,5,0,13
2685,2022/10/07,21,8,12,3,33
2723,2022/10/07,10,0,1,0,11
2730,2022/10/07,12,0,3,0,15
2731,2022/10/07,6,0,3,0,9
2732,2022/10/07,10,0,0,0,10
2734,2022/10/07,6,0,1,0,7
2735,2022/10/07,15,8,1,0,16
2761,2022/10/07,36,15,20,0,56
2788,2022/10/07,30,16,17,10,47
2812,2022/10/07,5,0,1,0,6
2813,2022/10/07,7,0,1,0,8
2913,2022/10/07,10,6,3,0,13
2914,2022/10/07,8,0,0,0,8
3015,2022/10/07,11,0,1,0,12
3033,2022/10/07,9,0,0,0,9
3035,2022/10/07,4,0,0,0,4
4446,2022/10/07,19,12,13,0,32
12136,2022/10/07,20,21,20,0,40
12516,2022/10/07,10,0,1,0,11
12518,2022/10/07,12,0,4,0,16
12523,2022/10/07,6,4,3,0,9
16062,2022/10/07,14,6,4,0,18
16063,2022/10/07,9,0,3,0,12
16276,2022/10/07,4,0,0,0,4
19329,2022/10/07,10,0,0,0,10
19521,2022/10/07,10,0,1,0,11
20901,2022/10/07,10,0,0,0,10
20920,2022/10/07,10,0,1,0,11
75,2022/10/08,25,20,22,0,47
76,2022/10/08,9,8,8,0,17
99,2022/10/08,5,0,0,0,5
117,2022/10/08,7,0,2,0,9
118,2022/10/08,1,0,0,0,1
119,2022/10/08,-1,0,0,0,-1
120,2022/10/08,1,0,2,1,3
149,2022/10/08,8,0,1,0,9
184,2022/10/08,7,6,7,0,14
195,2022/10/08,18,12,16,0,34
218,2022/10/08,16,18,19,0,35
296,2022/10/08,9,6,6,0,15
300,2022/10/08,7,0,2,0,9
304,2022/10/08,14,0,5,0,19
317,2022/10/08,11,0,3,0,14
343,2022/10/08,7,0,4,0,11
373,2022/10/08,20,0,1,0,21
374,2022/10/08,7,4,3,0,10
388,2022/10/08,0,0,2,0,2
419,2022/10/08,22,0,2,0,24
420,2022/10/08,12,0,3,2,15
462,2022/10/08,3,0,7,0,10
519,2022/10/08,16,6,4,0,20
525,2022/10/08,5,0,1,4,6
596,2022/10/08,18,0,5,3,23
597,2022/10/08,40,0,13,0,53
598,2022/10/08,4,0,1,0,5
1035,2022/10/08,15,0,7,0,22
1084,2022/10/08,21,0,6,1,27
1111,2022/10/08,9,0,0,0,9
1112,2022/10/08,10,0,0,0,10
1113,2022/10/08,8,0,1,0,9
1114,2022/10/08,8,0,3,0,11
1115,2022/10/08,15,6,2,0,17
1117,2022/10/08,7,0,0,0,7
1118,2022/10/08,12,0,1,0,13
1119,2022/10/08,7,0,0,0,7
1692,2022/10/08,6,0,3,0,9
1693,2022/10/08,4,0,0,0,4
1747,2022/10/08,20,20,20,0,40
1772,2022/10/08,6,0,0,0,6
1773,2022/10/08,6,0,1,0,7
1774,2022/10/08,6,0,0,0,6
1782,2022/10/08,10,9,9,0,19
1795,2022/10/08,80,35,44,0,124
1914,2022/10/08,10,0,0,0,10
1915,2022/10/08,10,0,0,0,10
1923,2022/10/08,6,0,1,0,7
1934,2022/10/08,12,0,4,1,16
1963,2022/10/08,26,12,3,0,29
1984,2022/10/08,5,0,1,0,6
2135,2022/10/08,6,0,5,0,11
2136,2022/10/08,6,0,2,0,8
2148,2022/10/08,8,4,2,0,10
2183,2022/10/08,6,6,4,0,10
2193,2022/10/08,20,9,17,1,37
2237,2022/10/08,8,0,2,0,10
2358,2022/10/08,7,0,3,0,10
2361,2022/10/08,17,0,3,0,20
2445,2022/10/08,12,0,2,0,14
2449,2022/10/08,22,0,4,0,26
2451,2022/10/08,29,10,4,0,33
2476,2022/10/08,9,0,0,0,9
2507,2022/10/08,22,12,10,0,32
2525,2022/10/08,9,0,1,0,10
2562,2022/10/08,16,6,1,0,17
2582,2022/10/08,11,0,1,0,12
2586,2022/10/08,2,0,3,0,5
2602,2022/10/08,11,0,0,0,11
2631,2022/10/08,3,0,2,0,5
2685,2022/10/08,6,0,5,2,11
2723,2022/10/08,9,0,1,0,10
2730,2022/10/08,9,0,2,0,11
2731,2022/10/08,9,6,0,0,9
2732,2022/10/08,10,0,1,0,11
2734,2022/10/08,5,0,0,0,5
2735,2022/10/08,14,0,2,0,16
2761,2022/10/08,16,0,16,0,32
2788,2022/10/08,3,0,3,0,6
2812,2022/10/08,4,0,0,0,4
2813,2022/10/08,6,0,3,0,9
2913,2022/10/08,7,0,1,0,8
2914,2022/10/08,8,0,0,0,8
3015,2022/10/08,10,0,2,0,12
3033,2022/10/08,9,0,0,0,9
3035,2022/10/08,4,0,0,0,4
4446,2022/10/08,15,9,14,1,29
12136,2022/10/08,15,15,19,0,34
12516,2022/10/08,9,0,4,0,13
12518,2022/10/08,8,0,2,0,10
12523,2022/10/08,7,4,2,0,9
16062,2022/10/08,10,0,3,0,13
16063,2022/10/08,6,0,2,0,8
16276,2022/10/08,10,6,0,0,10
19329,2022/10/08,10,0,0,0,10
19521,2022/10/08,9,0,1,0,10
20901,2022/10/08,10,0,0,0,10
20920,2022/10/08,9,0,0,0,9
75,2022/10/09,27,24,18,3,45
76,2022/10/09,28,28,28,0,56
99,2022/10/09,5,0,0,0,5
117,2022/10/09,5,0,2,0,7
118,2022/10/09,9,8,2,0,11
119,2022/10/09,3,4,1,0,4
120,2022/10/09,2,4,1,0,3
149,2022/10/09,7,0,1,0,8
184,2022/10/09,6,6,5,0,11
195,2022/10/09,8,6,5,0,13
218,2022/10/09,18,21,18,0,36
296,2022/10/09,9,6,2,0,11
300,2022/10/09,13,8,3,0,16
304,2022/10/09,15,6,3,0,18
317,2022/10/09,20,12,4,0,24
343,2022/10/09,11,8,0,0,11
373,2022/10/09,19,0,2,0,21
374,2022/10/09,12,8,3,0,15
388,2022/10/09,19,21,18,0,37
419,2022/10/09,26,6,10,0,36
420,2022/10/09,7,0,1,0,8
462,2022/10/09,12,16,9,0,21
519,2022/10/09,18,6,7,0,25
525,2022/10/09,0,0,0,0,0
596,2022/10/09,14,4,4,0,18
597,2022/10/09,39,12,6,8,45
598,2022/10/09,3,0,1,0,4
1035,2022/10/09,14,6,6,1,20
1084,2022/10/09,24,10,10,2,34
1111,2022/10/09,9,0,1,0,10
1112,2022/10/09,10,0,0,0,10
1113,2022/10/09,7,0,1,0,8
1114,2022/10/09,11,6,6,0,17
1115,2022/10/09,13,0,9,0,22
1117,2022/10/09,7,0,0,0,7
1118,2022/10/09,11,0,0,0,11
1119,2022/10/09,7,0,1,0,8
1692,2022/10/09,9,6,3,0,12
1693,2022/10/09,10,6,0,0,10
1747,2022/10/09,15,15,16,0,31
1772,2022/10/09,6,0,2,0,8
1773,2022/10/09,5,0,2,0,7
1774,2022/10/09,14,8,1,0,15
1782,2022/10/09,16,15,11,0,27
1795,2022/10/09,36,0,9,0,45
1914,2022/10/09,10,0,0,0,10
1915,2022/10/09,10,0,1,0,11
1923,2022/10/09,5,0,0,0,5
1934,2022/10/09,7,0,0,2,7
1963,2022/10/09,29,6,7,0,36
1984,2022/10/09,10,6,7,0,17
2135,2022/10/09,1,0,1,0,2
2136,2022/10/09,4,0,0,0,4
2148,2022/10/09,10,4,3,0,13
2183,2022/10/09,8,6,8,0,16
2193,2022/10/09,14,12,7,2,21
2237,2022/10/09,6,0,1,0,7
2358,2022/10/09,20,16,7,0,27
2361,2022/10/09,14,0,3,0,17
2445,2022/10/09,16,6,6,3,22
2449,2022/10/09,24,6,3,0,27
2451,2022/10/09,50,25,8,0,58
2475,2022/10/09,7,0,1,0,8
2476,2022/10/09,9,0,1,0,10
2507,2022/10/09,12,0,8,0,20
2525,2022/10/09,8,0,4,0,12
2562,2022/10/09,15,0,5,0,20
2582,2022/10/09,10,0,2,0,12
2586,2022/10/09,11,12,12,0,23
2602,2022/10/09,11,0,0,0,11
2631,2022/10/09,7,6,5,0,12
2685,2022/10/09,3,4,4,0,7
2723,2022/10/09,8,0,0,0,8
2730,2022/10/09,7,0,2,0,9
2731,2022/10/09,9,0,0,0,9
2732,2022/10/09,9,0,1,0,10
2734,2022/10/09,9,4,3,0,12
2735,2022/10/09,12,0,1,0,13
2761,2022/10/09,10,10,6,0,16
2788,2022/10/09,12,12,12,0,24
2812,2022/10/09,4,0,1,0,5
2813,2022/10/09,3,0,0,0,3
2913,2022/10/09,6,0,3,0,9
2914,2022/10/09,8,0,0,0,8
3015,2022/10/09,8,0,1,0,9
3033,2022/10/09,9,0,1,0,10
3035,2022/10/09,10,6,1,0,11
4446,2022/10/09,6,6,6,0,12
12136,2022/10/09,8,12,7,0,15
12516,2022/10/09,5,0,1,0,6
12518,2022/10/09,6,0,2,0,8
12523,2022/10/09,17,12,3,0,20
16062,2022/10/09,7,0,5,0,12
16063,2022/10/09,4,0,1,0,5
16276,2022/10/09,10,0,2,0,12
19521,2022/10/09,8,0,0,0,8
20901,2022/10/09,10,0,1,0,11
20920,2022/10/09,9,0,0,0,9
75,2022/10/10,46,40,32,0,78
76,2022/10/10,40,40,38,0,78
99,2022/10/10,5,0,0,0,5
117,2022/10/10,11,8,2,0,13
118,2022/10/10,7,0,5,0,12
119,2022/10/10,2,0,0,0,2
120,2022/10/10,1,0,2,0,3
149,2022/10/10,6,0,0,0,6
184,2022/10/10,10,9,9,0,19
195,2022/10/10,33,30,23,0,56
218,2022/10/10,27,27,23,0,50
296,2022/10/10,13,6,2,0,15
300,2022/10/10,10,0,2,1,12
304,2022/10/10,18,6,8,0,26
317,2022/10/10,22,6,4,0,26
343,2022/10/10,11,0,4,0,15
373,2022/10/10,23,6,6,6,29
374,2022/10/10,9,0,2,0,11
388,2022/10/10,28,27,14,0,42
419,2022/10/10,22,6,6,5,28
420,2022/10/10,12,6,4,0,16
462,2022/10/10,11,8,6,0,17
519,2022/10/10,17,6,2,0,19
525,2022/10/10,5,5,1,0,6
596,2022/10/10,14,4,1,4,15
597,2022/10/10,31,6,12,1,43
598,2022/10/10,8,6,1,0,9
1035,2022/10/10,13,6,4,0,17
1084,2022/10/10,17,5,7,0,24
1111,2022/10/10,8,0,0,0,8
1112,2022/10/10,10,0,0,0,10
1113,2022/10/10,6,0,2,0,8
1114,2022/10/10,5,0,1,0,6
1115,2022/10/10,4,0,1,0,5
1117,2022/10/10,7,0,0,0,7
1119,2022/10/10,6,0,0,0,6
1692,2022/10/10,12,6,5,0,17
1693,2022/10/10,16,6,3,0,19
1747,2022/10/10,19,20,18,0,37
1772,2022/10/10,4,0,1,0,5
1773,2022/10/10,3,0,1,0,4
1774,2022/10/10,13,0,2,0,15
1782,2022/10/10,26,21,19,0,45
1795,2022/10/10,27,0,11,3,38
1914,2022/10/10,10,0,1,0,11
1915,2022/10/10,9,0,0,0,9
1923,2022/10/10,5,0,0,0,5
1934,2022/10/10,5,0,2,3,7
1963,2022/10/10,28,6,3,0,31
1984,2022/10/10,3,0,1,0,4
2135,2022/10/10,6,6,1,0,7
2136,2022/10/10,4,0,1,0,5
2148,2022/10/10,7,0,1,0,8
2183,2022/10/10,0,0,0,0,0
2193,2022/10/10,23,18,20,2,43
2237,2022/10/10,11,6,2,0,13
2358,2022/10/10,13,0,4,0,17
2361,2022/10/10,18,7,4,0,22
2445,2022/10/10,13,6,8,1,21
2449,2022/10/10,21,0,5,2,26
2451,2022/10/10,42,0,8,0,50
2475,2022/10/10,6,0,0,0,6
2476,2022/10/10,8,0,1,0,9
2507,2022/10/10,16,12,6,0,22
2525,2022/10/10,4,0,2,0,6
2562,2022/10/10,10,0,5,0,15
2582,2022/10/10,8,0,0,0,8
2586,2022/10/10,19,20,9,0,28
2602,2022/10/10,11,0,0,0,11
2631,2022/10/10,2,0,2,0,4
2685,2022/10/10,-1,0,0,0,-1
2723,2022/10/10,8,0,2,0,10
2730,2022/10/10,5,0,2,0,7
2731,2022/10/10,9,0,0,0,9
2732,2022/10/10,8,0,1,0,9
2734,2022/10/10,6,0,2,0,8
2735,2022/10/10,11,0,4,0,15
2761,2022/10/10,19,15,16,0,35
2788,2022/10/10,16,16,11,0,27
2812,2022/10/10,3,0,0,0,3
2813,2022/10/10,3,0,0,0,3
2913,2022/10/10,3,0,0,0,3
3015,2022/10/10,7,0,3,0,10
3033,2022/10/10,8,0,0,0,8
3035,2022/10/10,9,0,1,0,10
4446,2022/10/10,9,9,7,0,16
12136,2022/10/10,22,21,16,0,38
12516,2022/10/10,4,0,2,1,6
12518,2022/10/10,14,10,1,2,15
12523,2022/10/10,14,0,3,0,17
16062,2022/10/10,2,0,0,0,2
16063,2022/10/10,9,6,1,0,10
16276,2022/10/10,8,0,1,1,9
19521,2022/10/10,8,0,0,0,8
20901,2022/10/10,9,0,1,0,10
20920,2022/10/10,9,0,0,0,9
75,2022/10/11,46,32,26,8,72
76,2022/10/11,42,40,38,0,80
99,2022/10/11,5,0,0,0,5
117,2022/10/11,9,0,2,2,11
118,2022/10/11,10,8,5,0,15
119,2022/10/11,6,4,0,0,6
120,2022/10/11,3,4,1,0,4
149,2022/10/11,6,0,0,0,6
184,2022/10/11,13,12,4,0,17
195,2022/10/11,37,27,27,6,64
218,2022/10/11,28,24,19,1,47
296,2022/10/11,17,6,3,0,20
300,2022/10/11,15,8,2,0,17
304,2022/10/11,10,0,4,0,14
317,2022/10/11,30,12,6,0,36
343,2022/10/11,7,0,2,0,9
373,2022/10/11,11,0,4,0,15
374,2022/10/11,11,4,2,0,13
388,2022/10/11,38,24,19,7,57
419,2022/10/11,17,6,7,0,24
420,2022/10/11,14,6,3,0,17
462,2022/10/11,13,8,7,0,20
519,2022/10/11,15,0,6,0,21
525,2022/10/11,4,0,3,0,7
596,2022/10/11,13,4,0,4,13
597,2022/10/11,18,0,9,1,27
598,2022/10/11,7,0,0,0,7
1035,2022/10/11,9,0,5,0,14
1084,2022/10/11,20,10,5,3,25
1111,2022/10/11,8,0,0,0,8
1112,2022/10/11,10,0,0,0,10
1113,2022/10/11,4,0,0,0,4
1114,2022/10/11,4,0,0,0,4
1115,2022/10/11,3,0,0,0,3
1117,2022/10/11,7,0,1,0,8
1119,2022/10/11,6,0,0,0,6
1692,2022/10/11,13,6,3,0,16
1693,2022/10/11,13,0,2,0,15
1747,2022/10/11,26,25,25,0,51
1772,2022/10/11,3,0,2,0,5
1773,2022/10/11,8,6,1,0,9
1774,2022/10/11,11,0,5,0,16
1782,2022/10/11,31,24,16,0,47
1795,2022/10/11,27,14,9,10,36
1914,2022/10/11,9,0,0,0,9
1915,2022/10/11,9,0,0,0,9
1923,2022/10/11,11,6,1,0,12
1934,2022/10/11,5,5,2,0,7
1963,2022/10/11,31,6,10,1,41
1984,2022/10/11,2,0,1,0,3
2135,2022/10/11,11,6,2,0,13
2136,2022/10/11,9,6,0,0,9
2148,2022/10/11,10,4,6,0,16
2183,2022/10/11,6,6,1,0,7
2193,2022/10/11,16,15,12,0,28
2237,2022/10/11,9,0,3,0,12
2358,2022/10/11,9,0,4,0,13
2361,2022/10/11,14,0,3,5,17
2445,2022/10/11,4,0,4,0,8
2449,2022/10/11,14,0,2,5,16
2451,2022/10/11,34,0,7,0,41
2475,2022/10/11,6,0,0,0,6
2476,2022/10/11,7,0,1,0,8
2507,2022/10/11,22,12,10,0,32
2525,2022/10/11,2,0,0,0,2
2562,2022/10/11,11,6,2,0,13
2582,2022/10/11,8,0,1,0,9
2586,2022/10/11,26,16,6,0,32
2602,2022/10/11,11,0,0,0,11
2631,2022/10/11,6,6,0,0,6
2685,2022/10/11,3,4,4,0,7
2723,2022/10/11,6,0,1,0,7
2730,2022/10/11,3,0,2,0,5
2731,2022/10/11,9,0,1,0,10
2732,2022/10/11,7,0,0,0,7
2734,2022/10/11,8,4,4,0,12
2735,2022/10/11,7,0,4,0,11
2761,2022/10/11,18,15,17,0,35
2788,2022/10/11,25,20,18,3,43
2812,2022/10/11,3,0,0,0,3
2813,2022/10/11,9,6,0,0,9
2913,2022/10/11,9,6,1,0,10
2914,2022/10/11,8,0,1,0,9
3015,2022/10/11,4,0,2,0,6
3033,2022/10/11,8,0,1,0,9
3035,2022/10/11,8,0,3,0,11
4446,2022/10/11,14,12,9,0,23
12136,2022/10/11,27,21,25,1,52
12516,2022/10/11,5,4,2,0,7
12518,2022/10/11,11,0,6,0,17
12523,2022/10/11,15,4,2,0,17
16062,2022/10/11,8,6,0,0,8
16063,2022/10/11,8,0,0,0,8
16276,2022/10/11,6,0,0,0,6
19329,2022/10/11,10,0,1,0,11
19521,2022/10/11,8,0,0,0,8
20901,2022/10/11,8,0,0,0,8
20920,2022/10/11,9,0,0,0,9
75,2022/10/12,48,36,53,0,101
76,2022/10/12,44,40,39,1,83
99,2022/10/12,5,0,0,0,5
117,2022/10/12,5,0,3,0,8
118,2022/10/12,5,0,4,0,9
119,2022/10/12,6,0,2,0,8
120,2022/10/12,2,0,1,0,3
149,2022/10/12,6,0,0,0,6
184,2022/10/12,18,9,7,0,25
195,2022/10/12,28,24,31,0,59
218,2022/10/12,32,24,29,5,61
296,2022/10/12,20,6,1,0,21
300,2022/10/12,13,0,5,0,18
304,2022/10/12,6,0,4,0,10
317,2022/10/12,30,6,4,0,34
343,2022/10/12,13,8,0,0,13
373,2022/10/12,7,0,3,0,10
374,2022/10/12,9,0,3,0,12
388,2022/10/12,36,24,25,5,61
419,2022/10/12,16,6,0,0,16
420,2022/10/12,17,6,2,0,19
462,2022/10/12,14,8,10,0,24
519,2022/10/12,15,6,5,0,20
525,2022/10/12,1,0,0,0,1
596,2022/10/12,13,4,2,0,15
597,2022/10/12,20,12,5,1,25
598,2022/10/12,7,0,2,0,9
1035,2022/10/12,4,0,1,0,5
1084,2022/10/12,17,5,10,1,27
1111,2022/10/12,8,0,0,0,8
1112,2022/10/12,10,0,0,0,10
1113,2022/10/12,4,0,0,0,4
1114,2022/10/12,10,6,3,0,13
1115,2022/10/12,9,6,0,0,9
1117,2022/10/12,6,0,0,0,6
1119,2022/10/12,6,0,2,0,8
1692,2022/10/12,10,0,3,0,13
1693,2022/10/12,17,6,2,0,19
1747,2022/10/12,21,20,18,0,39
1772,2022/10/12,1,0,0,0,1
1773,2022/10/12,7,0,2,0,9
1774,2022/10/12,6,0,5,0,11
1782,2022/10/12,33,18,18,6,51
1795,2022/10/12,8,0,5,0,13
1915,2022/10/12,9,0,1,0,10
1923,2022/10/12,10,0,1,0,11
1934,2022/10/12,8,5,4,0,12
1963,2022/10/12,32,12,5,0,37
1984,2022/10/12,7,6,1,0,8
2135,2022/10/12,9,0,0,0,9
2136,2022/10/12,9,0,1,0,10
2148,2022/10/12,4,0,3,0,7
2183,2022/10/12,5,0,3,0,8
2193,2022/10/12,19,15,4,2,23
2237,2022/10/12,6,0,2,0,8
2358,2022/10/12,13,8,7,0,20
2361,2022/10/12,6,0,6,0,12
2445,2022/10/12,0,0,0,0,0
2449,2022/10/12,13,6,3,2,16
2451,2022/10/12,27,0,12,0,39
2475,2022/10/12,6,0,1,0,7
2476,2022/10/12,6,0,0,0,6
2507,2022/10/12,18,6,5,2,23
2525,2022/10/12,8,6,2,0,10
2562,2022/10/12,9,0,1,0,10
2582,2022/10/12,7,0,1,0,8
2586,2022/10/12,32,12,5,0,37
2602,2022/10/12,11,0,2,0,13
2631,2022/10/12,6,0,6,0,12
2685,2022/10/12,7,8,5,0,12
2723,2022/10/12,5,0,1,0,6
2730,2022/10/12,7,6,2,0,9
2731,2022/10/12,8,0,0,0,8
2732,2022/10/12,7,0,0,0,7
2734,2022/10/12,4,0,3,0,7
2735,2022/10/12,11,8,2,0,13
2761,2022/10/12,16,15,7,0,23
2788,2022/10/12,16,12,21,1,37
2812,2022/10/12,9,6,0,0,9
2813,2022/10/12,9,0,2,0,11
2814,2022/10/12,9,0,1,0,10
2913,2022/10/12,8,0,1,1,9
2914,2022/10/12,7,0,0,0,7
3015,2022/10/12,2,0,1,0,3
3033,2022/10/12,7,0,2,0,9
3035,2022/10/12,5,0,1,0,6
4446,2022/10/12,17,12,6,1,23
12136,2022/10/12,25,24,23,1,48
12516,2022/10/12,3,0,0,1,3
12518,2022/10/12,15,10,1,0,16
12523,2022/10/12,13,0,5,0,18
16062,2022/10/12,14,6,2,0,16
16063,2022/10/12,8,0,0,0,8
16276,2022/10/12,6,0,3,3,9
19322,2022/10/12,8,0,2,0,10
19329,2022/10/12,9,0,0,0,9
19521,2022/10/12,8,0,1,0,9
20901,2022/10/12,8,0,0,0,8
20920,2022/10/12,9,0,1,0,10
75,2022/10/13,27,32,22,0,49
76,2022/10/13,48,44,39,4,87
99,2022/10/13,5,0,0,0,5
117,2022/10/13,10,8,0,0,10
118,2022/10/13,9,8,3,0,12
119,2022/10/13,8,4,1,0,9
120,2022/10/13,5,4,0,0,5
149,2022/10/13,6,0,0,0,6
184,2022/10/13,23,12,6,0,29
195,2022/10/13,24,27,26,0,50
218,2022/10/13,19,21,24,0,43
296,2022/10/13,19,0,6,0,25
300,2022/10/13,8,0,2,0,10
304,2022/10/13,8,6,4,0,12
317,2022/10/13,26,0,2,0,28
343,2022/10/13,13,0,2,0,15
373,2022/10/13,10,6,3,0,13
374,2022/10/13,10,4,3,0,13
388,2022/10/13,30,24,35,0,65
419,2022/10/13,16,0,8,0,24
420,2022/10/13,15,0,4,0,19
462,2022/10/13,12,8,10,0,22
519,2022/10/13,16,6,9,0,25
525,2022/10/13,6,5,0,0,6
596,2022/10/13,11,0,9,0,20
597,2022/10/13,26,12,9,1,35
598,2022/10/13,11,6,6,0,17
1035,2022/10/13,9,6,1,1,10
1084,2022/10/13,11,5,6,0,17
1111,2022/10/13,8,0,0,0,8
1112,2022/10/13,10,0,0,0,10
1113,2022/10/13,10,6,0,0,10
1114,2022/10/13,13,6,2,0,15
1115,2022/10/13,15,6,1,0,16
1117,2022/10/13,6,0,0,0,6
1119,2022/10/13,4,0,0,0,4
1692,2022/10/13,13,6,0,0,13
1693,2022/10/13,15,0,0,0,15
1747,2022/10/13,28,25,29,0,57
1772,2022/10/13,1,0,0,0,1
1773,2022/10/13,5,0,0,0,5
1774,2022/10/13,1,0,0,0,1
1782,2022/10/13,21,12,18,0,39
1795,2022/10/13,17,14,14,0,31
1915,2022/10/13,8,0,1,0,9
1923,2022/10/13,9,0,1,0,10
1934,2022/10/13,4,0,1,0,5
1963,2022/10/13,27,0,11,0,38
1984,2022/10/13,6,0,2,0,8
2135,2022/10/13,9,0,0,0,9
2136,2022/10/13,8,0,1,0,9
2148,2022/10/13,5,4,3,0,8
2183,2022/10/13,8,6,4,0,12
2193,2022/10/13,25,12,22,0,47
2237,2022/10/13,10,6,1,0,11
2358,2022/10/13,14,8,6,0,20
2361,2022/10/13,7,7,7,0,14
2445,2022/10/13,6,6,5,0,11
2449,2022/10/13,8,0,1,0,9
2451,2022/10/13,20,5,5,2,25
2475,2022/10/13,5,0,0,0,5
2476,2022/10/13,12,6,0,0,12
2507,2022/10/13,29,18,4,0,33
2525,2022/10/13,12,6,2,0,14
2562,2022/10/13,14,6,1,0,15
2582,2022/10/13,6,0,4,0,10
2586,2022/10/13,43,16,13,4,56
2602,2022/10/13,9,0,0,0,9
2631,2022/10/13,6,6,5,0,11
2685,2022/10/13,6,4,6,0,12
2723,2022/10/13,12,8,0,0,12
2730,2022/10/13,11,6,1,0,12
2731,2022/10/13,8,0,0,0,8
2732,2022/10/13,7,0,1,0,8
2734,2022/10/13,5,4,1,0,6
2735,2022/10/13,9,0,1,0,10
2761,2022/10/13,24,15,10,0,34
2788,2022/10/13,10,16,18,0,28
2812,2022/10/13,9,0,2,0,11
2813,2022/10/13,7,0,0,0,7
2814,2022/10/13,8,0,0,0,8
2913,2022/10/13,6,0,2,0,8
2914,2022/10/13,7,0,0,0,7
3015,2022/10/13,9,8,1,0,10
3033,2022/10/13,5,0,0,0,5
3035,2022/10/13,4,0,1,0,5
4446,2022/10/13,22,12,15,2,37
12136,2022/10/13,16,15,17,0,33
12516,2022/10/13,6,4,1,0,7
12518,2022/10/13,14,0,5,0,19
12523,2022/10/13,12,4,2,0,14
16062,2022/10/13,12,0,1,0,13
16063,2022/10/13,14,6,0,0,14
16276,2022/10/13,0,0,0,0,0
19322,2022/10/13,6,0,1,0,7
19329,2022/10/13,9,0,0,0,9
19521,2022/10/13,7,0,1,0,8
20901,2022/10/13,8,0,0,0,8
20920,2022/10/13,8,0,0,0,8
75,2022/10/14,40,32,43,0,83
76,2022/10/14,46,36,43,0,89
99,2022/10/14,5,0,1,0,6
117,2022/10/14,10,0,1,0,11
118,2022/10/14,6,0,2,0,8
119,2022/10/14,7,0,1,2,8
120,2022/10/14,5,0,4,0,9
149,2022/10/14,6,0,0,0,6
184,2022/10/14,29,12,20,0,49
195,2022/10/14,21,21,21,0,42
218,2022/10/14,19,24,19,0,38
296,2022/10/14,13,0,6,0,19
300,2022/10/14,14,8,4,0,18
304,2022/10/14,10,6,4,0,14
317,2022/10/14,24,0,5,0,29
343,2022/10/14,11,0,0,0,11
353,2022/10/14,7,0,2,0,9
373,2022/10/14,13,6,1,0,14
374,2022/10/14,11,4,7,0,18
388,2022/10/14,1,6,11,0,12
419,2022/10/14,14,6,3,0,17
420,2022/10/14,11,0,2,0,13
462,2022/10/14,10,8,7,0,17
519,2022/10/14,13,6,8,0,21
525,2022/10/14,6,0,0,0,6
596,2022/10/14,10,8,6,0,16
597,2022/10/14,40,24,20,0,60
598,2022/10/14,5,0,3,0,8
1035,2022/10/14,19,12,9,0,28
1084,2022/10/14,20,15,13,0,33
1111,2022/10/14,8,0,0,0,8
1112,2022/10/14,10,0,1,0,11
1113,2022/10/14,10,0,1,0,11
1114,2022/10/14,11,0,6,0,17
1115,2022/10/14,14,0,3,0,17
1117,2022/10/14,6,0,0,0,6
1119,2022/10/14,4,0,0,0,4
1692,2022/10/14,13,0,0,0,13
1693,2022/10/14,15,0,2,0,17
1747,2022/10/14,14,15,15,0,29
1772,2022/10/14,1,0,0,0,1
1773,2022/10/14,5,0,1,0,6
1774,2022/10/14,9,8,1,0,10
1782,2022/10/14,27,24,24,0,51
1795,2022/10/14,17,14,13,0,30
1915,2022/10/14,7,0,0,0,7
1923,2022/10/14,8,0,1,0,9
1934,2022/10/14,8,5,2,2,10
1963,2022/10/14,22,6,5,0,27
1984,2022/10/14,10,6,5,0,15
2135,2022/10/14,9,0,3,0,12
2136,2022/10/14,7,0,0,0,7
2148,2022/10/14,6,4,7,0,13
2183,2022/10/14,10,6,2,0,12
2193,2022/10/14,16,12,17,0,33
2237,2022/10/14,9,0,1,0,10
2358,2022/10/14,8,0,3,0,11
2361,2022/10/14,0,0,0,0,0
2445,2022/10/14,7,6,7,0,14
2449,2022/10/14,13,6,5,0,18
2451,2022/10/14,13,0,6,0,19
2475,2022/10/14,5,0,0,0,5
2476,2022/10/14,12,0,0,0,12
2507,2022/10/14,37,12,18,0,55
2525,2022/10/14,10,0,0,0,10
2562,2022/10/14,19,6,2,0,21
2582,2022/10/14,2,0,1,0,3
2586,2022/10/14,38,12,19,3,57
2631,2022/10/14,7,6,2,0,9
2685,2022/10/14,12,12,8,0,20
2723,2022/10/14,12,0,1,0,13
2730,2022/10/14,10,0,4,0,14
2731,2022/10/14,8,0,1,0,9
2732,2022/10/14,6,0,2,0,8
2734,2022/10/14,4,0,1,0,5
2735,2022/10/14,8,0,2,0,10
2761,2022/10/14,29,15,10,0,39
2788,2022/10/14,6,12,17,0,23
2812,2022/10/14,7,0,0,0,7
2813,2022/10/14,7,0,2,0,9
2814,2022/10/14,8,0,0,0,8
2913,2022/10/14,4,0,1,0,5
2914,2022/10/14,7,0,0,0,7
3015,2022/10/14,8,0,1,0,9
3033,2022/10/14,5,0,0,0,5
3035,2022/10/14,9,6,0,0,9
4446,2022/10/14,17,12,16,0,33
12136,2022/10/14,15,12,16,0,31
12516,2022/10/14,5,0,2,0,7
12518,2022/10/14,9,0,5,0,14
12523,2022/10/14,10,0,4,0,14
16062,2022/10/14,11,0,0,0,11
16063,2022/10/14,14,0,0,0,14
16276,2022/10/14,6,6,2,0,8
19322,2022/10/14,5,0,1,0,6
19329,2022/10/14,9,0,0,0,9
19521,2022/10/14,6,0,0,0,6
20901,2022/10/14,8,0,0,0,8
20920,2022/10/14,8,0,0,0,8
75,2022/10/15,22,24,21,0,43
76,2022/10/15,19,16,18,0,37
99,2022/10/15,4,0,1,0,5
117,2022/10/15,9,0,0,0,9
118,2022/10/15,12,8,2,0,14
119,2022/10/15,4,0,2,0,6
120,2022/10/15,5,4,3,0,8
149,2022/10/15,6,0,0,0,6
184,2022/10/15,15,6,9,0,24
195,2022/10/15,18,18,24,0,42
218,2022/10/15,18,18,20,0,38
296,2022/10/15,13,6,10,0,23
300,2022/10/15,10,0,6,0,16
304,2022/10/15,12,6,3,0,15
317,2022/10/15,25,6,8,0,33
343,2022/10/15,11,0,0,0,11
353,2022/10/15,5,0,0,0,5
373,2022/10/15,12,0,8,0,20
374,2022/10/15,4,0,0,0,4
388,2022/10/15,2,12,1,0,3
419,2022/10/15,23,12,11,0,34
420,2022/10/15,15,6,4,0,19
462,2022/10/15,11,8,5,0,16
519,2022/10/15,11,6,6,0,17
525,2022/10/15,11,5,1,0,12
596,2022/10/15,4,0,5,0,9
597,2022/10/15,20,0,18,0,38
598,2022/10/15,2,0,0,0,2
1035,2022/10/15,16,6,5,0,21
1084,2022/10/15,7,0,7,0,14
1111,2022/10/15,8,0,1,0,9
1112,2022/10/15,9,0,1,0,10
1113,2022/10/15,9,0,3,0,12
1114,2022/10/15,5,0,3,0,8
1115,2022/10/15,11,0,1,0,12
1117,2022/10/15,6,0,1,0,7
1119,2022/10/15,10,6,2,0,12
1692,2022/10/15,19,6,4,0,23
1693,2022/10/15,13,0,3,0,16
1747,2022/10/15,19,20,18,0,37
1772,2022/10/15,1,0,0,0,1
1773,2022/10/15,10,6,2,0,12
1774,2022/10/15,8,0,2,0,10
1782,2022/10/15,6,3,3,0,9
1795,2022/10/15,32,28,9,0,41
1914,2022/10/15,9,0,0,0,9
1915,2022/10/15,7,0,0,0,7
1923,2022/10/15,7,0,1,0,8
1934,2022/10/15,4,0,3,0,7
1963,2022/10/15,17,0,7,0,24
1984,2022/10/15,11,6,1,0,12
2135,2022/10/15,12,6,4,0,16
2136,2022/10/15,7,0,2,0,9
2148,2022/10/15,3,4,1,0,4
2183,2022/10/15,14,6,2,0,16
2193,2022/10/15,11,12,12,0,23
2237,2022/10/15,8,0,2,0,10
2358,2022/10/15,5,0,1,0,6
2361,2022/10/15,7,7,4,0,11
2445,2022/10/15,6,6,1,0,7
2449,2022/10/15,14,6,8,0,22
2451,2022/10/15,17,10,7,0,24
2475,2022/10/15,5,0,0,0,5
2476,2022/10/15,12,0,0,0,12
2507,2022/10/15,25,6,16,0,41
2525,2022/10/15,10,0,0,0,10
2562,2022/10/15,23,6,7,0,30
2582,2022/10/15,1,0,1,0,2
2586,2022/10/15,16,0,20,0,36
2631,2022/10/15,5,0,5,0,10
2685,2022/10/15,8,4,9,0,17
2723,2022/10/15,11,0,0,0,11
2730,2022/10/15,6,0,0,0,6
2731,2022/10/15,7,0,2,0,9
2732,2022/10/15,4,0,0,0,4
2734,2022/10/15,7,4,2,0,9
2735,2022/10/15,14,8,5,0,19
2761,2022/10/15,34,15,18,0,52
2788,2022/10/15,1,12,0,0,1
2812,2022/10/15,7,0,1,0,8
2813,2022/10/15,5,0,1,0,6
2814,2022/10/15,8,0,0,0,8
2913,2022/10/15,3,0,1,0,4
2914,2022/10/15,7,0,0,0,7
3015,2022/10/15,7,0,1,0,8
3033,2022/10/15,11,6,0,0,11
3035,2022/10/15,9,0,1,0,10
4446,2022/10/15,13,12,14,0,27
12136,2022/10/15,17,18,15,0,32
12516,2022/10/15,7,4,2,0,9
12518,2022/10/15,14,10,7,0,21
12523,2022/10/15,6,0,8,0,14
16062,2022/10/15,11,0,2,0,13
16063,2022/10/15,14,0,0,0,14
16276,2022/10/15,4,0,1,0,5
19322,2022/10/15,4,0,1,0,5
19329,2022/10/15,9,0,0,0,9
19521,2022/10/15,6,0,0,0,6
20901,2022/10/15,8,0,3,0,11
20920,2022/10/15,8,0,0,0,8
75,2022/10/16,29,28,21,0,50
76,2022/10/16,33,32,25,0,58
99,2022/10/16,3,0,0,0,3
117,2022/10/16,15,8,3,0,18
118,2022/10/16,10,0,1,0,11
119,2022/10/16,2,0,2,0,4
120,2022/10/16,2,0,3,0,5
149,2022/10/16,6,0,0,0,6
184,2022/10/16,10,6,6,0,16
195,2022/10/16,12,18,10,0,22
218,2022/10/16,19,21,20,0,39
296,2022/10/16,3,0,4,0,7
300,2022/10/16,4,0,2,0,6
304,2022/10/16,15,6,7,0,22
317,2022/10/16,23,6,4,0,27
343,2022/10/16,11,0,1,0,12
353,2022/10/16,5,0,1,0,6
373,2022/10/16,10,6,1,0,11
374,2022/10/16,8,4,8,0,16
388,2022/10/16,19,18,19,0,38
419,2022/10/16,18,6,3,0,21
420,2022/10/16,11,0,2,0,13
462,2022/10/16,14,8,8,0,22
519,2022/10/16,5,0,5,0,10
525,2022/10/16,10,0,5,0,15
596,2022/10/16,3,4,4,0,7
597,2022/10/16,14,12,8,0,22
598,2022/10/16,2,0,2,0,4
1035,2022/10/16,11,0,4,0,15
1084,2022/10/16,10,10,7,0,17
1111,2022/10/16,7,0,1,0,8
1112,2022/10/16,8,0,0,0,8
1113,2022/10/16,6,0,1,0,7
1114,2022/10/16,2,0,0,0,2
1115,2022/10/16,10,0,5,0,15
1117,2022/10/16,5,0,0,0,5
1119,2022/10/16,8,0,1,0,9
1692,2022/10/16,15,0,1,0,16
1693,2022/10/16,16,6,1,0,17
1747,2022/10/16,16,15,17,0,33
1772,2022/10/16,1,0,0,0,1
1773,2022/10/16,8,0,5,0,13
1774,2022/10/16,6,0,1,0,7
1782,2022/10/16,18,15,16,0,34
1795,2022/10/16,23,0,15,0,38
1914,2022/10/16,9,0,0,0,9
1915,2022/10/16,7,0,0,0,7
1923,2022/10/16,6,0,1,0,7
1934,2022/10/16,6,5,1,0,7
1963,2022/10/16,15,12,12,0,27
1984,2022/10/16,10,0,4,0,14
2135,2022/10/16,8,0,8,0,16
2136,2022/10/16,5,0,1,0,6
2148,2022/10/16,6,4,4,0,10
2183,2022/10/16,18,6,6,0,24
2193,2022/10/16,8,9,5,0,13
2237,2022/10/16,6,0,4,0,10
2358,2022/10/16,20,16,1,0,21
2361,2022/10/16,10,7,4,0,14
2445,2022/10/16,11,6,6,0,17
2449,2022/10/16,12,6,4,0,16
2451,2022/10/16,38,30,7,0,45
2475,2022/10/16,11,6,1,0,12
2476,2022/10/16,12,0,2,0,14
2507,2022/10/16,12,6,11,0,23
2525,2022/10/16,10,0,2,0,12
2562,2022/10/16,16,0,1,0,17
2582,2022/10/16,4,4,1,0,5
2586,2022/10/16,-4,0,1,0,-3
2631,2022/10/16,6,6,3,0,9
2685,2022/10/16,3,4,3,0,6
2723,2022/10/16,11,0,2,0,13
2730,2022/10/16,6,0,2,0,8
2731,2022/10/16,5,0,0,0,5
2732,2022/10/16,4,0,1,0,5
2734,2022/10/16,9,4,3,0,12
2735,2022/10/16,9,0,4,0,13
2761,2022/10/16,26,10,15,0,41
2788,2022/10/16,17,16,16,0,33
2812,2022/10/16,6,0,1,0,7
2813,2022/10/16,4,0,2,0,6
2814,2022/10/16,8,0,0,0,8
2913,2022/10/16,8,6,0,1,8
2914,2022/10/16,7,0,0,0,7
3015,2022/10/16,6,0,2,0,8
3033,2022/10/16,11,0,1,0,12
3035,2022/10/16,8,0,0,0,8
4446,2022/10/16,2,3,2,0,4
12136,2022/10/16,20,18,20,0,40
12516,2022/10/16,5,0,5,0,10
12518,2022/10/16,7,0,3,0,10
12523,2022/10/16,10,12,4,0,14
16062,2022/10/16,15,6,2,0,17
16063,2022/10/16,14,0,2,0,16
16276,2022/10/16,3,0,1,0,4
19322,2022/10/16,9,6,0,0,9
19329,2022/10/16,9,0,0,0,9
19521,2022/10/16,6,0,1,0,7
20901,2022/10/16,5,0,1,0,6
20920,2022/10/16,8,0,0,0,8
75,2022/10/17,44,36,35,0,79
76,2022/10/17,48,40,30,0,78
99,2022/10/17,15,12,1,0,16
117,2022/10/17,12,0,2,0,14
118,2022/10/17,9,0,2,0,11
119,2022/10/17,0,0,1,0,1
120,2022/10/17,-1,0,0,0,-1
149,2022/10/17,6,0,3,0,9
184,2022/10/17,4,0,1,0,5
195,2022/10/17,26,24,21,0,47
218,2022/10/17,23,24,22,0,45
296,2022/10/17,5,6,3,0,8
300,2022/10/17,10,8,5,0,15
304,2022/10/17,14,6,4,0,18
317,2022/10/17,25,6,6,0,31
343,2022/10/17,14,4,1,5,15
353,2022/10/17,10,6,2,0,12
373,2022/10/17,9,0,5,0,14
374,2022/10/17,0,0,0,0,0
388,2022/10/17,24,24,19,0,43
419,2022/10/17,15,0,9,0,24
420,2022/10/17,15,6,6,0,21
462,2022/10/17,15,8,7,0,22
519,2022/10/17,6,6,2,0,8
525,2022/10/17,5,0,0,0,5
596,2022/10/17,7,8,4,0,11
597,2022/10/17,18,12,13,1,31
598,2022/10/17,6,6,4,0,10
1035,2022/10/17,7,0,0,0,7
1084,2022/10/17,8,5,8,0,16
1111,2022/10/17,6,0,0,0,6
1112,2022/10/17,8,0,0,0,8
1113,2022/10/17,5,0,0,0,5
1114,2022/10/17,8,6,5,0,13
1115,2022/10/17,11,6,1,0,12
1117,2022/10/17,5,0,0,0,5
1119,2022/10/17,7,0,5,0,12
1692,2022/10/17,14,0,4,0,18
1693,2022/10/17,15,0,3,0,18
1747,2022/10/17,24,25,22,0,46
1772,2022/10/17,1,0,0,0,1
1773,2022/10/17,3,0,0,0,3
1774,2022/10/17,5,0,3,0,8
1782,2022/10/17,23,21,20,0,43
1795,2022/10/17,8,0,9,0,17
1914,2022/10/17,9,0,0,0,9
1915,2022/10/17,7,0,0,0,7
1923,2022/10/17,5,0,0,0,5
1934,2022/10/17,5,0,2,0,7
1963,2022/10/17,3,0,4,0,7
1984,2022/10/17,6,0,0,0,6
2135,2022/10/17,0,0,0,0,0
2136,2022/10/17,4,0,0,0,4
2148,2022/10/17,2,0,2,0,4
2183,2022/10/17,12,0,1,0,13
2193,2022/10/17,18,15,8,0,26
2237,2022/10/17,8,6,0,0,8
2358,2022/10/17,19,0,5,0,24
2361,2022/10/17,13,7,3,0,16
2445,2022/10/17,11,6,4,0,15
2449,2022/10/17,8,0,6,0,14
2451,2022/10/17,31,0,6,0,37
2475,2022/10/17,10,0,1,0,11
2476,2022/10/17,10,0,0,0,10
2507,2022/10/17,1,0,1,0,2
2525,2022/10/17,8,0,1,0,9
2562,2022/10/17,15,0,2,0,17
2582,2022/10/17,3,0,1,0,4
2586,2022/10/17,7,12,12,0,19
2631,2022/10/17,9,6,1,0,10
2685,2022/10/17,4,4,4,0,8
2723,2022/10/17,9,0,0,0,9
2730,2022/10/17,10,6,1,0,11
2731,2022/10/17,5,0,1,0,6
2732,2022/10/17,11,8,0,0,11
2734,2022/10/17,6,0,4,0,10
2735,2022/10/17,5,0,3,0,8
2761,2022/10/17,21,10,16,0,37
2788,2022/10/17,21,20,12,0,33
2812,2022/10/17,5,0,0,0,5
2813,2022/10/17,8,6,1,0,9
2814,2022/10/17,8,0,1,0,9
2913,2022/10/17,7,0,1,0,8
2914,2022/10/17,7,0,0,0,7
3015,2022/10/17,4,0,3,0,7
3033,2022/10/17,10,0,0,0,10
3035,2022/10/17,8,0,0,0,8
4446,2022/10/17,15,15,13,0,28
12136,2022/10/17,15,15,14,0,29
12516,2022/10/17,0,0,0,0,0
12518,2022/10/17,4,0,4,0,8
12523,2022/10/17,6,0,6,0,12
16062,2022/10/17,13,0,1,0,14
16063,2022/10/17,12,0,0,0,12
16276,2022/10/17,2,0,1,0,3
19329,2022/10/17,9,0,0,0,9
19521,2022/10/17,5,0,2,0,7
20901,2022/10/17,4,0,0,0,4
20920,2022/10/17,8,0,2,0,10
21132,2022/10/17,18,18,13,0,31
75,2022/10/18,45,36,32,0,77
76,2022/10/18,54,36,43,6,97
99,2022/10/18,14,0,1,0,15
117,2022/10/18,10,0,0,8,10
118,2022/10/18,11,4,1,0,12
119,2022/10/18,3,4,0,0,3
120,2022/10/18,3,4,1,0,4
149,2022/10/18,3,0,0,0,3
184,2022/10/18,12,9,1,0,13
195,2022/10/18,29,24,29,0,58
218,2022/10/18,22,21,23,0,45
296,2022/10/18,8,6,2,0,10
300,2022/10/18,5,0,2,0,7
304,2022/10/18,10,0,3,0,13
317,2022/10/18,19,0,5,6,24
343,2022/10/18,8,0,1,0,9
353,2022/10/18,8,0,0,0,8
373,2022/10/18,10,6,1,0,11
374,2022/10/18,8,8,3,0,11
388,2022/10/18,27,21,19,2,46
419,2022/10/18,18,12,7,0,25
420,2022/10/18,9,0,4,0,13
462,2022/10/18,15,8,12,0,27
519,2022/10/18,10,6,4,0,14
525,2022/10/18,5,0,1,0,6
596,2022/10/18,7,4,7,0,14
597,2022/10/18,16,12,13,0,29
598,2022/10/18,2,0,0,0,2
1035,2022/10/18,13,6,4,0,17
1084,2022/10/18,10,10,10,0,20
1111,2022/10/18,6,0,1,0,7
1112,2022/10/18,8,0,0,0,8
1113,2022/10/18,11,6,0,0,11
1114,2022/10/18,3,0,1,0,4
1115,2022/10/18,10,0,1,0,11
1117,2022/10/18,5,0,0,0,5
1119,2022/10/18,2,0,0,0,2
1692,2022/10/18,16,6,7,0,23
1693,2022/10/18,12,0,0,5,12
1747,2022/10/18,22,20,17,0,39
1772,2022/10/18,1,0,0,0,1
1773,2022/10/18,3,0,0,0,3
1774,2022/10/18,10,8,1,0,11
1782,2022/10/18,24,21,15,0,39
1795,2022/10/18,13,14,14,0,27
1914,2022/10/18,9,0,0,0,9
1915,2022/10/18,7,0,1,0,8
1923,2022/10/18,11,6,1,0,12
1934,2022/10/18,8,5,5,0,13
1963,2022/10/18,11,12,4,0,15
1984,2022/10/18,12,6,0,1,12
2135,2022/10/18,6,6,0,0,6
2136,2022/10/18,10,6,4,0,14
2148,2022/10/18,4,4,2,0,6
2183,2022/10/18,11,0,2,0,13
2193,2022/10/18,28,18,25,0,53
2237,2022/10/18,8,0,4,0,12
2358,2022/10/18,22,8,0,0,22
2361,2022/10/18,10,0,2,0,12
2445,2022/10/18,13,6,5,0,18
2449,2022/10/18,8,6,2,0,10
2451,2022/10/18,25,0,9,0,34
2475,2022/10/18,9,0,1,0,10
2476,2022/10/18,10,0,1,0,11
2507,2022/10/18,12,12,5,0,17
2525,2022/10/18,7,0,4,0,11
2562,2022/10/18,13,0,3,4,16
2582,2022/10/18,6,4,0,0,6
2586,2022/10/18,7,12,11,0,18
2631,2022/10/18,8,0,2,0,10
2685,2022/10/18,4,4,2,0,6
2723,2022/10/18,9,0,0,0,9
2730,2022/10/18,9,0,4,0,13
2731,2022/10/18,10,6,0,0,10
2732,2022/10/18,11,0,1,0,12
2734,2022/10/18,6,4,4,0,10
2735,2022/10/18,2,0,1,0,3
2761,2022/10/18,5,0,5,0,10
2788,2022/10/18,21,12,17,2,38
2812,2022/10/18,5,0,1,0,6
2813,2022/10/18,7,0,0,0,7
2814,2022/10/18,7,0,0,0,7
2913,2022/10/18,6,0,2,0,8
2914,2022/10/18,7,0,1,0,8
3015,2022/10/18,9,8,3,0,12
3033,2022/10/18,10,0,0,0,10
3035,2022/10/18,8,0,1,0,9
4446,2022/10/18,17,15,14,0,31
12136,2022/10/18,25,24,23,0,48
12516,2022/10/18,4,4,3,0,7
12518,2022/10/18,0,0,0,0,0
12523,2022/10/18,4,4,2,0,6
16062,2022/10/18,12,0,3,0,15
16063,2022/10/18,12,0,3,0,15
16276,2022/10/18,7,6,1,0,8
19329,2022/10/18,9,0,0,0,9
19521,2022/10/18,3,0,1,0,4
20901,2022/10/18,10,6,2,0,12
20920,2022/10/18,6,0,0,0,6
21132,2022/10/18,23,18,12,0,35
75,2022/10/19,49,36,37,0,86
76,2022/10/19,37,32,35,0,72
99,2022/10/19,13,0,0,0,13
117,2022/10/19,2,0,3,0,5
118,2022/10/19,14,4,4,0,18
119,2022/10/19,7,4,2,0,9
120,2022/10/19,2,0,0,0,2
149,2022/10/19,3,0,0,0,3
184,2022/10/19,20,9,15,0,35
195,2022/10/19,36,36,26,0,62
218,2022/10/19,23,24,27,0,50
296,2022/10/19,12,6,3,0,15
300,2022/10/19,11,8,2,0,13
304,2022/10/19,13,6,5,0,18
317,2022/10/19,14,6,2,2,16
343,2022/10/19,7,0,0,0,7
353,2022/10/19,8,0,0,0,8
373,2022/10/19,9,0,2,0,11
374,2022/10/19,5,0,6,0,11
388,2022/10/19,32,27,16,1,48
419,2022/10/19,11,0,5,0,16
420,2022/10/19,11,6,4,0,15
462,2022/10/19,11,8,12,0,23
519,2022/10/19,12,6,6,0,18
525,2022/10/19,4,0,4,0,8
596,2022/10/19,4,4,4,0,8
597,2022/10/19,15,12,12,0,27
598,2022/10/19,8,6,1,0,9
1035,2022/10/19,15,6,3,1,18
1084,2022/10/19,10,10,10,0,20
1111,2022/10/19,11,6,0,0,11
1112,2022/10/19,8,0,0,0,8
1113,2022/10/19,11,0,0,0,11
1114,2022/10/19,8,6,3,0,11
1115,2022/10/19,15,6,1,0,16
1117,2022/10/19,5,0,0,0,5
1119,2022/10/19,2,0,0,0,2
1692,2022/10/19,9,0,1,1,10
1693,2022/10/19,13,6,0,0,13
1747,2022/10/19,20,15,20,0,40
1772,2022/10/19,1,0,0,0,1
1773,2022/10/19,9,6,1,0,10
1774,2022/10/19,17,8,4,0,21
1782,2022/10/19,28,18,24,0,52
1795,2022/10/19,6,7,8,0,14
1915,2022/10/19,6,0,1,0,7
1923,2022/10/19,10,0,2,0,12
1934,2022/10/19,8,5,1,0,9
1963,2022/10/19,7,0,4,3,11
1984,2022/10/19,11,0,1,4,12
2135,2022/10/19,12,6,2,0,14
2136,2022/10/19,6,0,0,0,6
2148,2022/10/19,6,4,5,0,11
2183,2022/10/19,9,0,5,4,14
2193,2022/10/19,15,12,9,0,24
2237,2022/10/19,10,6,1,0,11
2358,2022/10/19,22,0,4,0,26
2361,2022/10/19,15,7,5,0,20
2445,2022/10/19,14,6,4,0,18
2449,2022/10/19,12,6,1,0,13
2451,2022/10/19,16,0,10,0,26
2475,2022/10/19,8,0,0,0,8
2476,2022/10/19,9,0,1,0,10
2507,2022/10/19,19,12,6,0,25
2525,2022/10/19,9,6,0,0,9
2562,2022/10/19,18,12,1,0,19
2582,2022/10/19,6,0,1,0,7
2586,2022/10/19,8,12,12,0,20
2631,2022/10/19,12,6,3,0,15
2685,2022/10/19,10,8,7,0,17
2723,2022/10/19,9,0,2,0,11
2730,2022/10/19,5,0,3,0,8
2731,2022/10/19,10,0,0,0,10
2732,2022/10/19,10,0,2,0,12
2734,2022/10/19,2,0,2,0,4
2735,2022/10/19,9,8,4,0,13
2761,2022/10/19,15,15,11,0,26
2788,2022/10/19,18,16,12,0,30
2812,2022/10/19,10,6,0,0,10
2813,2022/10/19,7,0,2,0,9
2913,2022/10/19,4,0,1,0,5
2914,2022/10/19,6,0,1,0,7
3015,2022/10/19,6,0,1,0,7
3033,2022/10/19,10,0,1,0,11
3035,2022/10/19,7,0,0,0,7
4446,2022/10/19,15,12,7,1,22
12136,2022/10/19,23,21,25,0,48
12516,2022/10/19,1,0,2,0,3
12518,2022/10/19,10,10,5,0,15
12523,2022/10/19,6,4,0,0,6
16062,2022/10/19,9,0,1,0,10
16063,2022/10/19,9,0,0,0,9
16276,2022/10/19,6,0,2,0,8
19329,2022/10/19,9,0,0,0,9
19521,2022/10/19,2,0,0,0,2
20901,2022/10/19,8,0,1,0,9
20920,2022/10/19,6,0,0,0,6
21132,2022/10/19,29,18,16,2,45
75,2022/10/20,26,24,27,0,53
76,2022/10/20,42,44,35,0,77
99,2022/10/20,13,0,0,0,13
117,2022/10/20,-1,0,1,0,0
118,2022/10/20,10,0,3,3,13
119,2022/10/20,5,0,0,0,5
120,2022/10/20,6,4,1,0,7
149,2022/10/20,9,6,0,0,9
184,2022/10/20,13,12,7,1,20
195,2022/10/20,35,24,29,1,64
218,2022/10/20,15,24,25,0,40
296,2022/10/20,15,6,5,0,20
300,2022/10/20,17,8,0,0,17
304,2022/10/20,14,6,2,0,16
317,2022/10/20,16,6,5,0,21
343,2022/10/20,7,0,0,0,7
353,2022/10/20,8,0,0,0,8
373,2022/10/20,13,6,2,0,15
374,2022/10/20,7,8,4,0,11
388,2022/10/20,18,30,26,6,44
419,2022/10/20,18,12,5,0,23
420,2022/10/20,7,0,2,0,9
462,2022/10/20,7,8,7,0,14
519,2022/10/20,18,12,6,0,24
525,2022/10/20,5,5,0,0,5
596,2022/10/20,8,8,9,0,17
597,2022/10/20,14,12,15,0,29
598,2022/10/20,7,0,1,0,8
1035,2022/10/20,11,0,3,0,14
1084,2022/10/20,6,5,6,0,12
1111,2022/10/20,11,0,1,0,12
1112,2022/10/20,8,0,1,0,9
1113,2022/10/20,11,0,0,0,11
1114,2022/10/20,11,6,2,0,13
1115,2022/10/20,14,0,0,0,14
1117,2022/10/20,5,0,2,0,7
1119,2022/10/20,8,6,0,0,8
1692,2022/10/20,7,0,2,0,9
1693,2022/10/20,13,0,1,0,14
1747,2022/10/20,19,20,19,0,38
1772,2022/10/20,9,8,2,0,11
1773,2022/10/20,8,0,0,0,8
1774,2022/10/20,13,0,3,0,16
1782,2022/10/20,14,15,18,0,32
1795,2022/10/20,5,7,8,0,13
1915,2022/10/20,5,0,3,0,8
1923,2022/10/20,8,0,1,0,9
1934,2022/10/20,6,0,3,0,9
1963,2022/10/20,12,12,5,0,17
1984,2022/10/20,6,0,0,0,6
2135,2022/10/20,10,0,0,0,10
2136,2022/10/20,6,0,0,0,6
2148,2022/10/20,9,8,5,0,14
2183,2022/10/20,0,0,0,0,0
2193,2022/10/20,16,15,15,0,31
2237,2022/10/20,9,0,5,0,14
2358,2022/10/20,18,0,4,0,22
2361,2022/10/20,16,7,3,0,19
2445,2022/10/20,10,0,8,0,18
2449,2022/10/20,17,6,1,0,18
2451,2022/10/20,14,10,6,0,20
2475,2022/10/20,8,0,0,0,8
2476,2022/10/20,8,0,1,0,9
2507,2022/10/20,9,12,6,0,15
2525,2022/10/20,9,0,0,0,9
2562,2022/10/20,17,0,2,0,19
2582,2022/10/20,9,4,3,0,12
2586,2022/10/20,16,16,18,0,34
2631,2022/10/20,9,0,4,0,13
2685,2022/10/20,10,8,9,0,19
2723,2022/10/20,7,0,1,0,8
2730,2022/10/20,2,0,0,0,2
2731,2022/10/20,10,0,2,0,12
2732,2022/10/20,8,0,0,0,8
2734,2022/10/20,4,4,2,0,6
2735,2022/10/20,5,0,4,0,9
2761,2022/10/20,19,15,20,0,39
2788,2022/10/20,17,12,17,0,34
2802,2022/10/20,9,0,2,0,11
2812,2022/10/20,10,0,1,0,11
2813,2022/10/20,5,0,0,0,5
2913,2022/10/20,3,0,2,0,5
2914,2022/10/20,5,0,0,0,5
3015,2022/10/20,5,0,1,0,6
3033,2022/10/20,9,0,0,0,9
3035,2022/10/20,7,0,0,0,7
4446,2022/10/20,22,15,19,0,41
12136,2022/10/20,14,18,17,0,31
12516,2022/10/20,3,4,2,0,5
12518,2022/10/20,5,0,0,0,5
12523,2022/10/20,10,4,3,0,13
16062,2022/10/20,8,0,2,0,10
16063,2022/10/20,9,0,1,0,10
16276,2022/10/20,10,6,0,0,10
19322,2022/10/20,9,0,0,0,9
19329,2022/10/20,9,0,1,0,10
19521,2022/10/20,2,0,0,0,2
20901,2022/10/20,7,0,0,0,7
20920,2022/10/20,6,0,1,0,7
21132,2022/10/20,26,15,19,3,45
75,2022/10/21,39,40,39,0,78
76,2022/10/21,38,32,42,3,80
99,2022/10/21,13,0,2,0,15
117,2022/10/21,-2,0,1,0,-1
118,2022/10/21,4,0,3,0,7
119,2022/10/21,5,0,0,0,5
120,2022/10/21,9,4,1,0,10
149,2022/10/21,9,0,3,0,12
184,2022/10/21,17,12,16,0,33
195,2022/10/21,26,21,23,1,49
218,2022/10/21,14,24,23,0,37
296,2022/10/21,16,6,2,0,18
300,2022/10/21,17,0,2,0,19
304,2022/10/21,12,0,3,0,15
317,2022/10/21,11,0,6,0,17
343,2022/10/21,11,4,3,0,14
353,2022/10/21,8,0,1,0,9
373,2022/10/21,17,6,2,0,19
374,2022/10/21,3,0,2,0,5
388,2022/10/21,-5,9,18,2,13
419,2022/10/21,19,6,6,0,25
420,2022/10/21,11,6,3,0,14
462,2022/10/21,8,8,0,0,8
519,2022/10/21,24,12,13,0,37
525,2022/10/21,5,0,1,0,6
596,2022/10/21,11,12,5,0,16
597,2022/10/21,29,30,14,0,43
598,2022/10/21,12,6,0,0,12
1035,2022/10/21,14,6,6,0,20
1084,2022/10/21,20,20,19,0,39
1111,2022/10/21,10,0,0,0,10
1112,2022/10/21,7,0,0,0,7
1113,2022/10/21,11,0,0,0,11
1114,2022/10/21,9,0,4,0,13
1115,2022/10/21,14,0,2,0,16
1117,2022/10/21,3,0,0,0,3
1119,2022/10/21,8,0,1,0,9
1692,2022/10/21,11,6,3,0,14
1693,2022/10/21,12,0,0,0,12
1747,2022/10/21,20,20,22,0,42
1772,2022/10/21,15,8,0,0,15
1773,2022/10/21,8,0,1,0,9
1774,2022/10/21,10,0,5,0,15
1782,2022/10/21,14,18,19,0,33
1795,2022/10/21,18,21,18,0,36
1915,2022/10/21,2,0,0,0,2
1923,2022/10/21,7,0,6,0,13
1934,2022/10/21,3,0,1,1,4
1963,2022/10/21,19,12,4,0,23
1984,2022/10/21,12,6,6,0,18
2135,2022/10/21,10,0,2,0,12
2136,2022/10/21,12,6,2,0,14
2148,2022/10/21,8,4,8,0,16
2183,2022/10/21,6,6,3,0,9
2193,2022/10/21,10,9,11,0,21
2237,2022/10/21,4,0,3,0,7
2358,2022/10/21,22,8,5,0,27
2361,2022/10/21,13,0,4,5,17
2445,2022/10/21,8,6,8,0,16
2449,2022/10/21,22,6,5,0,27
2451,2022/10/21,18,10,10,0,28
2475,2022/10/21,8,0,2,0,10
2476,2022/10/21,7,0,0,0,7
2507,2022/10/21,15,12,10,0,25
2525,2022/10/21,9,0,2,0,11
2562,2022/10/21,15,0,0,0,15
2582,2022/10/21,6,0,4,0,10
2586,2022/10/21,15,16,16,0,31
2631,2022/10/21,11,6,10,0,21
2685,2022/10/21,9,8,7,0,16
2723,2022/10/21,6,0,1,0,7
2730,2022/10/21,8,6,0,0,8
2731,2022/10/21,8,0,0,0,8
2732,2022/10/21,8,0,2,0,10
2734,2022/10/21,2,0,1,0,3
2735,2022/10/21,9,8,2,0,11
2761,2022/10/21,15,15,15,0,30
2788,2022/10/21,16,16,17,0,33
2802,2022/10/21,7,0,0,0,7
2812,2022/10/21,9,0,3,0,12
2813,2022/10/21,5,0,0,0,5
2913,2022/10/21,7,6,4,0,11
2914,2022/10/21,5,0,1,0,6
3015,2022/10/21,12,8,2,0,14
3033,2022/10/21,9,0,0,0,9
3035,2022/10/21,7,0,0,0,7
4446,2022/10/21,15,12,16,0,31
12136,2022/10/21,18,21,18,0,36
12516,2022/10/21,1,0,2,0,3
12518,2022/10/21,15,10,1,0,16
12523,2022/10/21,11,4,3,0,14
16062,2022/10/21,12,6,0,0,12
16063,2022/10/21,8,0,0,0,8
16276,2022/10/21,10,0,0,0,10
19322,2022/10/21,9,0,0,0,9
19329,2022/10/21,8,0,0,0,8
19521,2022/10/21,10,8,2,0,12
20901,2022/10/21,7,0,3,0,10
20920,2022/10/21,5,0,0,0,5
21132,2022/10/21,19,15,16,0,35
75,2022/10/22,20,20,19,0,39
76,2022/10/22,17,24,24,0,41
99,2022/10/22,11,0,0,0,11
117,2022/10/22,3,4,1,0,4
118,2022/10/22,1,0,0,0,1
119,2022/10/22,9,4,0,0,9
120,2022/10/22,12,4,2,2,14
149,2022/10/22,6,0,1,0,7
184,2022/10/22,1,0,2,0,3
195,2022/10/22,26,24,22,0,48
218,2022/10/22,9,18,17,0,26
296,2022/10/22,14,0,5,0,19
300,2022/10/22,23,8,7,0,30
304,2022/10/22,9,0,2,0,11
317,2022/10/22,11,6,1,0,12
343,2022/10/22,9,0,0,0,9
353,2022/10/22,7,0,0,0,7
373,2022/10/22,21,6,6,0,27
374,2022/10/22,5,4,2,0,7
388,2022/10/22,-6,12,12,0,6
419,2022/10/22,19,6,4,0,23
420,2022/10/22,8,0,2,0,10
462,2022/10/22,16,8,2,0,18
519,2022/10/22,17,6,11,0,28
525,2022/10/22,4,0,1,0,5
596,2022/10/22,6,0,5,0,11
597,2022/10/22,15,0,15,0,30
598,2022/10/22,12,0,1,0,13
1035,2022/10/22,14,6,7,0,21
1084,2022/10/22,1,0,2,0,3
1111,2022/10/22,10,0,1,0,11
1112,2022/10/22,7,0,0,0,7
1113,2022/10/22,11,0,2,0,13
1114,2022/10/22,5,0,3,0,8
1115,2022/10/22,12,0,4,0,16
1117,2022/10/22,3,0,0,0,3
1119,2022/10/22,7,0,1,0,8
1692,2022/10/22,14,6,1,0,15
1693,2022/10/22,12,0,0,0,12
1747,2022/10/22,18,20,20,0,38
1772,2022/10/22,15,0,4,0,19
1773,2022/10/22,7,0,0,0,7
1774,2022/10/22,5,0,2,0,7
1782,2022/10/22,4,9,9,0,13
1795,2022/10/22,28,28,16,0,44
1914,2022/10/22,9,0,1,0,10
1915,2022/10/22,2,0,1,0,3
1923,2022/10/22,1,0,1,0,2
1934,2022/10/22,6,5,1,1,7
1963,2022/10/22,27,12,2,0,29
1984,2022/10/22,6,0,5,0,11
2135,2022/10/22,14,6,3,0,17
2136,2022/10/22,10,0,2,0,12
2148,2022/10/22,0,0,0,0,0
2183,2022/10/22,3,0,3,0,6
2193,2022/10/22,11,12,7,1,18
2237,2022/10/22,1,0,0,0,1
2358,2022/10/22,17,0,1,0,18
2361,2022/10/22,4,0,2,0,6
2445,2022/10/22,6,6,6,0,12
2449,2022/10/22,23,6,1,1,24
2451,2022/10/22,8,0,2,0,10
2475,2022/10/22,6,0,0,0,6
2476,2022/10/22,7,0,0,0,7
2507,2022/10/22,17,12,12,0,29
2525,2022/10/22,7,0,3,0,10
2562,2022/10/22,21,6,0,0,21
2582,2022/10/22,6,4,2,0,8
2586,2022/10/22,10,12,10,0,20
2631,2022/10/22,7,6,3,0,10
2685,2022/10/22,10,8,7,0,17
2723,2022/10/22,5,0,1,0,6
2730,2022/10/22,8,0,7,0,15
2731,2022/10/22,8,0,4,0,12
2732,2022/10/22,6,0,1,0,7
2734,2022/10/22,5,4,1,0,6
2735,2022/10/22,7,0,5,0,12
2761,2022/10/22,19,20,15,0,34
2788,2022/10/22,7,8,7,0,14
2802,2022/10/22,7,0,0,0,7
2812,2022/10/22,6,0,0,0,6
2813,2022/10/22,11,6,1,0,12
2913,2022/10/22,3,0,2,0,5
2914,2022/10/22,4,0,1,0,5
3015,2022/10/22,10,0,4,0,14
3033,2022/10/22,9,0,1,0,10
3035,2022/10/22,7,0,1,0,8
4446,2022/10/22,5,6,5,0,10
12136,2022/10/22,18,18,19,0,37
12516,2022/10/22,3,4,3,0,6
12518,2022/10/22,14,0,0,0,14
12523,2022/10/22,12,4,5,0,17
16062,2022/10/22,12,0,4,0,16
16063,2022/10/22,8,0,4,0,12
16276,2022/10/22,10,0,2,0,12
19322,2022/10/22,9,0,0,0,9
19329,2022/10/22,8,0,0,0,8
19521,2022/10/22,8,0,1,0,9
20901,2022/10/22,4,0,1,0,5
20920,2022/10/22,5,0,0,0,5
21132,2022/10/22,15,12,12,0,27
75,2022/10/23,25,24,29,0,54
76,2022/10/23,21,28,28,0,49
99,2022/10/23,11,0,0,0,11
117,2022/10/23,6,4,4,0,10
118,2022/10/23,1,0,0,0,1
119,2022/10/23,9,0,2,4,11
120,2022/10/23,8,0,2,0,10
149,2022/10/23,5,0,0,0,5
184,2022/10/23,8,9,9,0,17
195,2022/10/23,19,15,17,0,36
218,2022/10/23,13,21,21,0,34
296,2022/10/23,15,6,4,2,19
300,2022/10/23,16,0,4,0,20
304,2022/10/23,13,6,7,4,20
317,2022/10/23,16,6,5,1,21
343,2022/10/23,8,0,2,1,10
353,2022/10/23,7,0,0,0,7
373,2022/10/23,15,0,3,0,18
374,2022/10/23,15,12,3,0,18
388,2022/10/23,3,21,20,0,23
419,2022/10/23,21,6,4,0,25
420,2022/10/23,12,6,0,0,12
462,2022/10/23,30,16,11,2,41
519,2022/10/23,6,0,4,0,10
525,2022/10/23,8,5,1,0,9
596,2022/10/23,5,4,3,0,8
597,2022/10/23,12,12,14,0,26
598,2022/10/23,17,6,4,0,21
1035,2022/10/23,13,6,2,1,15
1084,2022/10/23,9,10,4,0,13
1111,2022/10/23,9,0,2,0,11
1112,2022/10/23,7,0,0,0,7
1113,2022/10/23,9,0,2,0,11
1114,2022/10/23,2,0,0,0,2
1115,2022/10/23,8,0,6,0,14
1117,2022/10/23,3,0,0,0,3
1119,2022/10/23,6,0,1,0,7
1692,2022/10/23,13,0,2,0,15
1693,2022/10/23,18,6,2,0,20
1747,2022/10/23,18,20,15,0,33
1772,2022/10/23,11,0,3,0,14
1773,2022/10/23,7,0,2,0,9
1774,2022/10/23,3,0,1,0,4
1782,2022/10/23,16,21,21,0,37
1795,2022/10/23,12,0,10,0,22
1914,2022/10/23,8,0,0,0,8
1915,2022/10/23,1,0,0,0,1
1923,2022/10/23,0,0,1,0,1
1934,2022/10/23,9,5,2,0,11
1963,2022/10/23,37,12,7,0,44
1984,2022/10/23,7,6,4,0,11
2135,2022/10/23,11,0,6,0,17
2136,2022/10/23,8,0,0,0,8
2148,2022/10/23,4,4,3,0,7
2183,2022/10/23,6,6,3,0,9
2193,2022/10/23,12,9,12,1,24
2237,2022/10/23,1,0,0,0,1
2358,2022/10/23,24,8,7,5,31
2361,2022/10/23,9,7,3,0,12
2445,2022/10/23,6,6,6,0,12
2449,2022/10/23,21,0,2,0,23
2451,2022/10/23,36,30,13,0,49
2475,2022/10/23,6,0,0,0,6
2476,2022/10/23,7,0,3,0,10
2507,2022/10/23,17,12,16,2,33
2525,2022/10/23,4,0,3,0,7
2562,2022/10/23,21,0,3,2,24
2582,2022/10/23,4,0,2,0,6
2586,2022/10/23,8,8,9,0,17
2631,2022/10/23,4,0,2,0,6
2685,2022/10/23,11,8,5,0,16
2723,2022/10/23,4,0,3,0,7
2730,2022/10/23,1,0,3,0,4
2731,2022/10/23,4,0,1,0,5
2732,2022/10/23,5,0,1,0,6
2734,2022/10/23,12,8,1,0,13
2735,2022/10/23,10,8,2,0,12
2761,2022/10/23,14,10,14,0,28
2788,2022/10/23,16,16,16,0,32
2802,2022/10/23,7,0,2,0,9
2812,2022/10/23,6,0,0,0,6
2813,2022/10/23,10,0,2,0,12
2913,2022/10/23,1,0,0,0,1
2914,2022/10/23,3,0,2,0,5
3015,2022/10/23,6,0,3,0,9
3033,2022/10/23,8,0,0,0,8
3035,2022/10/23,6,0,3,0,9
4446,2022/10/23,6,6,6,0,12
12136,2022/10/23,20,21,19,0,39
12516,2022/10/23,8,8,2,0,10
12518,2022/10/23,24,10,3,0,27
12523,2022/10/23,15,8,2,0,17
16062,2022/10/23,8,0,10,0,18
16063,2022/10/23,4,0,1,0,5
16276,2022/10/23,8,0,2,0,10
19322,2022/10/23,9,0,0,0,9
19329,2022/10/23,8,0,1,0,9
19521,2022/10/23,7,0,1,0,8
20901,2022/10/23,3,0,1,0,4
20920,2022/10/23,5,0,0,0,5
21132,2022/10/23,12,9,9,0,21
75,2022/10/24,32,36,34,0,66
76,2022/10/24,37,44,34,1,71
99,2022/10/24,11,0,0,0,11
117,2022/10/24,6,4,1,0,7
118,2022/10/24,5,4,2,0,7
119,2022/10/24,3,0,4,0,7
120,2022/10/24,6,0,1,3,7
149,2022/10/24,11,6,0,0,11
184,2022/10/24,5,6,3,0,8
195,2022/10/24,26,24,23,0,49
218,2022/10/24,16,24,23,0,39
296,2022/10/24,9,0,7,0,16
300,2022/10/24,12,0,8,0,20
304,2022/10/24,2,0,1,0,3
317,2022/10/24,16,6,4,0,20
343,2022/10/24,5,0,1,0,6
353,2022/10/24,7,0,0,0,7
373,2022/10/24,18,6,5,5,23
374,2022/10/24,12,0,2,0,14
388,2022/10/24,4,21,23,0,27
419,2022/10/24,23,6,9,0,32
420,2022/10/24,18,6,4,0,22
462,2022/10/24,25,8,14,0,39
519,2022/10/24,8,6,6,0,14
525,2022/10/24,12,5,2,0,14
596,2022/10/24,6,4,4,0,10
597,2022/10/24,10,12,8,0,18
598,2022/10/24,13,0,0,0,13
1035,2022/10/24,16,6,5,0,21
1084,2022/10/24,15,10,3,0,18
1111,2022/10/24,7,0,2,0,9
1112,2022/10/24,7,0,0,0,7
1113,2022/10/24,7,0,1,0,8
1114,2022/10/24,8,6,4,0,12
1115,2022/10/24,2,0,0,0,2
1117,2022/10/24,11,8,1,0,12
1119,2022/10/24,11,6,0,0,11
1692,2022/10/24,11,0,4,0,15
1693,2022/10/24,16,0,2,0,18
1747,2022/10/24,23,20,23,0,46
1772,2022/10/24,8,0,2,0,10
1773,2022/10/24,17,12,0,0,17
1774,2022/10/24,10,8,0,0,10
1782,2022/10/24,13,18,17,1,30
1795,2022/10/24,16,14,9,0,25
1915,2022/10/24,7,6,0,0,7
1923,2022/10/24,5,6,2,0,7
1934,2022/10/24,12,5,5,0,17
1963,2022/10/24,36,6,9,2,45
1984,2022/10/24,3,0,1,0,4
2135,2022/10/24,11,6,0,0,11
2136,2022/10/24,8,0,0,0,8
2148,2022/10/24,1,0,1,0,2
2183,2022/10/24,9,6,0,0,9
2193,2022/10/24,14,15,14,0,28
2237,2022/10/24,13,12,2,0,15
2358,2022/10/24,12,0,4,0,16
2361,2022/10/24,6,0,3,0,9
2445,2022/10/24,6,6,3,0,9
2449,2022/10/24,19,0,2,0,21
2451,2022/10/24,23,0,9,0,32
2475,2022/10/24,6,0,1,0,7
2476,2022/10/24,4,0,0,0,4
2507,2022/10/24,5,6,5,1,10
2525,2022/10/24,7,6,1,0,8
2562,2022/10/24,16,0,1,0,17
2582,2022/10/24,2,0,2,0,4
2586,2022/10/24,15,16,2,0,17
2631,2022/10/24,2,0,0,0,2
2685,2022/10/24,10,4,9,0,19
2723,2022/10/24,1,0,0,0,1
2730,2022/10/24,-2,0,1,0,-1
2731,2022/10/24,3,0,0,0,3
2732,2022/10/24,4,0,5,0,9
2734,2022/10/24,11,0,4,0,15
2735,2022/10/24,8,0,7,0,15
2761,2022/10/24,15,15,9,1,24
2788,2022/10/24,16,16,12,0,28
2802,2022/10/24,5,0,0,0,5
2812,2022/10/24,6,0,1,0,7
2813,2022/10/24,8,0,0,0,8
2913,2022/10/24,7,6,0,0,7
2914,2022/10/24,7,6,0,0,7
3015,2022/10/24,3,0,1,0,4
3033,2022/10/24,8,0,0,0,8
3035,2022/10/24,3,0,0,0,3
4446,2022/10/24,15,15,14,0,29
12136,2022/10/24,19,18,20,0,39
12516,2022/10/24,6,0,2,0,8
12518,2022/10/24,21,0,3,0,24
12523,2022/10/24,13,0,2,0,15
16062,2022/10/24,-2,0,0,0,-2
16063,2022/10/24,3,0,2,0,5
16276,2022/10/24,6,0,1,0,7
19329,2022/10/24,7,0,0,0,7
19521,2022/10/24,6,0,0,0,6
20901,2022/10/24,8,6,1,0,9
20920,2022/10/24,17,12,2,0,19
21132,2022/10/24,18,15,14,0,32
75,2022/10/25,34,36,34,0,68
76,2022/10/25,42,40,33,3,75
99,2022/10/25,11,0,1,0,12
117,2022/10/25,5,0,0,0,5
118,2022/10/25,7,4,3,0,10
119,2022/10/25,-1,0,0,0,-1
120,2022/10/25,2,0,0,0,2
149,2022/10/25,11,0,1,0,12
184,2022/10/25,11,9,4,0,15
195,2022/10/25,33,30,29,1,62
218,2022/10/25,20,27,27,0,47
296,2022/10/25,2,0,1,0,3
300,2022/10/25,4,0,1,0,5
304,2022/10/25,7,6,4,0,11
317,2022/10/25,18,6,4,3,22
343,2022/10/25,4,0,0,0,4
353,2022/10/25,7,0,0,0,7
373,2022/10/25,8,0,1,0,9
374,2022/10/25,14,4,6,0,20
388,2022/10/25,5,24,23,0,28
419,2022/10/25,20,6,3,0,23
420,2022/10/25,14,0,0,0,14
462,2022/10/25,19,8,7,0,26
519,2022/10/25,8,6,2,0,10
525,2022/10/25,10,0,0,0,10
596,2022/10/25,10,8,4,0,14
597,2022/10/25,14,12,8,0,22
598,2022/10/25,13,0,0,0,13
1035,2022/10/25,11,0,3,0,14
1084,2022/10/25,22,10,9,0,31
1111,2022/10/25,5,0,0,0,5
1112,2022/10/25,7,0,1,0,8
1113,2022/10/25,6,0,1,0,7
1114,2022/10/25,10,6,6,0,16
1115,2022/10/25,8,6,1,0,9
1117,2022/10/25,18,8,0,0,18
1119,2022/10/25,11,0,0,0,11
1692,2022/10/25,13,6,0,0,13
1693,2022/10/25,14,0,1,2,15
1747,2022/10/25,20,20,20,0,40
1772,2022/10/25,6,0,0,0,6
1773,2022/10/25,17,0,0,0,17
1774,2022/10/25,10,0,2,0,12
1782,2022/10/25,13,18,17,0,30
1795,2022/10/25,21,14,10,0,31
1915,2022/10/25,13,6,1,0,14
1923,2022/10/25,3,0,0,0,3
1934,2022/10/25,12,5,3,2,15
1963,2022/10/25,31,6,5,0,36
1984,2022/10/25,8,6,0,0,8
2135,2022/10/25,11,0,0,0,11
2136,2022/10/25,8,0,0,0,8
2148,2022/10/25,4,4,1,0,5
2183,2022/10/25,9,0,0,0,9
2193,2022/10/25,15,15,11,0,26
2237,2022/10/25,17,6,4,0,21
2358,2022/10/25,8,0,7,0,15
2361,2022/10/25,10,7,0,0,10
2445,2022/10/25,9,6,4,0,13
2449,2022/10/25,17,0,1,9,18
2451,2022/10/25,14,0,10,0,24
2475,2022/10/25,5,0,0,0,5
2476,2022/10/25,4,0,0,0,4
2507,2022/10/25,5,6,13,0,18
2525,2022/10/25,6,0,2,1,8
2562,2022/10/25,21,6,3,0,24
2582,2022/10/25,4,4,2,0,6
2586,2022/10/25,29,16,18,0,47
2631,2022/10/25,8,6,3,0,11
2685,2022/10/25,9,8,5,0,14
2723,2022/10/25,9,8,0,0,9
2730,2022/10/25,3,6,1,0,4
2731,2022/10/25,9,6,1,0,10
2732,2022/10/25,7,8,1,0,8
2734,2022/10/25,11,4,3,0,14
2735,2022/10/25,9,8,5,0,14
2761,2022/10/25,20,15,9,0,29
2788,2022/10/25,20,16,19,1,39
2802,2022/10/25,5,0,0,0,5
2812,2022/10/25,5,0,0,0,5
2813,2022/10/25,8,0,2,0,10
2913,2022/10/25,7,0,1,0,8
2914,2022/10/25,7,0,0,0,7
3015,2022/10/25,10,8,2,0,12
3033,2022/10/25,8,0,0,0,8
3035,2022/10/25,3,0,0,0,3
4446,2022/10/25,13,12,14,0,27
12136,2022/10/25,23,24,24,0,47
12516,2022/10/25,8,4,0,0,8
12518,2022/10/25,18,0,2,0,20
12523,2022/10/25,15,4,5,0,20
16062,2022/10/25,4,6,0,0,4
16063,2022/10/25,7,6,0,0,7
16276,2022/10/25,5,0,1,0,6
19521,2022/10/25,6,0,1,0,7
20901,2022/10/25,7,0,0,0,7
20920,2022/10/25,15,0,1,0,16
21132,2022/10/25,19,15,14,0,33
21171,2022/10/25,4,4,1,0,5
21174,2022/10/25,8,8,8,0,16
21175,2022/10/25,8,8,6,0,14
21176,2022/10/25,8,8,6,0,14
75,2022/10/26,36,36,38,0,74
76,2022/10/26,46,40,45,4,91
99,2022/10/26,10,0,0,0,10
117,2022/10/26,9,4,2,0,11
118,2022/10/26,8,4,2,0,10
119,2022/10/26,-1,0,1,0,0
120,2022/10/26,6,4,3,1,9
149,2022/10/26,10,0,0,0,10
184,2022/10/26,16,9,12,0,28
195,2022/10/26,32,30,33,0,65
218,2022/10/26,20,27,32,0,52
296,2022/10/26,7,6,2,0,9
300,2022/10/26,11,8,5,0,16
304,2022/10/26,9,6,6,0,15
317,2022/10/26,17,6,2,0,19
343,2022/10/26,8,4,3,0,11
353,2022/10/26,7,0,1,0,8
373,2022/10/26,7,0,2,0,9
374,2022/10/26,12,4,4,0,16
388,2022/10/26,3,21,16,0,19
419,2022/10/26,23,6,6,0,29
420,2022/10/26,14,0,3,0,17
462,2022/10/26,12,0,8,0,20
519,2022/10/26,18,12,2,0,20
525,2022/10/26,10,0,1,0,11
596,2022/10/26,14,8,7,0,21
597,2022/10/26,18,12,15,0,33
598,2022/10/26,13,0,1,0,14
1035,2022/10/26,8,0,6,0,14
1084,2022/10/26,23,10,11,0,34
1111,2022/10/26,5,0,0,0,5
1112,2022/10/26,6,0,0,0,6
1113,2022/10/26,11,6,0,0,11
1114,2022/10/26,4,0,2,0,6
1115,2022/10/26,7,0,3,0,10
1117,2022/10/26,18,0,0,0,18
1119,2022/10/26,11,0,0,0,11
1692,2022/10/26,13,0,1,0,14
1693,2022/10/26,11,0,1,0,12
1747,2022/10/26,20,20,20,1,40
1772,2022/10/26,14,8,0,0,14
1773,2022/10/26,17,0,2,0,19
1774,2022/10/26,8,0,1,0,9
1782,2022/10/26,17,21,26,0,43
1795,2022/10/26,25,14,9,0,34
1915,2022/10/26,12,0,2,0,14
1923,2022/10/26,9,6,4,0,13
1934,2022/10/26,7,0,3,0,10
1963,2022/10/26,26,0,5,0,31
1984,2022/10/26,14,6,0,2,14
2135,2022/10/26,17,6,1,0,18
2136,2022/10/26,14,6,1,0,15
2148,2022/10/26,7,4,4,0,11
2183,2022/10/26,15,6,2,0,17
2193,2022/10/26,16,12,14,0,30
2237,2022/10/26,13,0,1,0,14
2358,2022/10/26,1,0,0,0,1
2361,2022/10/26,17,7,7,0,24
2445,2022/10/26,11,6,5,0,16
2449,2022/10/26,7,0,4,0,11
2451,2022/10/26,4,0,0,0,4
2475,2022/10/26,5,0,1,0,6
2476,2022/10/26,10,6,1,0,11
2507,2022/10/26,-2,6,8,5,6
2525,2022/10/26,9,6,2,0,11
2562,2022/10/26,18,0,4,0,22
2582,2022/10/26,6,4,1,0,7
2586,2022/10/26,27,16,10,0,37
2631,2022/10/26,11,6,1,0,12
2685,2022/10/26,12,8,4,0,16
2723,2022/10/26,9,0,3,0,12
2730,2022/10/26,8,6,1,0,9
2731,2022/10/26,8,0,0,0,8
2732,2022/10/26,6,0,0,0,6
2734,2022/10/26,8,0,3,0,11
2735,2022/10/26,4,0,3,0,7
2761,2022/10/26,26,15,13,0,39
2788,2022/10/26,12,12,13,0,25
2802,2022/10/26,11,6,0,0,11
2812,2022/10/26,5,0,0,0,5
2813,2022/10/26,6,0,1,0,7
2913,2022/10/26,12,6,0,0,12
2914,2022/10/26,7,0,0,0,7
3015,2022/10/26,8,0,3,0,11
3033,2022/10/26,8,0,0,0,8
3035,2022/10/26,9,6,2,0,11
4446,2022/10/26,5,6,8,0,13
12136,2022/10/26,20,21,20,0,40
12516,2022/10/26,12,4,6,0,18
12518,2022/10/26,16,0,2,0,18
12523,2022/10/26,14,4,1,0,15
16062,2022/10/26,10,6,1,0,11
16063,2022/10/26,7,0,1,0,8
16276,2022/10/26,4,0,3,0,7
19521,2022/10/26,5,0,1,0,6
20901,2022/10/26,7,0,0,0,7
20920,2022/10/26,14,0,0,0,14
21132,2022/10/26,23,18,20,0,43
21171,2022/10/26,7,4,0,0,7
21174,2022/10/26,8,8,6,0,14
21175,2022/10/26,10,8,8,0,18
21176,2022/10/26,10,8,10,0,20
75,2022/10/27,30,32,30,0,60
76,2022/10/27,37,40,53,1,90
99,2022/10/27,10,0,0,0,10
117,2022/10/27,7,0,2,0,9
118,2022/10/27,10,4,2,0,12
119,2022/10/27,2,4,0,0,2
120,2022/10/27,2,0,1,0,3
149,2022/10/27,10,0,1,0,11
184,2022/10/27,16,12,12,0,28
195,2022/10/27,30,30,31,2,61
218,2022/10/27,12,24,17,0,29
296,2022/10/27,11,6,5,0,16
300,2022/10/27,6,0,4,0,10
304,2022/10/27,9,6,1,0,10
317,2022/10/27,21,6,6,0,27
343,2022/10/27,5,0,1,0,6
353,2022/10/27,6,0,1,0,7
373,2022/10/27,11,6,4,0,15
374,2022/10/27,8,0,2,0,10
388,2022/10/27,14,27,28,2,42
419,2022/10/27,17,0,3,0,20
420,2022/10/27,11,0,3,0,14
462,2022/10/27,4,0,11,0,15
519,2022/10/27,22,6,14,0,36
525,2022/10/27,9,0,1,0,10
596,2022/10/27,15,8,5,0,20
597,2022/10/27,21,18,18,0,39
598,2022/10/27,12,0,4,0,16
1035,2022/10/27,8,6,6,0,14
1084,2022/10/27,17,5,6,0,23
1111,2022/10/27,11,6,2,0,13
1112,2022/10/27,6,0,2,0,8
1113,2022/10/27,11,0,0,0,11
1114,2022/10/27,8,6,0,0,8
1115,2022/10/27,10,6,1,0,11
1117,2022/10/27,18,0,1,0,19
1119,2022/10/27,11,0,1,0,12
1692,2022/10/27,12,0,0,0,12
1693,2022/10/27,10,0,0,4,10
1747,2022/10/27,19,20,22,0,41
1772,2022/10/27,13,0,0,1,13
1773,2022/10/27,15,0,1,0,16
1774,2022/10/27,7,0,3,0,10
1782,2022/10/27,12,21,15,0,27
1795,2022/10/27,30,14,9,0,39
1915,2022/10/27,10,0,0,0,10
1923,2022/10/27,11,6,5,0,16
1934,2022/10/27,4,0,3,0,7
1963,2022/10/27,27,6,6,12,33
1984,2022/10/27,12,0,7,0,19
2135,2022/10/27,16,0,2,0,18
2136,2022/10/27,13,0,0,0,13
2148,2022/10/27,11,8,4,0,15
2183,2022/10/27,13,0,4,0,17
2193,2022/10/27,20,18,15,1,35
2237,2022/10/27,12,0,2,0,14
2358,2022/10/27,9,8,7,0,16
2361,2022/10/27,10,0,3,0,13
2445,2022/10/27,12,6,5,0,17
2449,2022/10/27,3,0,0,0,3
2451,2022/10/27,14,10,12,0,26
2475,2022/10/27,10,6,0,0,10
2476,2022/10/27,9,0,1,0,10
2507,2022/10/27,-3,12,7,0,4
2525,2022/10/27,7,0,2,0,9
2562,2022/10/27,14,0,0,0,14
2582,2022/10/27,5,0,1,0,6
2586,2022/10/27,33,16,12,6,45
2631,2022/10/27,10,0,4,0,14
2685,2022/10/27,16,8,6,0,22
2723,2022/10/27,6,0,1,0,7
2730,2022/10/27,13,6,3,0,16
2731,2022/10/27,8,0,1,0,9
2732,2022/10/27,14,8,1,0,15
2734,2022/10/27,5,0,2,0,7
2735,2022/10/27,1,0,0,0,1
2761,2022/10/27,33,20,18,0,51
2788,2022/10/27,19,20,19,0,38
2802,2022/10/27,11,0,1,0,12
2812,2022/10/27,11,6,2,0,13
2813,2022/10/27,5,0,2,0,7
2913,2022/10/27,12,0,1,0,13
2914,2022/10/27,13,6,0,0,13
3015,2022/10/27,5,0,0,0,5
3033,2022/10/27,8,0,0,0,8
3035,2022/10/27,7,0,1,0,8
4446,2022/10/27,15,18,14,0,29
12136,2022/10/27,18,18,25,0,43
12516,2022/10/27,6,0,1,0,7
12518,2022/10/27,14,0,3,0,17
12523,2022/10/27,13,0,5,0,18
16062,2022/10/27,9,0,1,0,10
16063,2022/10/27,6,0,1,0,7
16276,2022/10/27,7,6,0,0,7
19322,2022/10/27,9,0,2,0,11
19521,2022/10/27,4,0,0,0,4
20901,2022/10/27,7,0,0,0,7
20920,2022/10/27,14,0,0,0,14
21132,2022/10/27,18,15,15,1,33
21171,2022/10/27,11,4,3,0,14
21174,2022/10/27,10,8,5,0,15
21175,2022/10/27,10,8,6,1,16
21176,2022/10/27,8,8,7,0,15
75,2022/10/28,40,40,39,0,79
76,2022/10/28,23,40,19,0,42
99,2022/10/28,10,0,0,0,10
117,2022/10/28,9,4,1,1,10
118,2022/10/28,12,4,0,0,12
119,2022/10/28,2,0,3,0,5
120,2022/10/28,5,4,2,0,7
149,2022/10/28,9,0,0,0,9
184,2022/10/28,19,15,8,0,27
195,2022/10/28,27,30,24,0,51
218,2022/10/28,19,24,26,0,45
296,2022/10/28,12,6,10,0,22
300,2022/10/28,10,8,8,0,18
304,2022/10/28,14,6,4,0,18
317,2022/10/28,15,0,3,0,18
343,2022/10/28,8,4,0,0,8
353,2022/10/28,5,0,0,0,5
373,2022/10/28,7,0,2,0,9
374,2022/10/28,6,0,5,0,11
388,2022/10/28,11,27,29,1,40
419,2022/10/28,20,6,6,1,26
420,2022/10/28,14,6,1,0,15
462,2022/10/28,9,16,6,0,15
519,2022/10/28,20,12,12,0,32
525,2022/10/28,8,0,0,0,8
596,2022/10/28,14,4,7,1,21
597,2022/10/28,33,30,11,0,44
598,2022/10/28,8,0,1,0,9
1035,2022/10/28,8,6,6,0,14
1084,2022/10/28,26,15,6,2,32
1111,2022/10/28,9,0,0,0,9
1112,2022/10/28,4,0,0,0,4
1113,2022/10/28,11,0,3,0,14
1114,2022/10/28,14,6,6,0,20
1115,2022/10/28,15,6,4,0,19
1117,2022/10/28,17,0,0,0,17
1119,2022/10/28,10,0,1,0,11
1692,2022/10/28,18,6,1,0,19
1693,2022/10/28,6,0,2,0,8
1747,2022/10/28,17,20,19,0,36
1772,2022/10/28,13,0,2,0,15
1773,2022/10/28,14,0,0,0,14
1774,2022/10/28,12,8,1,0,13
1782,2022/10/28,18,21,19,1,37
1795,2022/10/28,35,14,16,0,51
1915,2022/10/28,10,0,1,0,11
1923,2022/10/28,6,0,4,0,10
1934,2022/10/28,6,5,0,2,6
1963,2022/10/28,9,0,5,0,14
1984,2022/10/28,5,0,5,0,10
2135,2022/10/28,14,0,1,0,15
2136,2022/10/28,13,0,3,0,16
2148,2022/10/28,15,8,7,0,22
2183,2022/10/28,9,0,9,0,18
2193,2022/10/28,16,12,12,2,28
2237,2022/10/28,10,0,4,0,14
2358,2022/10/28,10,8,7,0,17
2361,2022/10/28,14,7,6,0,20
2445,2022/10/28,19,12,11,0,30
2449,2022/10/28,9,6,4,1,13
2451,2022/10/28,17,15,5,2,22
2476,2022/10/28,8,0,2,0,10
2507,2022/10/28,2,12,8,0,10
2525,2022/10/28,5,0,5,0,10
2562,2022/10/28,14,0,1,4,15
2582,2022/10/28,8,4,1,0,9
2586,2022/10/28,27,12,14,3,41
2631,2022/10/28,6,0,4,0,10
2685,2022/10/28,18,8,8,0,26
2723,2022/10/28,5,0,0,0,5
2730,2022/10/28,10,0,7,0,17
2731,2022/10/28,13,6,0,0,13
2732,2022/10/28,13,0,1,0,14
2734,2022/10/28,7,4,0,0,7
2735,2022/10/28,9,8,2,0,11
2761,2022/10/28,30,15,13,0,43
2788,2022/10/28,16,16,16,0,32
2802,2022/10/28,10,0,1,0,11
2812,2022/10/28,9,0,1,0,10
2813,2022/10/28,3,0,1,0,4
2913,2022/10/28,11,0,2,0,13
2914,2022/10/28,13,0,1,0,14
3015,2022/10/28,5,0,3,0,8
3033,2022/10/28,8,0,1,0,9
3035,2022/10/28,6,0,0,0,6
4446,2022/10/28,19,18,15,0,34
12136,2022/10/28,14,21,14,0,28
12516,2022/10/28,5,0,2,0,7
12518,2022/10/28,11,0,3,0,14
12523,2022/10/28,8,0,0,0,8
16062,2022/10/28,8,0,3,0,11
16063,2022/10/28,5,0,1,0,6
16276,2022/10/28,7,0,0,0,7
19322,2022/10/28,7,0,1,0,8
19521,2022/10/28,12,8,2,0,14
20901,2022/10/28,7,0,4,0,11
20920,2022/10/28,14,0,1,0,15
21132,2022/10/28,17,15,16,0,33
21171,2022/10/28,12,4,4,0,16
21174,2022/10/28,13,8,11,0,24
21175,2022/10/28,11,8,6,1,17
21176,2022/10/28,9,8,6,0,15
75,2022/10/29,33,32,29,0,62
76,2022/10/29,40,36,38,3,78
99,2022/10/29,10,0,0,0,10
117,2022/10/29,7,0,2,2,9
118,2022/10/29,16,4,1,2,17
119,2022/10/29,3,4,0,0,3
120,2022/10/29,3,0,2,0,5
184,2022/10/29,17,6,12,1,29
195,2022/10/29,27,24,24,0,51
218,2022/10/29,14,21,25,0,39
296,2022/10/29,8,6,6,0,14
300,2022/10/29,18,16,5,0,23
304,2022/10/29,10,0,2,0,12
317,2022/10/29,18,6,2,0,20
343,2022/10/29,8,0,4,0,12
373,2022/10/29,17,12,1,0,18
374,2022/10/29,5,4,4,0,9
388,2022/10/29,2,21,26,0,28
419,2022/10/29,19,6,2,0,21
420,2022/10/29,13,0,1,0,14
462,2022/10/29,11,8,8,0,19
519,2022/10/29,8,0,6,0,14
525,2022/10/29,8,0,0,7,8
596,2022/10/29,6,0,5,0,11
597,2022/10/29,22,0,11,0,33
598,2022/10/29,7,0,2,0,9
1035,2022/10/29,8,6,6,0,14
1084,2022/10/29,18,0,10,0,28
1111,2022/10/29,9,0,2,0,11
1112,2022/10/29,4,0,1,0,5
1113,2022/10/29,8,0,1,0,9
1114,2022/10/29,14,6,6,0,20
1115,2022/10/29,11,0,5,0,16
1117,2022/10/29,17,0,1,0,18
1119,2022/10/29,9,0,2,0,11
1692,2022/10/29,17,0,3,0,20
1693,2022/10/29,10,6,3,0,13
1747,2022/10/29,23,25,25,0,48
1772,2022/10/29,11,0,4,0,15
1773,2022/10/29,14,0,0,0,14
1774,2022/10/29,11,0,1,0,12
1782,2022/10/29,16,18,18,0,34
1795,2022/10/29,47,28,11,0,58
1914,2022/10/29,8,0,0,0,8
1915,2022/10/29,9,0,1,0,10
1923,2022/10/29,8,6,5,0,13
1934,2022/10/29,4,0,3,0,7
1963,2022/10/29,10,6,7,0,17
1984,2022/10/29,6,6,6,0,12
2135,2022/10/29,13,0,3,0,16
2136,2022/10/29,10,0,2,0,12
2148,2022/10/29,12,4,1,0,13
2183,2022/10/29,6,6,5,0,11
2193,2022/10/29,8,6,10,2,18
2237,2022/10/29,6,0,5,0,11
2358,2022/10/29,3,0,2,0,5
2361,2022/10/29,8,0,5,0,13
2445,2022/10/29,14,6,10,0,24
2449,2022/10/29,16,12,4,0,20
2451,2022/10/29,20,10,4,0,24
2476,2022/10/29,12,6,1,0,13
2507,2022/10/29,12,18,6,0,18
2525,2022/10/29,6,6,2,0,8
2562,2022/10/29,15,6,1,0,16
2582,2022/10/29,11,4,4,0,15
2586,2022/10/29,18,8,17,0,35
2631,2022/10/29,8,6,2,0,10
2685,2022/10/29,18,8,4,0,22
2723,2022/10/29,13,8,3,0,16
2730,2022/10/29,3,0,4,0,7
2731,2022/10/29,13,0,1,0,14
2732,2022/10/29,12,0,2,0,14
2734,2022/10/29,7,0,0,0,7
2735,2022/10/29,7,0,1,0,8
2761,2022/10/29,32,15,25,2,57
2788,2022/10/29,12,12,7,0,19
2802,2022/10/29,9,0,3,0,12
2812,2022/10/29,8,0,1,0,9
2813,2022/10/29,8,6,4,0,12
2913,2022/10/29,9,0,1,1,10
2914,2022/10/29,12,0,2,0,14
3015,2022/10/29,10,8,2,0,12
3033,2022/10/29,7,0,2,0,9
3035,2022/10/29,6,0,1,0,7
4446,2022/10/29,19,15,14,2,33
12136,2022/10/29,15,15,18,0,33
12516,2022/10/29,7,4,2,0,9
12518,2022/10/29,8,0,2,0,10
12523,2022/10/29,12,4,6,0,18
16062,2022/10/29,11,6,2,0,13
16063,2022/10/29,10,6,1,0,11
16276,2022/10/29,7,0,0,0,7
19322,2022/10/29,6,0,0,0,6
19521,2022/10/29,10,0,1,0,11
20901,2022/10/29,3,0,0,0,3
20920,2022/10/29,13,0,0,0,13
21132,2022/10/29,13,12,9,0,22
21171,2022/10/29,12,4,5,0,17
21174,2022/10/29,10,8,7,0,17
21175,2022/10/29,12,8,7,0,19
21176,2022/10/29,11,8,4,0,15
75,2022/10/30,32,28,21,0,53
76,2022/10/30,27,28,26,0,53
99,2022/10/30,10,0,2,0,12
117,2022/10/30,3,0,2,0,5
118,2022/10/30,13,0,3,0,16
119,2022/10/30,3,0,3,0,6
120,2022/10/30,5,4,1,1,6
149,2022/10/30,9,0,0,0,9
184,2022/10/30,10,6,5,2,15
195,2022/10/30,27,24,24,0,51
218,2022/10/30,8,18,18,0,26
296,2022/10/30,2,0,4,0,6
300,2022/10/30,13,0,1,0,14
304,2022/10/30,14,6,4,0,18
317,2022/10/30,22,6,11,0,33
343,2022/10/30,8,4,3,0,11
373,2022/10/30,16,0,5,1,21
374,2022/10/30,13,12,3,0,16
388,2022/10/30,-3,21,18,0,15
419,2022/10/30,23,6,2,0,25
420,2022/10/30,12,0,4,1,16
462,2022/10/30,11,8,6,0,17
519,2022/10/30,8,6,7,0,15
525,2022/10/30,1,0,0,0,1
596,2022/10/30,9,8,4,0,13
597,2022/10/30,23,12,4,0,27
598,2022/10/30,5,0,0,0,5
1035,2022/10/30,8,6,6,0,14
1084,2022/10/30,18,10,9,0,27
1111,2022/10/30,7,0,0,0,7
1112,2022/10/30,9,6,0,0,9
1113,2022/10/30,7,0,4,0,11
1114,2022/10/30,8,0,4,0,12
1115,2022/10/30,6,0,3,0,9
1117,2022/10/30,16,0,1,0,17
1119,2022/10/30,7,0,2,0,9
1692,2022/10/30,14,0,1,3,15
1693,2022/10/30,7,0,0,0,7
1747,2022/10/30,13,15,12,0,25
1772,2022/10/30,7,0,3,0,10
1773,2022/10/30,14,0,4,0,18
1774,2022/10/30,10,0,3,0,13
1782,2022/10/30,16,18,7,0,23
1795,2022/10/30,36,0,13,1,49
1914,2022/10/30,8,0,0,0,8
1915,2022/10/30,8,0,0,0,8
1923,2022/10/30,9,6,3,0,12
1934,2022/10/30,6,5,4,0,10
1963,2022/10/30,9,6,11,0,20
1984,2022/10/30,6,6,3,0,9
2135,2022/10/30,10,0,4,0,14
2136,2022/10/30,8,0,2,0,10
2148,2022/10/30,11,0,1,0,12
2183,2022/10/30,1,0,1,0,2
2193,2022/10/30,8,12,9,0,17
2237,2022/10/30,1,0,0,0,1
2358,2022/10/30,9,8,4,0,13
2361,2022/10/30,10,7,8,0,18
2445,2022/10/30,10,6,8,0,18
2449,2022/10/30,12,0,8,2,20
2451,2022/10/30,46,30,11,0,57
2476,2022/10/30,11,0,1,0,12
2507,2022/10/30,18,12,7,0,25
2525,2022/10/30,10,6,2,0,12
2562,2022/10/30,14,0,5,0,19
2582,2022/10/30,7,0,0,0,7
2586,2022/10/30,5,4,4,0,9
2631,2022/10/30,12,6,7,0,19
2685,2022/10/30,14,0,6,2,20
2723,2022/10/30,10,0,1,0,11
2730,2022/10/30,5,6,6,0,11
2731,2022/10/30,12,0,3,0,15
2732,2022/10/30,10,0,1,0,11
2734,2022/10/30,15,8,2,0,17
2735,2022/10/30,14,8,2,0,16
2761,2022/10/30,10,5,12,0,22
2788,2022/10/30,17,12,16,0,33
2802,2022/10/30,6,0,0,0,6
2812,2022/10/30,7,0,0,0,7
2813,2022/10/30,4,0,1,0,5
2913,2022/10/30,7,0,4,0,11
2914,2022/10/30,10,0,1,0,11
3015,2022/10/30,8,0,1,0,9
3033,2022/10/30,5,0,2,0,7
3035,2022/10/30,5,0,1,0,6
4446,2022/10/30,15,12,6,0,21
12136,2022/10/30,15,18,15,0,30
12516,2022/10/30,9,4,3,0,12
12518,2022/10/30,6,0,2,0,8
12523,2022/10/30,14,8,3,0,17
16062,2022/10/30,9,0,0,0,9
16063,2022/10/30,9,0,0,0,9
16276,2022/10/30,13,6,1,0,14
19322,2022/10/30,6,0,0,0,6
19329,2022/10/30,7,0,0,0,7
19521,2022/10/30,9,0,0,0,9
20901,2022/10/30,3,0,1,0,4
20920,2022/10/30,13,0,0,0,13
21132,2022/10/30,16,12,15,0,31
21171,2022/10/30,7,0,0,0,7
21174,2022/10/30,11,8,9,0,20
21175,2022/10/30,13,8,5,0,18
21176,2022/10/30,15,8,4,2,19
75,2022/10/31,51,40,33,0,84
76,2022/10/31,41,40,40,1,81
99,2022/10/31,8,0,0,0,8
117,2022/10/31,6,4,0,0,6
118,2022/10/31,9,0,5,0,14
119,2022/10/31,5,4,1,0,6
120,2022/10/31,4,0,4,0,8
149,2022/10/31,9,0,0,0,9
184,2022/10/31,10,6,4,0,14
195,2022/10/31,33,30,28,0,61
218,2022/10/31,13,24,22,0,35
296,2022/10/31,4,6,4,0,8
300,2022/10/31,20,8,3,0,23
304,2022/10/31,10,0,2,0,12
317,2022/10/31,17,6,11,1,28
343,2022/10/31,1,0,1,0,2
373,2022/10/31,10,0,5,0,15
374,2022/10/31,10,0,3,0,13
388,2022/10/31,6,27,18,0,24
419,2022/10/31,27,6,11,0,38
420,2022/10/31,13,6,2,0,15
462,2022/10/31,21,16,5,0,26
519,2022/10/31,7,6,4,0,11
525,2022/10/31,1,0,0,0,1
596,2022/10/31,9,4,6,0,15
597,2022/10/31,31,12,9,4,40
598,2022/10/31,11,6,1,0,12
1035,2022/10/31,8,6,3,0,11
1084,2022/10/31,9,0,7,0,16
1111,2022/10/31,7,0,0,0,7
1112,2022/10/31,9,0,0,0,9
1113,2022/10/31,9,6,0,0,9
1114,2022/10/31,4,0,1,0,5
1115,2022/10/31,9,6,3,0,12
1117,2022/10/31,15,0,1,0,16
1119,2022/10/31,5,0,0,0,5
1692,2022/10/31,16,6,4,0,20
1693,2022/10/31,7,0,0,0,7
1747,2022/10/31,21,20,20,0,41
1772,2022/10/31,12,8,1,0,13
1773,2022/10/31,10,0,0,0,10
1774,2022/10/31,7,0,3,0,10
1782,2022/10/31,30,21,16,0,46
1795,2022/10/31,36,14,8,1,44
1915,2022/10/31,8,0,0,0,8
1923,2022/10/31,6,0,3,0,9
1934,2022/10/31,2,0,2,0,4
1963,2022/10/31,4,6,9,0,13
1984,2022/10/31,9,6,4,0,13
2135,2022/10/31,12,6,2,0,14
2136,2022/10/31,6,0,0,0,6
2148,2022/10/31,10,0,4,0,14
2183,2022/10/31,6,6,4,0,10
2193,2022/10/31,14,15,12,0,26
2237,2022/10/31,7,6,0,0,7
2358,2022/10/31,5,0,4,0,9
2361,2022/10/31,2,0,3,0,5
2445,2022/10/31,2,0,0,0,2
2449,2022/10/31,8,6,8,0,16
2451,2022/10/31,35,0,16,0,51
2476,2022/10/31,10,0,0,0,10
2507,2022/10/31,17,6,13,0,30
2525,2022/10/31,14,6,0,0,14
2562,2022/10/31,9,0,1,4,10
2582,2022/10/31,7,0,1,0,8
2586,2022/10/31,9,8,9,0,18
2631,2022/10/31,11,6,4,0,15
2685,2022/10/31,14,8,6,3,20
2723,2022/10/31,9,0,0,0,9
2730,2022/10/31,5,6,1,0,6
2731,2022/10/31,9,0,1,0,10
2732,2022/10/31,9,0,3,0,12
2734,2022/10/31,13,0,4,0,17
2735,2022/10/31,20,8,3,0,23
2761,2022/10/31,8,10,7,0,15
2788,2022/10/31,21,20,18,0,39
2802,2022/10/31,6,0,0,0,6
2812,2022/10/31,7,0,0,0,7
2813,2022/10/31,3,0,1,0,4
2913,2022/10/31,3,0,1,1,4
2914,2022/10/31,9,0,0,0,9
3015,2022/10/31,15,8,7,0,22
3033,2022/10/31,3,0,0,0,3
3035,2022/10/31,10,6,3,0,13
4446,2022/10/31,15,6,4,5,19
12136,2022/10/31,24,24,24,0,48
12516,2022/10/31,6,0,5,0,11
12518,2022/10/31,8,4,6,0,14
12523,2022/10/31,11,0,5,0,16
16062,2022/10/31,15,6,1,0,16
16063,2022/10/31,9,0,0,0,9
16276,2022/10/31,12,0,2,0,14
19322,2022/10/31,6,0,1,0,7
19329,2022/10/31,7,0,0,0,7
19521,2022/10/31,9,0,1,0,10
20901,2022/10/31,8,6,0,0,8
20920,2022/10/31,13,0,1,0,14
21132,2022/10/31,16,15,11,0,27
21171,2022/10/31,7,0,3,3,10
21174,2022/10/31,10,8,5,1,15
21175,2022/10/31,16,8,11,0,27
21176,2022/10/31,17,8,5,5,22
75,2022/11/01,54,36,35,12,89
76,2022/11/01,36,36,36,0,72
99,2022/11/01,8,0,1,0,9
117,2022/11/01,6,0,1,1,7
118,2022/11/01,4,0,3,0,7
119,2022/11/01,8,4,1,0,9
120,2022/11/01,4,4,2,0,6
149,2022/11/01,9,0,0,0,9
184,2022/11/01,11,6,9,2,20
195,2022/11/01,35,30,30,0,65
218,2022/11/01,18,27,20,0,38
296,2022/11/01,6,6,8,0,14
300,2022/11/01,25,8,0,0,25
304,2022/11/01,14,6,3,0,17
317,2022/11/01,11,6,6,0,17
343,2022/11/01,0,0,0,0,0
373,2022/11/01,11,6,5,0,16
374,2022/11/01,11,4,9,0,20
388,2022/11/01,15,27,24,1,39
419,2022/11/01,16,0,6,2,22
420,2022/11/01,11,0,0,0,11
462,2022/11/01,24,8,10,0,34
519,2022/11/01,15,12,3,0,18
525,2022/11/01,6,5,3,0,9
596,2022/11/01,11,8,3,0,14
597,2022/11/01,30,12,8,5,38
598,2022/11/01,10,0,4,3,14
1035,2022/11/01,17,12,2,0,19
1084,2022/11/01,7,5,5,0,12
1111,2022/11/01,7,0,0,0,7
1112,2022/11/01,9,0,0,0,9
1113,2022/11/01,9,0,1,0,10
1114,2022/11/01,9,6,5,0,14
1115,2022/11/01,6,0,1,0,7
1117,2022/11/01,14,0,0,0,14
1119,2022/11/01,5,0,1,0,6
1692,2022/11/01,12,0,5,0,17
1693,2022/11/01,7,0,3,0,10
1747,2022/11/01,21,20,16,0,37
1772,2022/11/01,11,0,1,0,12
1773,2022/11/01,10,0,1,0,11
1774,2022/11/01,4,0,2,0,6
1782,2022/11/01,38,24,16,8,54
1795,2022/11/01,34,7,17,0,51
1915,2022/11/01,8,0,2,0,10
1923,2022/11/01,9,6,4,0,13
1934,2022/11/01,5,5,2,0,7
1963,2022/11/01,7,12,12,2,19
1984,2022/11/01,11,6,1,0,12
2135,2022/11/01,10,0,1,0,11
2136,2022/11/01,6,0,1,0,7
2148,2022/11/01,10,4,1,0,11
2183,2022/11/01,8,6,1,0,9
2193,2022/11/01,14,12,14,0,28
2237,2022/11/01,13,6,2,0,15
2358,2022/11/01,9,8,4,0,13
2361,2022/11/01,6,7,4,0,10
2445,2022/11/01,8,6,2,0,10
2449,2022/11/01,0,0,0,0,0
2451,2022/11/01,19,0,3,1,22
2476,2022/11/01,10,0,0,0,10
2507,2022/11/01,16,12,12,4,28
2525,2022/11/01,14,0,0,0,14
2562,2022/11/01,10,6,2,0,12
2582,2022/11/01,10,4,4,0,14
2586,2022/11/01,16,16,15,0,31
2631,2022/11/01,7,0,5,0,12
2685,2022/11/01,13,8,6,2,19
2723,2022/11/01,9,0,3,0,12
2730,2022/11/01,4,0,0,0,4
2731,2022/11/01,8,0,2,0,10
2732,2022/11/01,6,0,0,0,6
2734,2022/11/01,9,0,5,0,14
2735,2022/11/01,17,0,0,0,17
2761,2022/11/01,16,15,10,0,26
2788,2022/11/01,19,16,13,0,32
2802,2022/11/01,12,6,3,0,15
2812,2022/11/01,7,0,1,0,8
2813,2022/11/01,8,6,2,0,10
2913,2022/11/01,1,0,0,0,1
2914,2022/11/01,9,0,0,0,9
3015,2022/11/01,8,0,4,0,12
3033,2022/11/01,9,6,1,0,10
3035,2022/11/01,7,0,2,0,9
4446,2022/11/01,18,12,8,5,26
12136,2022/11/01,24,24,20,0,44
12516,2022/11/01,5,4,2,0,7
12518,2022/11/01,2,0,2,0,4
12523,2022/11/01,10,4,4,0,14
16062,2022/11/01,14,0,0,0,14
16063,2022/11/01,9,0,1,0,10
16276,2022/11/01,10,0,1,0,11
19322,2022/11/01,5,0,0,0,5
19521,2022/11/01,8,0,1,0,9
20901,2022/11/01,8,0,2,0,10
20920,2022/11/01,12,0,0,0,12
21132,2022/11/01,20,15,14,6,34
21171,2022/11/01,1,0,1,0,2
21174,2022/11/01,16,12,12,0,28
21175,2022/11/01,9,4,9,0,18
21176,2022/11/01,11,4,1,4,12
75,2022/11/02,47,40,44,0,91
76,2022/11/02,44,44,40,0,84
99,2022/11/02,7,0,2,0,9
117,2022/11/02,8,4,1,0,9
118,2022/11/02,1,0,0,0,1
119,2022/11/02,7,0,1,0,8
120,2022/11/02,2,0,2,0,4
149,2022/11/02,9,0,0,0,9
184,2022/11/02,12,12,7,0,19
195,2022/11/02,35,30,29,0,64
218,2022/11/02,28,30,36,0,64
296,2022/11/02,4,6,2,0,6
300,2022/11/02,25,0,2,0,27
304,2022/11/02,17,6,4,0,21
317,2022/11/02,5,0,6,0,11
343,2022/11/02,4,4,1,0,5
353,2022/11/02,5,0,0,0,5
373,2022/11/02,6,0,2,0,8
374,2022/11/02,2,0,3,0,5
388,2022/11/02,17,27,22,4,39
419,2022/11/02,14,6,8,4,22
420,2022/11/02,11,0,4,0,15
462,2022/11/02,22,8,9,0,31
519,2022/11/02,12,0,3,0,15
525,2022/11/02,3,0,2,0,5
596,2022/11/02,16,8,11,1,27
597,2022/11/02,29,12,10,0,39
598,2022/11/02,3,0,2,0,5
1035,2022/11/02,15,0,3,0,18
1084,2022/11/02,12,10,10,0,22
1111,2022/11/02,7,0,0,0,7
1112,2022/11/02,9,0,0,0,9
1113,2022/11/02,14,6,0,0,14
1114,2022/11/02,10,6,4,0,14
1115,2022/11/02,11,6,3,0,14
1117,2022/11/02,14,0,1,0,15
1119,2022/11/02,10,6,0,0,10
1692,2022/11/02,7,0,3,0,10
1693,2022/11/02,10,6,2,0,12
1747,2022/11/02,30,25,26,0,56
1772,2022/11/02,18,8,2,0,20
1773,2022/11/02,9,0,1,0,10
1774,2022/11/02,2,0,0,0,2
1782,2022/11/02,35,21,33,0,68
1795,2022/11/02,24,7,8,8,32
1915,2022/11/02,6,0,0,0,6
1923,2022/11/02,11,6,1,0,12
1934,2022/11/02,8,5,4,0,12
1963,2022/11/02,-1,6,5,1,4
1984,2022/11/02,16,6,2,0,18
2135,2022/11/02,9,0,2,0,11
2136,2022/11/02,11,6,0,0,11
2148,2022/11/02,9,0,1,0,10
2183,2022/11/02,13,6,4,0,17
2193,2022/11/02,12,12,15,2,27
2237,2022/11/02,11,0,3,0,14
2358,2022/11/02,9,4,4,0,13
2361,2022/11/02,9,7,13,0,22
2445,2022/11/02,12,6,2,0,14
2449,2022/11/02,6,6,5,0,11
2451,2022/11/02,15,0,10,0,25
2476,2022/11/02,10,0,0,0,10
2507,2022/11/02,6,6,4,0,10
2525,2022/11/02,14,0,0,0,14
2562,2022/11/02,8,0,3,0,11
2582,2022/11/02,6,0,2,0,8
2586,2022/11/02,13,12,9,0,22
2631,2022/11/02,2,0,0,0,2
2685,2022/11/02,5,0,4,0,9
2723,2022/11/02,6,0,1,0,7
2730,2022/11/02,10,6,2,0,12
2731,2022/11/02,6,0,0,0,6
2732,2022/11/02,6,0,1,0,7
2734,2022/11/02,4,0,0,0,4
2735,2022/11/02,17,0,2,0,19
2761,2022/11/02,21,15,10,0,31
2788,2022/11/02,18,12,15,2,33
2802,2022/11/02,9,0,0,0,9
2812,2022/11/02,6,0,0,0,6
2813,2022/11/02,6,0,1,0,7
2913,2022/11/02,1,0,0,0,1
2914,2022/11/02,9,0,0,0,9
3015,2022/11/02,4,0,0,0,4
3033,2022/11/02,8,0,0,0,8
3035,2022/11/02,5,0,0,0,5
4446,2022/11/02,17,12,5,0,22
12136,2022/11/02,25,21,22,0,47
12516,2022/11/02,3,0,3,0,6
12518,2022/11/02,4,4,1,0,5
12523,2022/11/02,6,0,2,0,8
16062,2022/11/02,14,0,0,0,14
16063,2022/11/02,8,0,0,0,8
16276,2022/11/02,9,0,0,0,9
19322,2022/11/02,5,0,0,0,5
19521,2022/11/02,7,0,0,0,7
20901,2022/11/02,6,0,0,0,6
20920,2022/11/02,12,0,1,0,13
21132,2022/11/02,15,15,16,0,31
21171,2022/11/02,0,0,0,0,0
21174,2022/11/02,12,8,11,0,23
21175,2022/11/02,8,8,5,0,13
21176,2022/11/02,10,4,3,5,13
75,2022/11/03,35,32,38,0,73
76,2022/11/03,52,48,45,0,97
99,2022/11/03,5,0,0,0,5
117,2022/11/03,7,0,1,1,8
118,2022/11/03,5,4,5,0,10
119,2022/11/03,6,0,4,0,10
120,2022/11/03,0,0,0,0,0
149,2022/11/03,9,0,0,0,9
184,2022/11/03,17,12,11,0,28
195,2022/11/03,36,30,29,0,65
218,2022/11/03,16,24,25,0,41
296,2022/11/03,8,6,4,0,12
300,2022/11/03,23,0,1,0,24
304,2022/11/03,19,6,4,0,23
317,2022/11/03,11,12,3,0,14
343,2022/11/03,7,4,2,0,9
353,2022/11/03,5,0,0,0,5
373,2022/11/03,4,0,0,0,4
374,2022/11/03,3,4,2,0,5
388,2022/11/03,21,30,32,1,53
419,2022/11/03,2,0,4,0,6
420,2022/11/03,13,6,1,0,14
462,2022/11/03,21,8,6,0,27
519,2022/11/03,21,12,8,0,29
525,2022/11/03,1,0,0,0,1
596,2022/11/03,8,4,8,0,16
597,2022/11/03,31,12,17,0,48
598,2022/11/03,1,0,1,0,2
1035,2022/11/03,18,6,3,0,21
1084,2022/11/03,12,10,10,0,22
1111,2022/11/03,13,6,0,0,13
1112,2022/11/03,9,0,1,0,10
1113,2022/11/03,14,0,0,0,14
1114,2022/11/03,6,0,4,0,10
1115,2022/11/03,8,0,1,0,9
1117,2022/11/03,13,0,0,0,13
1119,2022/11/03,10,0,0,0,10
1692,2022/11/03,4,0,3,0,7
1693,2022/11/03,8,0,1,0,9
1747,2022/11/03,24,20,23,0,47
1772,2022/11/03,16,0,1,0,17
1773,2022/11/03,8,0,0,0,8
1774,2022/11/03,10,8,6,0,16
1782,2022/11/03,14,12,17,0,31
1795,2022/11/03,9,0,8,0,17
1915,2022/11/03,6,0,1,0,7
1923,2022/11/03,10,0,2,0,12
1934,2022/11/03,9,5,5,0,14
1963,2022/11/03,8,6,6,1,14
1984,2022/11/03,20,6,10,0,30
2135,2022/11/03,7,0,0,0,7
2136,2022/11/03,11,0,2,0,13
2148,2022/11/03,12,4,0,0,12
2183,2022/11/03,9,0,4,0,13
2193,2022/11/03,10,15,14,0,24
2237,2022/11/03,8,0,2,0,10
2358,2022/11/03,5,0,4,0,9
2361,2022/11/03,3,7,4,0,7
2445,2022/11/03,22,12,10,0,32
2449,2022/11/03,7,6,1,0,8
2451,2022/11/03,20,15,11,0,31
2476,2022/11/03,10,0,0,0,10
2507,2022/11/03,14,12,9,2,23
2525,2022/11/03,14,0,1,0,15
2562,2022/11/03,11,6,0,0,11
2582,2022/11/03,4,0,1,0,5
2586,2022/11/03,20,16,17,0,37
2631,2022/11/03,2,0,0,0,2
2685,2022/11/03,9,8,8,0,17
2723,2022/11/03,5,0,0,0,5
2730,2022/11/03,8,0,3,0,11
2731,2022/11/03,6,0,0,0,6
2732,2022/11/03,13,8,1,0,14
2734,2022/11/03,8,4,3,0,11
2735,2022/11/03,15,0,1,0,16
2761,2022/11/03,31,20,20,0,51
2788,2022/11/03,21,20,18,0,39
2802,2022/11/03,9,0,0,0,9
2812,2022/11/03,6,0,1,0,7
2813,2022/11/03,5,0,1,0,6
2913,2022/11/03,7,6,1,0,8
2914,2022/11/03,9,0,0,0,9
3015,2022/11/03,12,8,3,0,15
3033,2022/11/03,8,0,0,0,8
3035,2022/11/03,5,0,0,0,5
4446,2022/11/03,24,12,14,0,38
12136,2022/11/03,24,21,26,0,50
12516,2022/11/03,0,0,0,0,0
12518,2022/11/03,3,0,2,0,5
12523,2022/11/03,8,4,5,0,13
16062,2022/11/03,14,0,0,0,14
16063,2022/11/03,8,0,0,0,8
16276,2022/11/03,9,0,0,0,9
19322,2022/11/03,11,6,0,0,11
19521,2022/11/03,7,0,3,0,10
20901,2022/11/03,6,0,0,0,6
20920,2022/11/03,11,0,0,0,11
21132,2022/11/03,14,15,17,0,31
21171,2022/11/03,4,4,1,0,5
21174,2022/11/03,5,4,4,0,9
21175,2022/11/03,7,4,6,0,13
21176,2022/11/03,6,4,6,0,12
75,2022/11/04,44,40,34,0,78
76,2022/11/04,46,36,34,2,80
99,2022/11/04,3,0,0,0,3
117,2022/11/04,5,0,2,0,7
118,2022/11/04,4,4,2,0,6
119,2022/11/04,2,0,2,0,4
120,2022/11/04,4,4,2,0,6
149,2022/11/04,9,0,0,0,9
184,2022/11/04,16,9,16,0,32
195,2022/11/04,31,24,25,1,56
218,2022/11/04,25,24,24,0,49
296,2022/11/04,10,6,1,0,11
300,2022/11/04,22,0,3,0,25
304,2022/11/04,15,0,4,0,19
317,2022/11/04,14,6,5,0,19
343,2022/11/04,9,4,0,0,9
353,2022/11/04,4,0,0,0,4
373,2022/11/04,10,6,1,0,11
374,2022/11/04,5,4,3,0,8
388,2022/11/04,43,30,37,0,80
419,2022/11/04,-2,0,1,0,-1
420,2022/11/04,12,0,1,0,13
462,2022/11/04,15,0,7,0,22
519,2022/11/04,25,12,8,0,33
525,2022/11/04,1,0,0,0,1
596,2022/11/04,10,8,4,0,14
597,2022/11/04,36,24,17,0,53
598,2022/11/04,0,0,0,0,0
1035,2022/11/04,21,6,4,0,25
1084,2022/11/04,19,15,10,0,29
1111,2022/11/04,8,0,1,0,9
1112,2022/11/04,7,0,0,0,7
1113,2022/11/04,14,0,0,0,14
1114,2022/11/04,6,6,6,0,12
1115,2022/11/04,5,0,3,0,8
1117,2022/11/04,13,0,1,0,14
1119,2022/11/04,8,0,0,0,8
1692,2022/11/04,7,6,2,0,9
1693,2022/11/04,7,0,0,0,7
1747,2022/11/04,16,15,14,0,30
1772,2022/11/04,17,0,3,0,20
1773,2022/11/04,5,0,0,0,5
1774,2022/11/04,2,0,1,0,3
1782,2022/11/04,14,15,13,0,27
1795,2022/11/04,16,14,10,0,26
1915,2022/11/04,4,0,0,0,4
1923,2022/11/04,19,6,1,0,20
1934,2022/11/04,4,0,2,0,6
1963,2022/11/04,7,6,6,0,13
1984,2022/11/04,16,6,2,1,18
2135,2022/11/04,8,0,5,0,13
2136,2022/11/04,10,0,3,0,13
2148,2022/11/04,16,4,2,0,18
2183,2022/11/04,11,6,8,0,19
2193,2022/11/04,13,12,10,0,23
2237,2022/11/04,14,6,4,0,18
2358,2022/11/04,9,8,6,0,15
2361,2022/11/04,6,7,0,0,6
2445,2022/11/04,24,12,16,0,40
2449,2022/11/04,6,0,4,0,10
2451,2022/11/04,19,10,6,0,25
2476,2022/11/04,8,0,0,0,8
2507,2022/11/04,33,12,6,3,39
2525,2022/11/04,13,0,1,0,14
2562,2022/11/04,11,0,5,0,16
2582,2022/11/04,3,0,2,0,5
2586,2022/11/04,20,16,7,0,27
2631,2022/11/04,8,6,6,0,14
2685,2022/11/04,8,8,4,0,12
2723,2022/11/04,12,8,0,0,12
2730,2022/11/04,19,6,1,0,20
2731,2022/11/04,11,6,0,0,11
2732,2022/11/04,21,0,1,0,22
2734,2022/11/04,5,0,3,0,8
2735,2022/11/04,14,0,1,0,15
2761,2022/11/04,32,20,21,0,53
2788,2022/11/04,21,16,19,0,40
2802,2022/11/04,8,0,1,0,9
2812,2022/11/04,4,0,0,0,4
2813,2022/11/04,12,6,2,0,14
2913,2022/11/04,6,0,4,0,10
2914,2022/11/04,12,0,0,0,12
3015,2022/11/04,11,0,1,0,12
3033,2022/11/04,6,0,1,0,7
3035,2022/11/04,10,6,0,0,10
4446,2022/11/04,14,12,9,0,23
12136,2022/11/04,24,18,17,0,41
12516,2022/11/04,4,4,0,0,4
12518,2022/11/04,5,4,0,0,5
12523,2022/11/04,7,4,2,0,9
16062,2022/11/04,22,0,3,0,25
16063,2022/11/04,8,0,3,0,11
16276,2022/11/04,9,0,0,0,9
19322,2022/11/04,12,0,0,0,12
19521,2022/11/04,2,0,1,0,3
20901,2022/11/04,12,6,0,0,12
20920,2022/11/04,11,0,0,0,11
21132,2022/11/04,15,18,20,0,35
21171,2022/11/04,7,4,6,0,13
21174,2022/11/04,10,8,8,0,18
21175,2022/11/04,12,8,7,0,19
21176,2022/11/04,8,8,6,1,14
75,2022/11/05,44,36,44,0,88
76,2022/11/05,50,40,41,4,91
99,2022/11/05,15,12,2,0,17
117,2022/11/05,7,4,2,0,9
118,2022/11/05,2,0,2,0,4
119,2022/11/05,0,0,0,1,0
120,2022/11/05,2,0,2,0,4
184,2022/11/05,12,12,11,0,23
195,2022/11/05,35,30,29,0,64
218,2022/11/05,25,24,22,0,47
296,2022/11/05,15,6,2,0,17
300,2022/11/05,27,8,2,0,29
304,2022/11/05,11,0,7,3,18
317,2022/11/05,9,0,4,0,13
343,2022/11/05,9,0,2,0,11
373,2022/11/05,15,6,1,0,16
374,2022/11/05,6,4,3,0,9
388,2022/11/05,30,24,20,0,50
419,2022/11/05,3,6,5,0,8
420,2022/11/05,11,0,1,0,12
462,2022/11/05,16,8,4,0,20
519,2022/11/05,23,6,2,0,25
525,2022/11/05,6,5,2,0,8
596,2022/11/05,6,0,5,0,11
597,2022/11/05,19,0,14,0,33
598,2022/11/05,6,6,0,0,6
1035,2022/11/05,23,6,6,0,29
1084,2022/11/05,9,0,5,0,14
1111,2022/11/05,7,0,1,0,8
1112,2022/11/05,7,0,0,0,7
1113,2022/11/05,14,0,1,0,15
1114,2022/11/05,6,6,4,0,10
1115,2022/11/05,8,6,4,0,12
1117,2022/11/05,12,0,1,0,13
1119,2022/11/05,8,0,0,0,8
1692,2022/11/05,11,6,2,0,13
1693,2022/11/05,7,0,0,0,7
1747,2022/11/05,22,20,18,0,40
1772,2022/11/05,14,0,0,0,14
1773,2022/11/05,5,0,1,0,6
1774,2022/11/05,9,8,2,0,11
1782,2022/11/05,16,15,13,0,29
1795,2022/11/05,27,21,12,0,39
1914,2022/11/05,1,0,2,0,3
1915,2022/11/05,4,0,0,0,4
1923,2022/11/05,18,0,3,0,21
1934,2022/11/05,7,5,0,0,7
1963,2022/11/05,13,12,6,0,19
1984,2022/11/05,13,0,8,3,21
2135,2022/11/05,9,6,3,0,12
2136,2022/11/05,7,0,2,0,9
2148,2022/11/05,14,0,1,0,15
2183,2022/11/05,9,6,5,0,14
2193,2022/11/05,18,15,15,0,33
2237,2022/11/05,10,0,3,0,13
2358,2022/11/05,7,4,4,0,11
2361,2022/11/05,13,7,2,0,15
2445,2022/11/05,14,6,5,0,19
2449,2022/11/05,8,6,1,0,9
2451,2022/11/05,13,0,10,0,23
2476,2022/11/05,8,0,0,0,8
2507,2022/11/05,42,18,7,0,49
2525,2022/11/05,12,0,2,0,14
2562,2022/11/05,12,6,0,0,12
2582,2022/11/05,5,4,1,0,6
2586,2022/11/05,32,20,17,0,49
2631,2022/11/05,8,6,2,0,10
2685,2022/11/05,12,8,12,0,24
2723,2022/11/05,12,0,0,0,12
2730,2022/11/05,24,6,5,0,29
2731,2022/11/05,11,0,1,0,12
2732,2022/11/05,20,0,1,0,21
2734,2022/11/05,6,4,2,0,8
2735,2022/11/05,13,0,7,0,20
2761,2022/11/05,26,15,11,0,37
2788,2022/11/05,14,12,12,0,26
2802,2022/11/05,7,0,0,0,7
2813,2022/11/05,10,0,1,0,11
2913,2022/11/05,8,6,1,0,9
2914,2022/11/05,12,0,2,0,14
3015,2022/11/05,10,0,2,0,12
3033,2022/11/05,5,0,1,0,6
3035,2022/11/05,10,0,1,0,11
4446,2022/11/05,17,12,13,0,30
12136,2022/11/05,25,18,22,0,47
12516,2022/11/05,8,4,0,0,8
12518,2022/11/05,9,4,2,0,11
12523,2022/11/05,9,4,2,0,11
16062,2022/11/05,19,0,3,0,22
16063,2022/11/05,5,0,2,0,7
16276,2022/11/05,9,0,0,0,9
19322,2022/11/05,12,0,1,0,13
19521,2022/11/05,1,0,0,0,1
20901,2022/11/05,12,0,1,0,13
20920,2022/11/05,11,0,0,0,11
21132,2022/11/05,10,15,8,0,18
21171,2022/11/05,9,8,4,0,13
21174,2022/11/05,10,8,8,0,18
21175,2022/11/05,13,8,8,0,21
21176,2022/11/05,5,4,4,0,9
75,2022/11/06,24,24,18,0,42
76,2022/11/06,33,28,41,0,74
99,2022/11/06,13,0,0,0,13
117,2022/11/06,5,0,2,0,7
118,2022/11/06,4,4,3,0,7
119,2022/11/06,3,4,2,0,5
120,2022/11/06,4,4,2,0,6
149,2022/11/06,9,0,2,0,11
184,2022/11/06,7,6,5,0,12
195,2022/11/06,27,21,25,0,52
218,2022/11/06,21,18,17,0,38
296,2022/11/06,19,6,12,0,31
300,2022/11/06,25,0,6,0,31
304,2022/11/06,1,0,0,0,1
317,2022/11/06,17,12,6,0,23
343,2022/11/06,11,4,3,0,14
373,2022/11/06,20,6,1,0,21
374,2022/11/06,11,8,3,0,14
388,2022/11/06,25,15,19,0,44
419,2022/11/06,4,6,6,0,10
420,2022/11/06,16,6,2,0,18
462,2022/11/06,20,8,7,0,27
519,2022/11/06,27,6,7,0,34
525,2022/11/06,4,0,0,0,4
596,2022/11/06,5,4,4,0,9
597,2022/11/06,11,6,11,0,22
598,2022/11/06,6,0,1,0,7
1035,2022/11/06,17,0,4,0,21
1084,2022/11/06,14,10,7,0,21
1111,2022/11/06,6,0,5,0,11
1112,2022/11/06,7,0,1,0,8
1113,2022/11/06,13,0,3,0,16
1114,2022/11/06,8,6,6,0,14
1115,2022/11/06,10,6,4,0,14
1117,2022/11/06,11,0,2,0,13
1118,2022/11/06,6,6,1,0,7
1119,2022/11/06,8,0,2,0,10
1692,2022/11/06,9,0,2,0,11
1693,2022/11/06,13,6,2,0,15
1747,2022/11/06,24,20,21,0,45
1772,2022/11/06,14,0,3,0,17
1773,2022/11/06,10,6,1,0,11
1774,2022/11/06,15,8,3,0,18
1782,2022/11/06,27,24,17,0,44
1795,2022/11/06,15,0,14,0,29
1914,2022/11/06,5,6,2,0,7
1915,2022/11/06,10,6,1,0,11
1923,2022/11/06,15,0,5,0,20
1934,2022/11/06,7,0,1,0,8
1963,2022/11/06,19,12,5,1,24
1984,2022/11/06,2,0,2,0,4
2135,2022/11/06,6,0,3,0,9
2136,2022/11/06,5,0,0,0,5
2148,2022/11/06,13,0,0,0,13
2183,2022/11/06,10,6,1,0,11
2193,2022/11/06,15,12,13,2,28
2237,2022/11/06,7,0,2,0,9
2358,2022/11/06,11,8,9,0,20
2361,2022/11/06,18,7,4,0,22
2445,2022/11/06,9,0,4,0,13
2449,2022/11/06,13,6,4,0,17
2451,2022/11/06,33,30,9,0,42
2476,2022/11/06,8,0,3,0,11
2507,2022/11/06,47,12,4,5,51
2525,2022/11/06,10,0,5,0,15
2562,2022/11/06,12,0,1,0,13
2582,2022/11/06,8,4,1,0,9
2586,2022/11/06,23,8,7,1,30
2631,2022/11/06,12,6,3,0,15
2685,2022/11/06,8,8,8,0,16
2723,2022/11/06,12,0,2,0,14
2730,2022/11/06,19,0,5,0,24
2731,2022/11/06,10,0,2,0,12
2732,2022/11/06,19,0,4,0,23
2734,2022/11/06,8,4,0,0,8
2735,2022/11/06,6,0,3,0,9
2761,2022/11/06,25,10,9,0,34
2788,2022/11/06,14,12,14,0,28
2802,2022/11/06,7,0,0,0,7
2812,2022/11/06,10,6,0,0,10
2813,2022/11/06,9,0,2,0,11
2913,2022/11/06,7,0,0,0,7
2914,2022/11/06,10,0,0,0,10
3015,2022/11/06,8,0,3,0,11
3033,2022/11/06,10,6,0,0,10
3035,2022/11/06,9,0,1,0,10
4446,2022/11/06,10,6,7,0,17
12136,2022/11/06,15,12,8,0,23
12516,2022/11/06,16,8,1,0,17
12518,2022/11/06,11,4,4,0,15
12523,2022/11/06,15,8,5,0,20
16062,2022/11/06,16,0,2,0,18
16063,2022/11/06,3,0,2,0,5
16276,2022/11/06,9,0,1,0,10
19322,2022/11/06,11,0,0,0,11
19329,2022/11/06,6,6,1,0,7
19521,2022/11/06,9,8,1,0,10
20901,2022/11/06,11,0,0,0,11
20920,2022/11/06,11,0,0,0,11
21132,2022/11/06,17,15,12,0,29
21171,2022/11/06,9,4,3,0,12
21174,2022/11/06,14,12,14,0,28
21175,2022/11/06,13,8,8,0,21
21176,2022/11/06,9,8,4,1,13
75,2022/11/07,42,36,37,0,79
76,2022/11/07,36,44,38,0,74
99,2022/11/07,13,0,1,0,14
117,2022/11/07,3,0,1,1,4
118,2022/11/07,5,4,1,0,6
119,2022/11/07,1,0,0,0,1
120,2022/11/07,6,4,2,0,8
149,2022/11/07,7,0,0,0,7
184,2022/11/07,8,6,4,2,12
195,2022/11/07,29,27,26,0,55
218,2022/11/07,28,24,27,0,55
296,2022/11/07,13,6,3,0,16
300,2022/11/07,19,0,0,0,19
304,2022/11/07,7,6,2,0,9
317,2022/11/07,23,12,6,0,29
343,2022/11/07,8,0,1,0,9
373,2022/11/07,19,0,5,0,24
374,2022/11/07,8,0,6,0,14
388,2022/11/07,36,30,25,1,61
419,2022/11/07,10,12,6,0,16
420,2022/11/07,14,0,0,0,14
462,2022/11/07,21,8,14,0,35
519,2022/11/07,26,6,2,0,28
525,2022/11/07,9,5,0,0,9
596,2022/11/07,9,8,5,0,14
597,2022/11/07,12,12,6,0,18
598,2022/11/07,11,6,1,0,12
1035,2022/11/07,19,6,4,0,23
1084,2022/11/07,17,10,8,0,25
1111,2022/11/07,1,0,1,0,2
1112,2022/11/07,6,0,0,0,6
1113,2022/11/07,10,0,0,0,10
1114,2022/11/07,8,6,4,0,12
1115,2022/11/07,6,0,0,0,6
1117,2022/11/07,9,0,0,0,9
1118,2022/11/07,11,6,2,0,13
1119,2022/11/07,6,0,1,0,7
1692,2022/11/07,13,6,5,0,18
1693,2022/11/07,11,0,2,0,13
1747,2022/11/07,23,20,19,0,42
1772,2022/11/07,11,0,1,0,12
1773,2022/11/07,15,6,1,0,16
1774,2022/11/07,12,0,3,0,15
1782,2022/11/07,28,18,12,1,40
1795,2022/11/07,22,21,11,0,33
1914,2022/11/07,9,6,2,0,11
1915,2022/11/07,9,0,0,0,9
1923,2022/11/07,10,0,1,0,11
1934,2022/11/07,11,5,1,2,12
1963,2022/11/07,25,12,4,0,29
1984,2022/11/07,6,6,4,0,10
2135,2022/11/07,9,6,3,0,12
2136,2022/11/07,11,6,0,0,11
2148,2022/11/07,13,0,2,0,15
2183,2022/11/07,9,0,1,0,10
2193,2022/11/07,15,15,18,0,33
2237,2022/11/07,11,6,3,0,14
2358,2022/11/07,2,0,1,0,3
2361,2022/11/07,21,7,3,0,24
2445,2022/11/07,11,6,3,0,14
2449,2022/11/07,15,6,3,0,18
2451,2022/11/07,24,0,11,0,35
2476,2022/11/07,5,0,0,0,5
2507,2022/11/07,38,0,4,2,42
2525,2022/11/07,5,0,0,0,5
2562,2022/11/07,11,0,1,0,12
2582,2022/11/07,7,0,1,0,8
2586,2022/11/07,31,16,11,10,42
2631,2022/11/07,15,6,1,0,16
2685,2022/11/07,8,8,2,0,10
2723,2022/11/07,10,0,1,0,11
2730,2022/11/07,14,0,0,0,14
2731,2022/11/07,8,0,0,0,8
2732,2022/11/07,15,0,3,0,18
2734,2022/11/07,8,0,4,0,12
2735,2022/11/07,11,8,0,0,11
2761,2022/11/07,31,15,8,4,39
2788,2022/11/07,16,16,16,0,32
2802,2022/11/07,7,0,0,0,7
2812,2022/11/07,10,0,0,0,10
2813,2022/11/07,7,0,0,0,7
2913,2022/11/07,7,0,0,0,7
2914,2022/11/07,10,0,0,0,10
3015,2022/11/07,5,0,3,0,8
3033,2022/11/07,10,0,0,0,10
3035,2022/11/07,8,0,0,0,8
4446,2022/11/07,15,12,9,0,24
12136,2022/11/07,31,24,24,0,55
12516,2022/11/07,15,0,0,0,15
12518,2022/11/07,11,4,0,0,11
12523,2022/11/07,10,0,4,0,14
16062,2022/11/07,14,0,0,0,14
16063,2022/11/07,7,6,0,0,7
16276,2022/11/07,8,0,0,0,8
19322,2022/11/07,11,0,1,0,12
19329,2022/11/07,11,6,0,0,11
19521,2022/11/07,8,0,1,0,9
20901,2022/11/07,11,0,0,0,11
20920,2022/11/07,11,0,2,0,13
21103,2022/11/07,20,10,1,0,21
21132,2022/11/07,17,12,13,2,30
21171,2022/11/07,10,4,3,0,13
21174,2022/11/07,8,8,6,0,14
21175,2022/11/07,17,12,11,0,28
21176,2022/11/07,12,8,5,0,17
75,2022/11/08,29,24,22,0,51
76,2022/11/08,30,32,36,0,66
99,2022/11/08,12,0,0,0,12
117,2022/11/08,5,4,1,0,6
118,2022/11/08,8,4,2,0,10
119,2022/11/08,5,4,2,0,7
120,2022/11/08,4,0,1,0,5
149,2022/11/08,7,0,0,0,7
184,2022/11/08,14,12,5,0,19
195,2022/11/08,33,30,22,1,55
218,2022/11/08,25,24,26,0,51
296,2022/11/08,10,0,5,0,15
300,2022/11/08,19,0,6,1,25
304,2022/11/08,5,0,4,0,9
317,2022/11/08,23,6,3,0,26
343,2022/11/08,7,0,1,2,8
373,2022/11/08,20,6,5,0,25
374,2022/11/08,10,8,3,0,13
388,2022/11/08,40,30,29,0,69
419,2022/11/08,10,6,6,0,16
420,2022/11/08,14,0,3,0,17
462,2022/11/08,15,8,7,0,22
519,2022/11/08,16,6,7,0,23
525,2022/11/08,9,0,5,0,14
596,2022/11/08,12,8,10,0,22
597,2022/11/08,18,12,12,0,30
598,2022/11/08,10,0,0,0,10
1035,2022/11/08,6,0,3,0,9
1084,2022/11/08,19,10,16,0,35
1111,2022/11/08,6,6,0,0,6
1112,2022/11/08,6,0,1,0,7
1113,2022/11/08,10,0,2,0,12
1114,2022/11/08,10,6,1,0,11
1115,2022/11/08,6,0,2,0,8
1117,2022/11/08,9,0,0,0,9
1118,2022/11/08,9,0,1,0,10
1119,2022/11/08,5,0,1,0,6
1692,2022/11/08,8,0,3,0,11
1693,2022/11/08,9,0,0,0,9
1747,2022/11/08,24,20,18,0,42
1772,2022/11/08,10,0,2,0,12
1773,2022/11/08,14,0,0,0,14
1774,2022/11/08,9,0,0,0,9
1782,2022/11/08,39,24,26,5,65
1795,2022/11/08,25,14,10,1,35
1914,2022/11/08,7,0,0,0,7
1915,2022/11/08,9,0,0,0,9
1923,2022/11/08,9,0,1,0,10
1934,2022/11/08,13,5,2,0,15
1963,2022/11/08,33,12,11,0,44
1984,2022/11/08,8,6,3,0,11
2135,2022/11/08,6,0,0,0,6
2136,2022/11/08,11,0,1,0,12
2148,2022/11/08,15,4,0,0,15
2183,2022/11/08,14,6,2,0,16
2193,2022/11/08,9,12,10,0,19
2237,2022/11/08,8,0,1,0,9
2358,2022/11/08,9,8,3,0,12
2361,2022/11/08,18,0,4,0,22
2445,2022/11/08,14,6,9,0,23
2449,2022/11/08,18,6,4,0,22
2451,2022/11/08,13,0,5,0,18
2476,2022/11/08,5,0,0,0,5
2507,2022/11/08,11,0,3,3,14
2525,2022/11/08,5,0,2,0,7
2562,2022/11/08,16,6,0,0,16
2582,2022/11/08,10,4,3,0,13
2586,2022/11/08,22,12,14,2,36
2602,2022/11/08,16,0,1,0,17
2631,2022/11/08,20,6,2,0,22
2685,2022/11/08,14,8,7,0,21
2723,2022/11/08,9,0,2,0,11
2730,2022/11/08,14,0,1,0,15
2731,2022/11/08,8,0,0,0,8
2732,2022/11/08,12,0,1,0,13
2734,2022/11/08,8,4,3,0,11
2735,2022/11/08,11,0,1,0,12
2761,2022/11/08,34,15,14,0,48
2788,2022/11/08,20,20,19,1,39
2802,2022/11/08,7,0,0,0,7
2812,2022/11/08,10,0,0,0,10
2813,2022/11/08,7,0,1,0,8
2913,2022/11/08,13,6,2,0,15
2914,2022/11/08,10,0,0,0,10
3015,2022/11/08,10,8,1,0,11
3033,2022/11/08,10,0,1,0,11
3035,2022/11/08,8,0,3,0,11
4446,2022/11/08,15,9,9,0,24
12136,2022/11/08,28,21,21,0,49
12516,2022/11/08,19,4,3,0,22
12518,2022/11/08,15,4,0,0,15
12523,2022/11/08,10,4,1,0,11
16062,2022/11/08,14,0,2,0,16
16063,2022/11/08,7,0,2,0,9
16276,2022/11/08,8,0,0,0,8
19322,2022/11/08,10,0,0,0,10
19329,2022/11/08,11,0,1,0,12
19520,2022/11/08,16,0,1,0,17
19521,2022/11/08,7,0,0,0,7
20901,2022/11/08,11,0,1,0,12
20920,2022/11/08,9,0,0,0,9
21102,2022/11/08,20,0,1,0,21
21103,2022/11/08,19,0,0,0,19
21132,2022/11/08,20,18,17,1,37
21171,2022/11/08,11,4,3,1,14
21174,2022/11/08,14,12,12,0,26
21175,2022/11/08,14,8,3,0,17
21176,2022/11/08,11,4,2,4,13
75,2022/11/09,47,40,36,0,83
76,2022/11/09,34,40,43,0,77
99,2022/11/09,12,0,0,0,12
117,2022/11/09,4,0,2,0,6
118,2022/11/09,10,4,1,0,11
119,2022/11/09,3,0,3,0,6
120,2022/11/09,7,4,3,0,10
149,2022/11/09,7,0,0,0,7
184,2022/11/09,15,6,9,0,24
195,2022/11/09,40,30,29,0,69
218,2022/11/09,29,30,26,0,55
296,2022/11/09,5,0,9,0,14
300,2022/11/09,12,0,0,6,12
304,2022/11/09,7,6,4,0,11
317,2022/11/09,20,0,5,0,25
343,2022/11/09,4,0,4,0,8
353,2022/11/09,10,0,1,0,11
373,2022/11/09,15,0,7,0,22
374,2022/11/09,7,0,2,0,9
388,2022/11/09,41,30,26,1,67
419,2022/11/09,10,6,3,0,13
420,2022/11/09,11,0,1,0,12
462,2022/11/09,16,8,4,4,20
519,2022/11/09,9,0,6,0,15
525,2022/11/09,4,0,3,0,7
596,2022/11/09,10,8,6,0,16
597,2022/11/09,18,12,11,0,29
598,2022/11/09,10,0,3,0,13
1035,2022/11/09,3,0,3,0,6
1084,2022/11/09,13,10,10,0,23
1111,2022/11/09,6,0,1,0,7
1112,2022/11/09,5,0,1,0,6
1113,2022/11/09,8,0,1,0,9
1114,2022/11/09,9,0,3,0,12
1115,2022/11/09,4,0,0,0,4
1117,2022/11/09,9,0,1,0,10
1118,2022/11/09,8,0,2,0,10
1119,2022/11/09,4,0,0,0,4
1692,2022/11/09,11,6,2,0,13
1693,2022/11/09,9,0,1,0,10
1747,2022/11/09,26,20,13,0,39
1772,2022/11/09,8,0,0,0,8
1773,2022/11/09,14,0,2,0,16
1774,2022/11/09,9,0,1,0,10
1782,2022/11/09,32,24,22,2,54
1795,2022/11/09,28,14,22,0,50
1914,2022/11/09,7,0,1,0,8
1915,2022/11/09,9,0,1,0,10
1923,2022/11/09,8,0,1,0,9
1934,2022/11/09,11,0,4,1,15
1963,2022/11/09,28,6,3,0,31
1984,2022/11/09,11,6,1,0,12
2135,2022/11/09,6,0,3,0,9
2136,2022/11/09,10,0,0,0,10
2148,2022/11/09,15,0,3,0,18
2183,2022/11/09,12,0,5,0,17
2193,2022/11/09,14,15,16,0,30
2237,2022/11/09,7,0,0,0,7
2358,2022/11/09,10,4,4,0,14
2361,2022/11/09,28,14,3,2,31
2445,2022/11/09,11,6,3,0,14
2449,2022/11/09,14,0,6,0,20
2451,2022/11/09,8,0,7,0,15
2476,2022/11/09,5,0,0,0,5
2507,2022/11/09,5,0,8,0,13
2525,2022/11/09,3,0,1,0,4
2562,2022/11/09,16,0,2,0,18
2582,2022/11/09,7,0,0,1,7
2586,2022/11/09,18,12,14,0,32
2602,2022/11/09,15,0,4,0,19
2631,2022/11/09,18,0,0,0,18
2685,2022/11/09,11,4,4,0,15
2723,2022/11/09,7,0,0,0,7
2730,2022/11/09,13,0,1,0,14
2731,2022/11/09,8,0,1,0,9
2732,2022/11/09,11,0,1,0,12
2734,2022/11/09,9,4,1,0,10
2735,2022/11/09,10,0,2,0,12
2761,2022/11/09,30,10,15,0,45
2788,2022/11/09,16,16,19,0,35
2802,2022/11/09,7,0,0,0,7
2812,2022/11/09,10,0,0,0,10
2813,2022/11/09,6,0,0,0,6
2913,2022/11/09,11,0,1,0,12
2914,2022/11/09,10,0,0,0,10
3015,2022/11/09,9,0,2,0,11
3033,2022/11/09,9,0,0,0,9
3035,2022/11/09,5,0,2,0,7
4446,2022/11/09,15,9,3,0,18
12136,2022/11/09,31,24,16,0,47
12516,2022/11/09,16,0,2,0,18
12518,2022/11/09,15,0,3,0,18
12523,2022/11/09,9,0,3,0,12
16062,2022/11/09,12,0,2,0,14
16063,2022/11/09,5,0,0,0,5
16276,2022/11/09,8,0,2,4,10
19322,2022/11/09,10,0,0,0,10
19329,2022/11/09,10,0,2,0,12
19520,2022/11/09,15,0,0,0,15
19521,2022/11/09,7,0,0,0,7
20901,2022/11/09,10,0,0,0,10
20920,2022/11/09,9,0,1,0,10
21102,2022/11/09,19,0,1,0,20
21103,2022/11/09,19,0,0,0,19
21132,2022/11/09,17,15,13,1,30
21171,2022/11/09,7,0,4,1,11
21174,2022/11/09,14,12,9,0,23
21175,2022/11/09,15,4,7,0,22
21176,2022/11/09,9,4,3,2,12
75,2022/11/10,43,32,34,0,77
76,2022/11/10,35,44,40,1,75
99,2022/11/10,12,0,0,0,12
117,2022/11/10,6,4,1,0,7
118,2022/11/10,13,4,0,0,13
119,2022/11/10,4,4,1,0,5
120,2022/11/10,4,0,3,0,7
149,2022/11/10,7,0,2,0,9
184,2022/11/10,18,12,11,0,29
195,2022/11/10,41,30,33,0,74
218,2022/11/10,24,21,23,0,47
296,2022/11/10,2,6,3,0,5
300,2022/11/10,14,8,2,0,16
304,2022/11/10,9,6,5,0,14
317,2022/11/10,15,0,4,0,19
343,2022/11/10,4,4,2,0,6
353,2022/11/10,9,0,1,0,10
373,2022/11/10,8,0,5,0,13
374,2022/11/10,9,4,1,0,10
388,2022/11/10,41,27,30,0,71
419,2022/11/10,19,12,9,0,28
420,2022/11/10,16,6,1,0,17
462,2022/11/10,8,0,7,0,15
519,2022/11/10,3,0,3,0,6
525,2022/11/10,1,0,0,0,1
596,2022/11/10,12,8,5,0,17
597,2022/11/10,19,12,13,0,32
598,2022/11/10,7,0,0,0,7
1035,2022/11/10,0,0,0,0,0
1084,2022/11/10,8,5,4,0,12
1111,2022/11/10,5,0,0,0,5
1112,2022/11/10,4,0,0,0,4
1113,2022/11/10,7,0,1,0,8
1114,2022/11/10,12,6,0,0,12
1115,2022/11/10,10,6,2,0,12
1117,2022/11/10,8,0,0,0,8
1118,2022/11/10,6,0,2,0,8
1119,2022/11/10,10,6,0,0,10
1692,2022/11/10,9,0,1,0,10
1693,2022/11/10,8,0,0,0,8
1747,2022/11/10,33,20,19,0,52
1772,2022/11/10,8,0,2,0,10
1773,2022/11/10,12,0,4,0,16
1774,2022/11/10,8,0,2,0,10
1782,2022/11/10,26,18,22,3,48
1795,2022/11/10,20,14,16,0,36
1914,2022/11/10,12,6,0,0,12
1915,2022/11/10,8,0,0,0,8
1923,2022/11/10,13,6,0,0,13
1934,2022/11/10,11,5,2,0,13
1963,2022/11/10,25,0,5,0,30
1984,2022/11/10,10,0,0,0,10
2135,2022/11/10,9,6,2,0,11
2136,2022/11/10,10,0,4,0,14
2148,2022/11/10,12,0,0,0,12
2183,2022/11/10,13,6,3,0,16
2193,2022/11/10,13,15,10,0,23
2237,2022/11/10,7,0,0,0,7
2358,2022/11/10,14,8,2,0,16
2361,2022/11/10,23,0,6,0,29
2445,2022/11/10,14,6,6,0,20
2449,2022/11/10,8,0,6,0,14
2451,2022/11/10,16,15,12,1,28
2475,2022/11/10,8,0,1,0,9
2476,2022/11/10,11,6,1,0,12
2507,2022/11/10,3,6,5,0,8
2525,2022/11/10,2,0,0,0,2
2562,2022/11/10,14,0,1,0,15
2582,2022/11/10,6,0,0,0,6
2586,2022/11/10,16,12,15,1,31
2602,2022/11/10,11,0,1,0,12
2631,2022/11/10,18,0,5,6,23
2685,2022/11/10,15,8,3,2,18
2723,2022/11/10,7,0,1,0,8
2730,2022/11/10,12,0,2,0,14
2731,2022/11/10,7,0,0,0,7
2732,2022/11/10,10,0,2,0,12
2734,2022/11/10,8,0,6,0,14
2735,2022/11/10,16,8,3,0,19
2761,2022/11/10,30,15,20,0,50
2788,2022/11/10,17,20,15,0,32
2802,2022/11/10,7,0,0,0,7
2812,2022/11/10,10,0,0,0,10
2813,2022/11/10,12,6,0,0,12
2814,2022/11/10,6,6,1,0,7
2913,2022/11/10,10,0,3,0,13
2914,2022/11/10,10,0,1,0,11
3015,2022/11/10,7,0,3,0,10
3033,2022/11/10,9,0,1,0,10
3035,2022/11/10,3,0,1,0,4
4446,2022/11/10,27,15,8,0,35
12136,2022/11/10,36,21,20,0,56
12516,2022/11/10,14,0,2,0,16
12518,2022/11/10,12,0,4,0,16
12523,2022/11/10,10,4,3,0,13
16062,2022/11/10,10,0,1,0,11
16063,2022/11/10,11,6,1,0,12
16276,2022/11/10,2,0,0,0,2
19322,2022/11/10,10,0,1,0,11
19329,2022/11/10,8,0,3,0,11
19520,2022/11/10,15,0,0,0,15
19521,2022/11/10,7,0,0,0,7
20901,2022/11/10,10,0,0,0,10
20920,2022/11/10,8,0,0,0,8
21102,2022/11/10,18,0,0,0,18
21103,2022/11/10,19,0,0,0,19
21132,2022/11/10,18,15,18,0,36
21171,2022/11/10,6,4,2,0,8
21174,2022/11/10,17,12,14,0,31
21175,2022/11/10,12,4,7,0,19
21176,2022/11/10,8,4,5,1,13
75,2022/11/11,45,36,39,0,84
76,2022/11/11,34,40,30,0,64
99,2022/11/11,12,0,1,0,13
117,2022/11/11,5,0,1,0,6
118,2022/11/11,13,0,3,0,16
119,2022/11/11,3,0,3,0,6
120,2022/11/11,1,0,1,0,2
149,2022/11/11,5,0,1,0,6
184,2022/11/11,19,12,16,0,35
195,2022/11/11,32,24,27,0,59
218,2022/11/11,25,24,20,0,45
296,2022/11/11,5,6,4,0,9
300,2022/11/11,12,0,3,0,15
304,2022/11/11,10,6,1,0,11
317,2022/11/11,11,0,1,0,12
343,2022/11/11,2,0,2,0,4
353,2022/11/11,8,0,2,0,10
373,2022/11/11,3,0,0,4,3
374,2022/11/11,12,4,2,0,14
388,2022/11/11,38,27,24,3,62
419,2022/11/11,16,6,3,0,19
420,2022/11/11,15,0,1,0,16
462,2022/11/11,17,16,4,0,21
519,2022/11/11,12,12,8,0,20
525,2022/11/11,6,5,2,0,8
596,2022/11/11,11,4,1,0,12
597,2022/11/11,36,30,15,1,51
598,2022/11/11,7,0,2,0,9
1035,2022/11/11,12,12,5,0,17
1084,2022/11/11,19,15,11,0,30
1111,2022/11/11,5,0,0,0,5
1112,2022/11/11,10,6,0,0,10
1113,2022/11/11,6,0,2,0,8
1114,2022/11/11,12,0,1,0,13
1115,2022/11/11,8,0,1,0,9
1117,2022/11/11,8,0,0,0,8
1118,2022/11/11,4,0,3,0,7
1119,2022/11/11,10,0,2,0,12
1692,2022/11/11,8,0,2,0,10
1693,2022/11/11,8,0,1,0,9
1747,2022/11/11,34,20,35,0,69
1772,2022/11/11,6,0,0,0,6
1773,2022/11/11,8,0,0,0,8
1774,2022/11/11,6,0,2,0,8
1782,2022/11/11,4,3,3,0,7
1795,2022/11/11,4,0,3,0,7
1914,2022/11/11,12,0,1,0,13
1915,2022/11/11,8,0,3,0,11
1923,2022/11/11,13,0,2,0,15
1934,2022/11/11,9,0,2,2,11
1963,2022/11/11,20,0,6,0,26
1984,2022/11/11,16,6,5,0,21
2135,2022/11/11,13,6,2,0,15
2136,2022/11/11,6,0,0,0,6
2148,2022/11/11,12,0,3,0,15
2183,2022/11/11,10,0,5,0,15
2193,2022/11/11,18,15,13,0,31
2237,2022/11/11,7,0,3,0,10
2358,2022/11/11,16,4,6,0,22
2361,2022/11/11,17,0,0,4,17
2445,2022/11/11,20,12,9,0,29
2449,2022/11/11,2,0,2,0,4
2451,2022/11/11,18,15,10,0,28
2475,2022/11/11,7,0,2,0,9
2476,2022/11/11,10,0,0,0,10
2507,2022/11/11,10,12,4,0,14
2525,2022/11/11,8,6,0,0,8
2562,2022/11/11,13,0,4,0,17
2582,2022/11/11,10,4,3,0,13
2586,2022/11/11,12,12,13,0,25
2602,2022/11/11,10,0,1,0,11
2631,2022/11/11,7,0,1,2,8
2685,2022/11/11,18,8,9,4,27
2723,2022/11/11,14,8,1,0,15
2730,2022/11/11,10,0,1,0,11
2731,2022/11/11,7,0,4,0,11
2732,2022/11/11,8,0,2,0,10
2734,2022/11/11,6,4,5,0,11
2735,2022/11/11,13,0,2,0,15
2761,2022/11/11,20,10,16,2,36
2788,2022/11/11,18,16,20,0,38
2802,2022/11/11,7,0,0,0,7
2812,2022/11/11,10,0,0,0,10
2813,2022/11/11,12,0,2,0,14
2814,2022/11/11,11,6,0,0,11
2913,2022/11/11,7,0,1,0,8
2914,2022/11/11,9,0,2,0,11
3015,2022/11/11,4,0,2,0,6
3033,2022/11/11,8,0,0,0,8
3035,2022/11/11,8,6,3,0,11
4446,2022/11/11,31,12,18,3,49
12136,2022/11/11,34,18,20,0,54
12516,2022/11/11,12,0,4,0,16
12518,2022/11/11,8,0,2,0,10
12523,2022/11/11,11,4,1,0,12
16062,2022/11/11,9,0,1,0,10
16063,2022/11/11,16,6,1,0,17
16276,2022/11/11,2,0,0,0,2
19322,2022/11/11,9,0,2,0,11
19329,2022/11/11,5,0,2,0,7
19520,2022/11/11,15,0,0,0,15
19521,2022/11/11,7,0,0,0,7
20901,2022/11/11,10,0,0,0,10
20920,2022/11/11,8,0,1,0,9
21102,2022/11/11,18,0,0,0,18
21103,2022/11/11,19,0,0,0,19
21132,2022/11/11,18,18,18,0,36
21171,2022/11/11,4,0,1,0,5
21174,2022/11/11,11,8,11,0,22
21175,2022/11/11,13,8,8,0,21
21176,2022/11/11,10,8,8,1,18
75,2022/11/12,38,32,29,2,67
76,2022/11/12,40,36,35,0,75
99,2022/11/12,11,0,0,0,11
117,2022/11/12,4,0,1,0,5
118,2022/11/12,10,0,3,0,13
119,2022/11/12,4,4,1,0,5
120,2022/11/12,4,4,1,0,5
149,2022/11/12,4,0,1,0,5
184,2022/11/12,9,6,6,0,15
195,2022/11/12,26,21,20,0,46
218,2022/11/12,29,24,35,0,64
296,2022/11/12,7,6,3,0,10
300,2022/11/12,9,0,4,0,13
304,2022/11/12,15,6,6,0,21
317,2022/11/12,16,6,2,0,18
343,2022/11/12,0,0,0,0,0
353,2022/11/12,6,0,0,0,6
373,2022/11/12,-1,0,1,0,0
374,2022/11/12,14,4,4,0,18
388,2022/11/12,20,9,13,0,33
419,2022/11/12,19,6,7,0,26
420,2022/11/12,14,0,1,0,15
462,2022/11/12,13,0,6,0,19
519,2022/11/12,10,6,5,0,15
525,2022/11/12,4,0,2,0,6
596,2022/11/12,10,0,5,0,15
597,2022/11/12,20,0,8,0,28
598,2022/11/12,5,0,2,0,7
1035,2022/11/12,13,6,5,0,18
1084,2022/11/12,8,0,5,0,13
1111,2022/11/12,5,0,0,0,5
1112,2022/11/12,10,0,0,0,10
1113,2022/11/12,10,6,0,0,10
1114,2022/11/12,17,6,4,0,21
1115,2022/11/12,7,0,2,0,9
1117,2022/11/12,8,0,2,0,10
1118,2022/11/12,7,6,5,0,12
1119,2022/11/12,8,0,0,0,8
1692,2022/11/12,12,6,1,0,13
1693,2022/11/12,7,0,0,0,7
1747,2022/11/12,14,15,12,0,26
1772,2022/11/12,6,0,0,0,6
1773,2022/11/12,8,0,1,0,9
1774,2022/11/12,12,8,2,0,14
1782,2022/11/12,16,15,16,0,32
1795,2022/11/12,15,14,13,0,28
1914,2022/11/12,11,0,3,0,14
1915,2022/11/12,5,0,2,0,7
1923,2022/11/12,11,0,1,0,12
1934,2022/11/12,5,0,1,1,6
1963,2022/11/12,14,0,2,0,16
1984,2022/11/12,17,6,1,0,18
2135,2022/11/12,11,0,4,0,15
2136,2022/11/12,6,0,0,0,6
2148,2022/11/12,9,0,0,0,9
2183,2022/11/12,5,0,5,0,10
2193,2022/11/12,20,15,15,0,35
2237,2022/11/12,4,0,2,0,6
2358,2022/11/12,14,4,3,0,17
2361,2022/11/12,13,0,0,0,13
2445,2022/11/12,17,6,8,0,25
2449,2022/11/12,6,6,3,0,9
2451,2022/11/12,18,10,8,0,26
2475,2022/11/12,5,0,0,0,5
2476,2022/11/12,10,0,1,0,11
2507,2022/11/12,18,12,10,0,28
2525,2022/11/12,14,6,3,0,17
2562,2022/11/12,9,0,1,0,10
2582,2022/11/12,7,0,2,0,9
2586,2022/11/12,19,20,9,0,28
2602,2022/11/12,9,0,0,0,9
2631,2022/11/12,4,0,3,1,7
2685,2022/11/12,13,8,2,0,15
2723,2022/11/12,13,0,0,0,13
2730,2022/11/12,9,0,2,0,11
2731,2022/11/12,3,0,1,0,4
2732,2022/11/12,6,0,3,0,9
2734,2022/11/12,1,0,2,0,3
2735,2022/11/12,11,0,9,0,20
2761,2022/11/12,7,5,5,0,12
2788,2022/11/12,14,16,13,0,27
2802,2022/11/12,7,0,0,0,7
2813,2022/11/12,10,0,0,0,10
2814,2022/11/12,11,0,3,0,14
2913,2022/11/12,6,0,0,0,6
2914,2022/11/12,7,0,1,0,8
3015,2022/11/12,10,8,1,0,11
3033,2022/11/12,8,0,0,0,8
3035,2022/11/12,5,0,0,0,5
4446,2022/11/12,22,12,6,1,28
12136,2022/11/12,32,18,12,0,44
12516,2022/11/12,8,0,1,0,9
12518,2022/11/12,6,0,1,0,7
12523,2022/11/12,14,4,5,0,19
16062,2022/11/12,8,0,2,0,10
16063,2022/11/12,15,0,2,0,17
16276,2022/11/12,2,0,1,0,3
19322,2022/11/12,7,0,0,0,7
19329,2022/11/12,3,0,0,0,3
19520,2022/11/12,15,0,0,0,15
19521,2022/11/12,7,0,2,0,9
20901,2022/11/12,10,0,0,0,10
20920,2022/11/12,7,0,1,0,8
21102,2022/11/12,18,0,1,0,19
21103,2022/11/12,19,0,1,0,20
21132,2022/11/12,15,15,14,0,29
21171,2022/11/12,7,4,4,0,11
21174,2022/11/12,8,8,6,0,14
21175,2022/11/12,13,8,7,0,20
21176,2022/11/12,5,4,5,1,10
75,2022/11/13,18,20,19,0,37
76,2022/11/13,35,36,31,0,66
99,2022/11/13,11,0,1,0,12
117,2022/11/13,7,4,2,1,9
118,2022/11/13,7,0,3,3,10
119,2022/11/13,3,0,3,0,6
120,2022/11/13,3,0,0,0,3
149,2022/11/13,9,6,2,0,11
184,2022/11/13,4,6,4,0,8
195,2022/11/13,18,21,20,0,38
218,2022/11/13,6,18,9,0,15
296,2022/11/13,16,12,1,0,17
300,2022/11/13,13,8,5,0,18
304,2022/11/13,15,6,1,0,16
317,2022/11/13,20,6,7,0,27
343,2022/11/13,4,4,2,0,6
353,2022/11/13,6,0,0,0,6
373,2022/11/13,4,6,5,1,9
374,2022/11/13,14,4,2,0,16
388,2022/11/13,17,18,17,0,34
419,2022/11/13,18,6,5,0,23
420,2022/11/13,13,0,2,0,15
462,2022/11/13,23,16,9,0,32
519,2022/11/13,17,12,11,0,28
525,2022/11/13,7,5,2,0,9
596,2022/11/13,12,8,1,2,13
597,2022/11/13,24,12,16,0,40
598,2022/11/13,9,6,1,0,10
1035,2022/11/13,14,6,1,0,15
1084,2022/11/13,14,15,10,0,24
1111,2022/11/13,11,6,1,0,12
1112,2022/11/13,10,0,3,0,13
1113,2022/11/13,10,0,1,0,11
1114,2022/11/13,13,0,8,0,21
1115,2022/11/13,11,6,2,0,13
1117,2022/11/13,6,0,0,0,6
1118,2022/11/13,8,6,3,0,11
1119,2022/11/13,8,0,0,0,8
1692,2022/11/13,11,0,4,0,15
1693,2022/11/13,7,0,1,0,8
1747,2022/11/13,14,15,18,0,32
1772,2022/11/13,6,0,0,0,6
1773,2022/11/13,13,6,0,0,13
1774,2022/11/13,10,0,4,0,14
1782,2022/11/13,18,18,18,0,36
1795,2022/11/13,1,0,1,0,2
1914,2022/11/13,8,0,0,0,8
1915,2022/11/13,3,0,0,0,3
1923,2022/11/13,10,0,2,0,12
1934,2022/11/13,8,5,2,0,10
1963,2022/11/13,18,6,3,0,21
1984,2022/11/13,22,6,6,0,28
2135,2022/11/13,7,0,3,0,10
2136,2022/11/13,12,6,2,0,14
2148,2022/11/13,13,4,2,0,15
2183,2022/11/13,6,6,5,0,11
2193,2022/11/13,17,12,12,3,29
2237,2022/11/13,8,6,1,0,9
2358,2022/11/13,19,8,7,0,26
2361,2022/11/13,5,0,6,0,11
2445,2022/11/13,15,6,1,0,16
2449,2022/11/13,9,6,5,0,14
2451,2022/11/13,34,30,16,0,50
2475,2022/11/13,5,0,2,0,7
2476,2022/11/13,9,0,2,0,11
2507,2022/11/13,20,12,9,0,29
2525,2022/11/13,11,0,1,0,12
2562,2022/11/13,14,6,2,0,16
2582,2022/11/13,5,0,3,0,8
2586,2022/11/13,26,16,15,0,41
2602,2022/11/13,9,0,1,0,10
2631,2022/11/13,6,6,2,0,8
2685,2022/11/13,19,8,5,0,24
2723,2022/11/13,13,0,1,0,14
2730,2022/11/13,13,6,1,0,14
2731,2022/11/13,2,0,0,0,2
2732,2022/11/13,3,0,1,0,4
2734,2022/11/13,3,4,3,0,6
2735,2022/11/13,2,0,0,0,2
2761,2022/11/13,15,15,12,0,27
2788,2022/11/13,16,16,17,0,33
2802,2022/11/13,7,0,1,0,8
2812,2022/11/13,10,0,3,0,13
2813,2022/11/13,10,0,1,0,11
2814,2022/11/13,8,0,2,0,10
2913,2022/11/13,6,0,1,2,7
2914,2022/11/13,6,0,0,0,6
3015,2022/11/13,9,0,4,0,13
3033,2022/11/13,8,0,0,0,8
3035,2022/11/13,5,0,2,0,7
4446,2022/11/13,14,6,10,0,24
12136,2022/11/13,1,0,6,0,7
12516,2022/11/13,7,0,3,1,10
12518,2022/11/13,9,4,5,0,14
12523,2022/11/13,13,4,1,0,14
16062,2022/11/13,12,6,0,0,12
16063,2022/11/13,13,0,1,0,14
16276,2022/11/13,7,6,1,0,8
19322,2022/11/13,7,0,0,0,7
19329,2022/11/13,9,6,1,0,10
19520,2022/11/13,15,0,1,0,16
19521,2022/11/13,5,0,0,0,5
20901,2022/11/13,10,0,1,0,11
20920,2022/11/13,6,0,1,0,7
21102,2022/11/13,17,0,0,0,17
21103,2022/11/13,18,0,0,0,18
21132,2022/11/13,12,12,15,0,27
21171,2022/11/13,7,4,3,0,10
21174,2022/11/13,8,8,8,0,16
21175,2022/11/13,8,8,8,0,16
21176,2022/11/13,7,8,3,0,10
75,2022/11/14,31,32,38,0,69
76,2022/11/14,40,36,50,0,90
99,2022/11/14,10,0,3,0,13
117,2022/11/14,4,0,2,0,6
118,2022/11/14,1,0,1,0,2
119,2022/11/14,0,0,3,0,3
120,2022/11/14,7,4,2,0,9
149,2022/11/14,7,0,0,0,7
184,2022/11/14,6,6,3,0,9
195,2022/11/14,25,27,30,0,55
218,2022/11/14,24,27,26,0,50
296,2022/11/14,21,6,5,0,26
300,2022/11/14,8,0,2,0,10
304,2022/11/14,14,0,7,0,21
317,2022/11/14,19,6,6,0,25
343,2022/11/14,6,4,1,0,7
353,2022/11/14,6,0,0,0,6
373,2022/11/14,4,6,2,0,6
374,2022/11/14,12,0,8,0,20
388,2022/11/14,27,27,27,0,54
419,2022/11/14,19,6,4,0,23
420,2022/11/14,11,0,1,2,12
462,2022/11/14,14,0,11,0,25
519,2022/11/14,12,6,4,0,16
525,2022/11/14,5,0,1,0,6
596,2022/11/14,17,8,6,2,23
597,2022/11/14,20,12,12,0,32
598,2022/11/14,8,0,3,0,11
1035,2022/11/14,19,6,1,0,20
1084,2022/11/14,14,10,7,0,21
1111,2022/11/14,10,0,0,0,10
1112,2022/11/14,7,0,0,0,7
1113,2022/11/14,9,0,0,0,9
1114,2022/11/14,5,0,2,0,7
1115,2022/11/14,9,0,0,0,9
1117,2022/11/14,6,0,1,0,7
1118,2022/11/14,5,0,1,0,6
1119,2022/11/14,8,0,0,0,8
1692,2022/11/14,13,6,6,2,19
1693,2022/11/14,12,6,3,2,15
1747,2022/11/14,11,15,17,0,28
1772,2022/11/14,6,0,1,0,7
1773,2022/11/14,13,0,0,0,13
1774,2022/11/14,6,0,2,0,8
1782,2022/11/14,12,12,19,0,31
1795,2022/11/14,14,14,14,0,28
1914,2022/11/14,8,0,0,0,8
1915,2022/11/14,9,6,1,0,10
1923,2022/11/14,8,0,0,0,8
1934,2022/11/14,6,0,2,0,8
1963,2022/11/14,21,6,10,0,31
1984,2022/11/14,16,0,4,2,20
2135,2022/11/14,4,0,1,0,5
2136,2022/11/14,10,0,1,0,11
2148,2022/11/14,11,0,5,0,16
2183,2022/11/14,1,0,3,0,4
2193,2022/11/14,14,12,19,0,33
2237,2022/11/14,7,0,2,0,9
2358,2022/11/14,12,0,8,0,20
2361,2022/11/14,6,7,2,0,8
2445,2022/11/14,14,0,2,0,16
2449,2022/11/14,10,6,2,0,12
2451,2022/11/14,18,0,15,0,33
2475,2022/11/14,3,0,0,0,3
2476,2022/11/14,7,0,0,0,7
2507,2022/11/14,17,6,16,0,33
2525,2022/11/14,10,0,0,0,10
2562,2022/11/14,12,0,2,7,14
2582,2022/11/14,2,0,5,0,7
2586,2022/11/14,19,8,22,0,41
2602,2022/11/14,8,0,0,0,8
2631,2022/11/14,10,6,1,0,11
2685,2022/11/14,14,0,4,0,18
2723,2022/11/14,12,0,1,0,13
2730,2022/11/14,12,0,2,0,14
2731,2022/11/14,8,6,0,0,8
2732,2022/11/14,10,8,1,0,11
2734,2022/11/14,0,0,1,0,1
2735,2022/11/14,10,8,3,0,13
2761,2022/11/14,18,15,19,0,37
2788,2022/11/14,15,16,21,0,36
2802,2022/11/14,12,6,0,0,12
2812,2022/11/14,7,0,0,0,7
2813,2022/11/14,9,0,0,0,9
2814,2022/11/14,6,0,1,0,7
2913,2022/11/14,9,6,2,0,11
2914,2022/11/14,12,6,2,0,14
3015,2022/11/14,5,0,3,0,8
3033,2022/11/14,8,0,1,0,9
3035,2022/11/14,9,6,1,0,10
4446,2022/11/14,10,6,11,0,21
12136,2022/11/14,19,24,24,0,43
12516,2022/11/14,3,0,2,0,5
12518,2022/11/14,8,4,2,0,10
12523,2022/11/14,12,0,2,0,14
16062,2022/11/14,12,0,0,0,12
16063,2022/11/14,12,0,1,0,13
16276,2022/11/14,6,0,2,0,8
19322,2022/11/14,7,0,0,0,7
19329,2022/11/14,8,0,1,0,9
19520,2022/11/14,14,0,0,0,14
19521,2022/11/14,5,0,0,0,5
20901,2022/11/14,9,0,0,0,9
20920,2022/11/14,5,0,1,0,6
21132,2022/11/14,12,15,16,0,28
21171,2022/11/14,8,4,2,1,10
21174,2022/11/14,12,12,12,0,24
21175,2022/11/14,8,8,9,0,17
21176,2022/11/14,12,8,7,0,19
75,2022/11/15,21,28,25,0,46
76,2022/11/15,26,36,37,0,63
99,2022/11/15,7,0,0,0,7
117,2022/11/15,2,0,2,0,4
118,2022/11/15,4,4,4,0,8
119,2022/11/15,1,4,1,0,2
120,2022/11/15,9,4,1,0,10
149,2022/11/15,7,0,1,0,8
184,2022/11/15,12,9,9,0,21
195,2022/11/15,22,27,30,0,52
218,2022/11/15,22,24,30,0,52
296,2022/11/15,22,6,4,0,26
300,2022/11/15,6,0,4,0,10
304,2022/11/15,7,0,5,0,12
317,2022/11/15,13,0,9,3,22
343,2022/11/15,5,0,3,0,8
353,2022/11/15,6,0,1,0,7
373,2022/11/15,2,0,4,0,6
374,2022/11/15,8,4,3,0,11
388,2022/11/15,27,27,29,0,56
419,2022/11/15,15,0,8,2,23
420,2022/11/15,8,0,1,0,9
462,2022/11/15,11,8,9,0,20
519,2022/11/15,14,6,3,0,17
525,2022/11/15,4,0,0,0,4
596,2022/11/15,9,0,3,0,12
597,2022/11/15,20,12,10,4,30
598,2022/11/15,5,0,0,0,5
1035,2022/11/15,18,0,4,1,22
1084,2022/11/15,17,10,13,0,30
1111,2022/11/15,10,0,1,0,11
1112,2022/11/15,7,0,1,0,8
1113,2022/11/15,9,0,1,0,10
1114,2022/11/15,3,0,2,0,5
1115,2022/11/15,9,0,0,0,9
1117,2022/11/15,5,0,1,0,6
1118,2022/11/15,10,6,0,0,10
1119,2022/11/15,8,0,0,0,8
1692,2022/11/15,5,0,4,0,9
1693,2022/11/15,7,0,0,0,7
1747,2022/11/15,19,25,26,0,45
1772,2022/11/15,5,0,0,0,5
1773,2022/11/15,13,0,0,0,13
1774,2022/11/15,4,0,2,0,6
1782,2022/11/15,17,24,17,0,34
1795,2022/11/15,14,14,7,0,21
1914,2022/11/15,8,0,0,0,8
1915,2022/11/15,8,0,0,0,8
1923,2022/11/15,8,0,0,0,8
1934,2022/11/15,9,5,1,2,10
1963,2022/11/15,11,0,4,0,15
1984,2022/11/15,10,0,1,0,11
2135,2022/11/15,3,0,1,0,4
2136,2022/11/15,9,0,0,0,9
2148,2022/11/15,6,0,1,0,7
2183,2022/11/15,4,6,0,0,4
2193,2022/11/15,4,9,3,0,7
2237,2022/11/15,11,6,1,0,12
2358,2022/11/15,4,0,2,0,6
2361,2022/11/15,4,0,2,0,6
2445,2022/11/15,18,6,6,0,24
2449,2022/11/15,8,0,2,0,10
2451,2022/11/15,4,0,2,0,6
2475,2022/11/15,9,6,0,0,9
2476,2022/11/15,7,0,0,0,7
2507,2022/11/15,1,0,2,0,3
2525,2022/11/15,10,0,0,0,10
2562,2022/11/15,9,6,0,0,9
2582,2022/11/15,1,4,1,0,2
2586,2022/11/15,9,12,11,0,20
2631,2022/11/15,9,0,5,0,14
2685,2022/11/15,18,8,8,2,26
2723,2022/11/15,11,0,0,0,11
2730,2022/11/15,10,0,1,0,11
2731,2022/11/15,8,0,2,0,10
2732,2022/11/15,9,0,0,0,9
2734,2022/11/15,7,8,8,0,15
2735,2022/11/15,7,0,1,0,8
2761,2022/11/15,14,15,13,0,27
2788,2022/11/15,14,20,19,0,33
2802,2022/11/15,12,0,1,0,13
2812,2022/11/15,7,0,0,0,7
2813,2022/11/15,9,0,0,0,9
2814,2022/11/15,5,0,1,0,6
2913,2022/11/15,7,0,0,0,7
2914,2022/11/15,10,0,0,0,10
3015,2022/11/15,2,0,0,0,2
3033,2022/11/15,7,0,0,0,7
3035,2022/11/15,8,0,0,0,8
4446,2022/11/15,11,12,10,0,21
12136,2022/11/15,19,24,33,0,52
12516,2022/11/15,5,4,1,0,6
12518,2022/11/15,10,4,2,0,12
12523,2022/11/15,14,4,3,0,17
16062,2022/11/15,12,0,0,0,12
16063,2022/11/15,11,0,1,0,12
16276,2022/11/15,4,0,0,0,4
19322,2022/11/15,7,0,0,0,7
19329,2022/11/15,7,0,0,0,7
19520,2022/11/15,14,0,0,0,14
19521,2022/11/15,13,8,1,0,14
20901,2022/11/15,9,0,0,0,9
20920,2022/11/15,4,0,2,0,6
21132,2022/11/15,11,15,15,0,26
21171,2022/11/15,9,4,5,0,14
21174,2022/11/15,12,12,12,0,24
21175,2022/11/15,7,8,7,0,14
21176,2022/11/15,9,4,6,2,15
75,2022/11/16,32,36,27,0,59
76,2022/11/16,32,44,31,0,63
99,2022/11/16,7,0,0,0,7
117,2022/11/16,4,4,0,0,4
118,2022/11/16,0,0,0,0,0
119,2022/11/16,0,0,0,0,0
120,2022/11/16,8,0,0,0,8
149,2022/11/16,6,0,0,0,6
184,2022/11/16,15,12,7,0,22
195,2022/11/16,22,30,23,0,45
218,2022/11/16,19,27,14,0,33
296,2022/11/16,18,0,2,0,20
300,2022/11/16,10,8,5,0,15
304,2022/11/16,8,6,2,0,10
317,2022/11/16,1,0,1,0,2
343,2022/11/16,6,4,2,0,8
353,2022/11/16,5,0,0,0,5
373,2022/11/16,4,6,4,0,8
374,2022/11/16,5,0,2,0,7
388,2022/11/16,25,27,25,0,50
419,2022/11/16,5,0,5,0,10
420,2022/11/16,13,6,5,0,18
462,2022/11/16,10,8,7,0,17
519,2022/11/16,11,0,5,0,16
525,2022/11/16,9,5,1,0,10
596,2022/11/16,14,8,2,0,16
597,2022/11/16,12,6,10,0,22
598,2022/11/16,5,0,1,0,6
1035,2022/11/16,13,0,4,3,17
1084,2022/11/16,14,10,10,0,24
1111,2022/11/16,9,0,0,0,9
1112,2022/11/16,6,0,0,0,6
1113,2022/11/16,8,0,1,0,9
1114,2022/11/16,7,6,2,0,9
1115,2022/11/16,9,0,1,0,10
1117,2022/11/16,4,0,0,0,4
1118,2022/11/16,10,0,3,0,13
1119,2022/11/16,8,0,1,0,9
1692,2022/11/16,1,0,0,0,1
1693,2022/11/16,7,0,1,0,8
1747,2022/11/16,13,20,19,0,32
1772,2022/11/16,5,0,0,0,5
1773,2022/11/16,13,0,1,0,14
1774,2022/11/16,2,0,2,0,4
1782,2022/11/16,24,24,25,0,49
1795,2022/11/16,21,14,7,0,28
1914,2022/11/16,8,0,1,0,9
1915,2022/11/16,8,0,1,0,9
1923,2022/11/16,8,0,1,0,9
1934,2022/11/16,6,0,3,0,9
1963,2022/11/16,13,6,8,0,21
1984,2022/11/16,9,0,5,3,14
2135,2022/11/16,2,0,3,0,5
2136,2022/11/16,9,0,0,0,9
2148,2022/11/16,5,0,1,0,6
2183,2022/11/16,4,0,0,0,4
2193,2022/11/16,13,12,12,0,25
2237,2022/11/16,10,0,1,0,11
2358,2022/11/16,6,4,4,0,10
2361,2022/11/16,9,7,4,0,13
2445,2022/11/16,18,6,2,0,20
2449,2022/11/16,12,6,6,0,18
2451,2022/11/16,1,0,0,0,1
2475,2022/11/16,9,0,0,0,9
2476,2022/11/16,7,0,0,0,7
2507,2022/11/16,5,6,5,0,10
2525,2022/11/16,10,0,1,0,11
2562,2022/11/16,9,0,1,0,10
2582,2022/11/16,0,0,0,0,0
2586,2022/11/16,9,12,9,0,18
2631,2022/11/16,10,6,1,0,11
2685,2022/11/16,8,0,7,0,15
2723,2022/11/16,11,0,0,0,11
2730,2022/11/16,9,0,2,0,11
2731,2022/11/16,6,0,0,0,6
2732,2022/11/16,9,0,0,0,9
2734,2022/11/16,-1,0,0,0,-1
2735,2022/11/16,14,8,3,0,17
2761,2022/11/16,16,15,15,0,31
2788,2022/11/16,15,20,16,0,31
2802,2022/11/16,11,0,1,0,12
2812,2022/11/16,7,0,1,0,8
2813,2022/11/16,9,0,0,0,9
2814,2022/11/16,4,0,1,0,5
2913,2022/11/16,7,0,0,0,7
2914,2022/11/16,10,0,1,0,11
3015,2022/11/16,10,8,0,0,10
3033,2022/11/16,7,0,0,0,7
3035,2022/11/16,8,0,1,0,9
4446,2022/11/16,10,9,8,0,18
12136,2022/11/16,10,24,12,0,22
12516,2022/11/16,8,4,4,0,12
12518,2022/11/16,8,0,2,0,10
12523,2022/11/16,11,0,4,0,15
16062,2022/11/16,12,0,0,0,12
16063,2022/11/16,10,0,4,0,14
16276,2022/11/16,4,0,0,0,4
19322,2022/11/16,7,0,0,0,7
19329,2022/11/16,7,0,3,0,10
19520,2022/11/16,14,0,0,0,14
19521,2022/11/16,12,0,0,0,12
20901,2022/11/16,9,0,0,0,9
20920,2022/11/16,2,0,0,0,2
21132,2022/11/16,14,18,16,0,30
21171,2022/11/16,8,4,2,0,10
21174,2022/11/16,8,8,11,0,19
21175,2022/11/16,8,8,8,0,16
21176,2022/11/16,5,4,5,0,10
75,2022/11/17,42,36,38,3,80
76,2022/11/17,47,44,54,0,101
99,2022/11/17,19,12,0,0,19
117,2022/11/17,4,0,1,0,5
118,2022/11/17,4,4,4,0,8
119,2022/11/17,4,4,1,0,5
120,2022/11/17,8,0,1,1,9
149,2022/11/17,6,0,0,0,6
184,2022/11/17,19,12,11,0,30
195,2022/11/17,37,36,43,0,80
218,2022/11/17,27,27,29,0,56
296,2022/11/17,16,0,4,0,20
300,2022/11/17,5,0,3,0,8
304,2022/11/17,6,0,1,0,7
317,2022/11/17,6,6,3,0,9
343,2022/11/17,4,0,1,0,5
353,2022/11/17,5,0,0,0,5
373,2022/11/17,6,6,1,0,7
374,2022/11/17,3,0,4,0,7
388,2022/11/17,38,30,28,1,66
419,2022/11/17,12,12,3,0,15
420,2022/11/17,8,0,1,0,9
462,2022/11/17,11,8,6,0,17
519,2022/11/17,12,6,5,0,17
525,2022/11/17,8,0,0,0,8
596,2022/11/17,17,4,2,4,19
597,2022/11/17,20,18,12,0,32
598,2022/11/17,4,0,3,0,7
1035,2022/11/17,6,0,6,0,12
1084,2022/11/17,8,5,6,0,14
1111,2022/11/17,9,0,1,0,10
1112,2022/11/17,6,0,1,0,7
1113,2022/11/17,7,0,3,0,10
1114,2022/11/17,11,6,1,0,12
1115,2022/11/17,8,0,1,0,9
1117,2022/11/17,4,0,0,0,4
1118,2022/11/17,13,6,4,0,17
1119,2022/11/17,7,0,0,0,7
1692,2022/11/17,7,6,3,0,10
1693,2022/11/17,6,0,2,0,8
1747,2022/11/17,20,20,19,0,39
1772,2022/11/17,5,0,0,0,5
1773,2022/11/17,12,0,3,0,15
1774,2022/11/17,8,8,0,0,8
1782,2022/11/17,29,24,16,0,45
1795,2022/11/17,28,14,25,0,53
1914,2022/11/17,7,0,0,0,7
1915,2022/11/17,7,0,2,0,9
1923,2022/11/17,7,0,0,0,7
1934,2022/11/17,8,5,5,0,13
1963,2022/11/17,5,0,3,0,8
1984,2022/11/17,1,0,1,0,2
2135,2022/11/17,-1,0,2,0,1
2136,2022/11/17,9,0,0,0,9
2148,2022/11/17,8,4,3,0,11
2183,2022/11/17,10,6,0,0,10
2193,2022/11/17,19,18,19,0,38
2237,2022/11/17,9,0,0,0,9
2358,2022/11/17,6,4,1,1,7
2361,2022/11/17,11,7,6,0,17
2445,2022/11/17,16,0,2,3,18
2449,2022/11/17,12,6,2,0,14
2451,2022/11/17,17,15,14,0,31
2475,2022/11/17,9,0,0,0,9
2476,2022/11/17,13,6,1,0,14
2507,2022/11/17,6,6,9,0,15
2525,2022/11/17,9,0,1,0,10
2562,2022/11/17,8,0,1,0,9
2582,2022/11/17,4,4,1,0,5
2586,2022/11/17,17,16,17,0,34
2631,2022/11/17,9,0,3,0,12
2685,2022/11/17,0,0,0,0,0
2723,2022/11/17,11,0,0,0,11
2730,2022/11/17,7,0,1,0,8
2731,2022/11/17,6,0,1,0,7
2732,2022/11/17,9,0,0,0,9
2734,2022/11/17,7,8,0,0,7
2735,2022/11/17,11,0,2,0,13
2761,2022/11/17,16,15,13,0,29
2788,2022/11/17,24,20,26,0,50
2802,2022/11/17,10,0,1,0,11
2812,2022/11/17,6,0,0,0,6
2813,2022/11/17,9,0,2,0,11
2814,2022/11/17,3,0,1,0,4
2913,2022/11/17,7,0,2,0,9
2914,2022/11/17,9,0,0,0,9
3015,2022/11/17,10,0,4,0,14
3033,2022/11/17,7,0,0,0,7
3035,2022/11/17,13,6,0,0,13
4446,2022/11/17,3,15,11,0,14
12136,2022/11/17,19,21,23,0,42
12516,2022/11/17,8,4,2,0,10
12518,2022/11/17,10,4,4,0,14
12523,2022/11/17,7,0,3,0,10
16062,2022/11/17,12,0,2,0,14
16063,2022/11/17,6,0,0,0,6
16276,2022/11/17,4,0,0,0,4
19322,2022/11/17,7,0,0,0,7
19329,2022/11/17,10,6,0,0,10
19520,2022/11/17,14,0,1,0,15
19521,2022/11/17,12,0,0,0,12
20901,2022/11/17,9,0,1,0,10
20920,2022/11/17,14,12,3,0,17
21099,2022/11/17,12,0,2,0,14
21132,2022/11/17,14,18,20,0,34
21171,2022/11/17,6,0,2,0,8
21174,2022/11/17,9,12,8,0,17
21175,2022/11/17,8,8,8,0,16
21176,2022/11/17,9,8,7,1,16
75,2022/11/18,49,48,50,0,99
76,2022/11/18,33,40,32,0,65
99,2022/11/18,19,0,0,0,19
117,2022/11/18,7,4,2,0,9
118,2022/11/18,4,4,3,0,7
119,2022/11/18,3,0,2,0,5
120,2022/11/18,6,0,2,0,8
149,2022/11/18,6,0,1,0,7
184,2022/11/18,11,3,16,0,27
195,2022/11/18,19,24,18,0,37
218,2022/11/18,25,27,31,0,56
296,2022/11/18,12,0,1,0,13
300,2022/11/18,2,0,1,0,3
304,2022/11/18,11,6,5,0,16
317,2022/11/18,9,6,6,0,15
343,2022/11/18,3,0,1,0,4
353,2022/11/18,11,6,1,0,12
373,2022/11/18,5,0,1,0,6
374,2022/11/18,7,8,1,0,8
388,2022/11/18,18,9,17,0,35
419,2022/11/18,9,0,6,2,15
420,2022/11/18,7,0,0,0,7
462,2022/11/18,13,8,5,0,18
519,2022/11/18,22,12,18,0,40
525,2022/11/18,8,0,4,2,12
596,2022/11/18,23,12,5,0,28
597,2022/11/18,38,30,24,0,62
598,2022/11/18,7,6,0,0,7
1035,2022/11/18,0,0,0,0,0
1084,2022/11/18,17,15,16,0,33
1111,2022/11/18,8,0,0,0,8
1112,2022/11/18,5,0,0,0,5
1113,2022/11/18,4,0,0,0,4
1114,2022/11/18,16,6,2,0,18
1115,2022/11/18,13,6,3,0,16
1117,2022/11/18,12,8,0,0,12
1118,2022/11/18,9,0,2,0,11
1119,2022/11/18,7,0,1,0,8
1692,2022/11/18,4,0,3,0,7
1693,2022/11/18,4,0,0,0,4
1747,2022/11/18,26,25,27,0,53
1772,2022/11/18,5,0,2,0,7
1773,2022/11/18,9,0,1,0,10
1774,2022/11/18,8,0,3,0,11
1782,2022/11/18,31,18,29,0,60
1795,2022/11/18,17,14,10,0,27
1914,2022/11/18,7,0,1,0,8
1915,2022/11/18,5,0,0,0,5
1923,2022/11/18,7,0,1,0,8
1934,2022/11/18,3,0,3,0,6
1963,2022/11/18,2,0,4,0,6
1984,2022/11/18,0,0,0,0,0
2135,2022/11/18,-3,0,1,0,-2
2136,2022/11/18,9,0,0,0,9
2148,2022/11/18,13,8,6,0,19
2183,2022/11/18,17,6,11,0,28
2193,2022/11/18,12,12,11,0,23
2237,2022/11/18,9,0,2,0,11
2358,2022/11/18,12,8,1,0,13
2361,2022/11/18,5,0,2,0,7
2445,2022/11/18,7,0,6,0,13
2449,2022/11/18,10,0,2,0,12
2451,2022/11/18,23,20,6,0,29
2475,2022/11/18,9,0,0,0,9
2476,2022/11/18,12,0,1,0,13
2507,2022/11/18,9,12,9,0,18
2525,2022/11/18,8,0,0,0,8
2562,2022/11/18,13,6,3,0,16
2582,2022/11/18,7,4,3,0,10
2586,2022/11/18,20,20,20,0,40
2631,2022/11/18,7,0,7,0,14
2685,2022/11/18,8,8,8,0,16
2723,2022/11/18,11,0,1,0,12
2730,2022/11/18,6,0,0,0,6
2731,2022/11/18,11,6,1,0,12
2732,2022/11/18,9,0,0,0,9
2734,2022/11/18,7,0,6,0,13
2735,2022/11/18,9,0,5,0,14
2761,2022/11/18,23,20,16,0,39
2788,2022/11/18,10,12,16,0,26
2802,2022/11/18,9,0,1,0,10
2812,2022/11/18,6,0,0,0,6
2813,2022/11/18,7,0,0,0,7
2814,2022/11/18,8,6,1,0,9
2913,2022/11/18,5,0,2,0,7
2914,2022/11/18,9,0,1,0,10
3015,2022/11/18,6,0,1,0,7
3033,2022/11/18,7,0,0,0,7
3035,2022/11/18,13,0,1,0,14
4446,2022/11/18,4,12,13,0,17
12136,2022/11/18,17,21,21,0,38
12516,2022/11/18,6,0,0,0,6
12518,2022/11/18,6,0,4,0,10
12523,2022/11/18,4,0,1,0,5
16062,2022/11/18,10,0,0,0,10
16063,2022/11/18,6,0,2,0,8
16276,2022/11/18,10,6,1,0,11
19322,2022/11/18,7,0,1,0,8
19329,2022/11/18,10,0,2,0,12
19520,2022/11/18,13,0,1,0,14
19521,2022/11/18,12,0,0,0,12
20901,2022/11/18,8,0,1,0,9
20920,2022/11/18,11,0,2,0,13
21099,2022/11/18,10,0,0,0,10
21132,2022/11/18,16,21,16,0,32
21171,2022/11/18,8,4,3,0,11
21174,2022/11/18,13,12,12,0,25
21175,2022/11/18,9,8,9,0,18
21176,2022/11/18,5,4,3,0,8
75,2022/11/19,27,28,26,0,53
76,2022/11/19,33,32,33,0,66
99,2022/11/19,19,0,1,0,20
117,2022/11/19,5,0,2,0,7
118,2022/11/19,5,4,5,0,10
119,2022/11/19,5,4,0,0,5
120,2022/11/19,4,0,0,4,4
149,2022/11/19,11,6,0,0,11
184,2022/11/19,7,12,9,0,16
195,2022/11/19,24,24,21,0,45
218,2022/11/19,21,27,22,0,43
296,2022/11/19,17,6,9,1,26
300,2022/11/19,9,8,4,0,13
304,2022/11/19,12,6,4,0,16
317,2022/11/19,9,6,11,0,20
343,2022/11/19,6,4,0,1,6
353,2022/11/19,10,0,0,0,10
373,2022/11/19,10,6,0,0,10
374,2022/11/19,6,0,3,0,9
388,2022/11/19,25,24,19,0,44
419,2022/11/19,7,6,1,0,8
420,2022/11/19,7,0,1,0,8
462,2022/11/19,16,8,10,0,26
519,2022/11/19,10,6,7,0,17
525,2022/11/19,2,0,1,0,3
596,2022/11/19,18,0,12,0,30
597,2022/11/19,14,0,14,0,28
598,2022/11/19,7,0,1,0,8
1035,2022/11/19,12,12,5,0,17
1084,2022/11/19,1,0,1,0,2
1111,2022/11/19,8,0,0,0,8
1112,2022/11/19,11,6,2,0,13
1113,2022/11/19,4,0,1,0,5
1114,2022/11/19,14,0,7,0,21
1115,2022/11/19,10,0,1,0,11
1117,2022/11/19,12,0,1,0,13
1118,2022/11/19,7,0,2,0,9
1119,2022/11/19,6,0,1,0,7
1692,2022/11/19,7,6,3,0,10
1693,2022/11/19,4,0,0,0,4
1747,2022/11/19,19,20,21,0,40
1772,2022/11/19,3,0,0,0,3
1773,2022/11/19,8,0,1,0,9
1774,2022/11/19,13,8,0,0,13
1782,2022/11/19,20,18,23,0,43
1795,2022/11/19,35,28,22,0,57
1914,2022/11/19,6,0,0,0,6
1915,2022/11/19,11,6,1,0,12
1923,2022/11/19,6,0,0,0,6
1934,2022/11/19,5,5,4,0,9
1963,2022/11/19,4,6,0,0,4
1984,2022/11/19,6,6,3,0,9
2135,2022/11/19,-4,0,1,0,-3
2136,2022/11/19,9,0,2,0,11
2148,2022/11/19,7,0,1,0,8
2183,2022/11/19,12,6,3,0,15
2193,2022/11/19,19,18,16,0,35
2237,2022/11/19,13,6,5,0,18
2358,2022/11/19,15,4,2,0,17
2361,2022/11/19,10,7,6,0,16
2445,2022/11/19,13,12,5,0,18
2449,2022/11/19,14,6,1,0,15
2451,2022/11/19,27,10,12,0,39
2475,2022/11/19,9,0,0,0,9
2476,2022/11/19,11,0,2,0,13
2507,2022/11/19,12,12,12,0,24
2525,2022/11/19,8,0,0,0,8
2562,2022/11/19,10,0,1,0,11
2582,2022/11/19,8,4,4,0,12
2586,2022/11/19,12,12,13,0,25
2631,2022/11/19,6,6,4,0,10
2685,2022/11/19,8,8,0,0,8
2723,2022/11/19,10,0,0,0,10
2730,2022/11/19,12,6,5,0,17
2731,2022/11/19,10,0,2,0,12
2732,2022/11/19,9,0,1,0,10
2734,2022/11/19,5,4,1,0,6
2735,2022/11/19,12,8,4,0,16
2761,2022/11/19,22,15,16,0,38
2788,2022/11/19,10,16,6,0,16
2802,2022/11/19,8,0,1,0,9
2812,2022/11/19,6,0,0,0,6
2813,2022/11/19,7,0,0,0,7
2814,2022/11/19,7,0,0,0,7
2913,2022/11/19,9,6,1,0,10
2914,2022/11/19,8,0,0,0,8
3015,2022/11/19,5,0,1,0,6
3033,2022/11/19,7,0,1,0,8
3035,2022/11/19,12,0,1,0,13
4446,2022/11/19,0,9,12,0,12
12136,2022/11/19,14,18,16,0,30
12516,2022/11/19,6,0,0,0,6
12518,2022/11/19,2,0,0,0,2
12523,2022/11/19,7,4,5,0,12
16062,2022/11/19,10,0,3,0,13
16063,2022/11/19,10,6,0,0,10
16276,2022/11/19,9,0,0,0,9
19322,2022/11/19,6,0,0,0,6
19329,2022/11/19,8,0,0,0,8
19520,2022/11/19,12,0,0,0,12
19521,2022/11/19,12,0,1,0,13
20901,2022/11/19,7,0,2,0,9
20920,2022/11/19,9,0,2,0,11
21099,2022/11/19,10,0,0,0,10
21132,2022/11/19,14,15,15,0,29
21171,2022/11/19,5,0,2,0,7
21174,2022/11/19,13,12,9,0,22
21175,2022/11/19,7,8,8,0,15
21176,2022/11/19,10,8,5,0,15
75,2022/11/20,25,24,33,0,58
76,2022/11/20,32,32,42,0,74
99,2022/11/20,18,0,0,0,18
117,2022/11/20,3,0,1,0,4
118,2022/11/20,4,4,1,0,5
119,2022/11/20,5,0,1,1,6
120,2022/11/20,0,0,0,0,0
149,2022/11/20,11,0,2,0,13
184,2022/11/20,4,6,3,0,7
195,2022/11/20,18,15,26,0,44
218,2022/11/20,11,12,16,0,27
296,2022/11/20,7,0,4,0,11
300,2022/11/20,13,8,1,0,14
304,2022/11/20,14,6,3,0,17
317,2022/11/20,4,6,3,0,7
343,2022/11/20,5,0,2,0,7
353,2022/11/20,10,0,0,0,10
373,2022/11/20,16,6,3,0,19
374,2022/11/20,11,8,4,0,15
388,2022/11/20,21,15,13,0,34
419,2022/11/20,12,6,6,0,18
420,2022/11/20,12,6,1,0,13
462,2022/11/20,14,8,12,0,26
519,2022/11/20,15,12,4,0,19
525,2022/11/20,1,0,0,0,1
596,2022/11/20,14,8,1,0,15
597,2022/11/20,18,18,11,0,29
598,2022/11/20,6,0,2,0,8
1035,2022/11/20,13,6,6,0,19
1084,2022/11/20,10,10,7,0,17
1111,2022/11/20,8,0,4,0,12
1112,2022/11/20,9,0,1,0,10
1113,2022/11/20,9,6,0,0,9
1114,2022/11/20,7,0,6,0,13
1115,2022/11/20,9,0,10,0,19
1117,2022/11/20,11,0,1,0,12
1118,2022/11/20,11,6,5,0,16
1119,2022/11/20,5,0,0,0,5
1692,2022/11/20,4,0,2,0,6
1693,2022/11/20,10,6,0,0,10
1747,2022/11/20,13,15,15,0,28
1773,2022/11/20,7,0,1,0,8
1774,2022/11/20,13,0,1,0,14
1782,2022/11/20,15,18,11,0,26
1795,2022/11/20,13,0,13,0,26
1914,2022/11/20,6,0,0,0,6
1915,2022/11/20,10,0,4,0,14
1923,2022/11/20,6,0,0,0,6
1934,2022/11/20,1,0,1,0,2
1963,2022/11/20,16,12,8,0,24
1984,2022/11/20,9,6,2,0,11
2135,2022/11/20,-5,0,1,0,-4
2136,2022/11/20,7,0,2,0,9
2148,2022/11/20,6,0,0,0,6
2183,2022/11/20,15,6,5,0,20
2193,2022/11/20,15,12,12,2,27
2237,2022/11/20,8,0,5,0,13
2358,2022/11/20,25,12,4,0,29
2361,2022/11/20,4,0,5,0,9
2445,2022/11/20,14,6,8,0,22
2449,2022/11/20,13,0,2,0,15
2451,2022/11/20,50,35,12,0,62
2475,2022/11/20,9,0,1,0,10
2476,2022/11/20,9,0,5,0,14
2507,2022/11/20,12,12,11,0,23
2525,2022/11/20,8,0,1,0,9
2562,2022/11/20,9,0,2,0,11
2582,2022/11/20,4,0,3,0,7
2586,2022/11/20,11,12,12,0,23
2631,2022/11/20,2,0,1,0,3
2685,2022/11/20,12,4,8,0,20
2723,2022/11/20,10,0,2,0,12
2730,2022/11/20,7,0,6,0,13
2731,2022/11/20,8,0,2,0,10
2732,2022/11/20,8,0,2,0,10
2734,2022/11/20,12,8,1,0,13
2735,2022/11/20,8,0,4,0,12
2761,2022/11/20,21,15,15,0,36
2788,2022/11/20,16,12,13,0,29
2802,2022/11/20,7,0,0,0,7
2812,2022/11/20,6,0,0,0,6
2813,2022/11/20,7,0,0,0,7
2814,2022/11/20,7,0,1,0,8
2913,2022/11/20,8,0,1,0,9
2914,2022/11/20,8,0,1,0,9
3015,2022/11/20,12,8,4,0,16
3033,2022/11/20,6,0,2,0,8
3035,2022/11/20,11,0,1,0,12
4446,2022/11/20,-3,9,6,0,3
12136,2022/11/20,10,12,12,0,22
12516,2022/11/20,10,4,1,0,11
12518,2022/11/20,6,4,2,0,8
12523,2022/11/20,10,8,1,0,11
16062,2022/11/20,7,0,2,0,9
16063,2022/11/20,10,0,1,0,11
16276,2022/11/20,9,0,2,0,11
19322,2022/11/20,6,0,0,0,6
19329,2022/11/20,8,0,2,0,10
19520,2022/11/20,12,0,0,0,12
19521,2022/11/20,11,0,0,0,11
20901,2022/11/20,5,0,0,1,5
20920,2022/11/20,7,0,0,0,7
21099,2022/11/20,10,0,0,0,10
21132,2022/11/20,14,15,18,0,32
21171,2022/11/20,7,4,2,0,9
21174,2022/11/20,16,12,16,0,32
21175,2022/11/20,7,8,8,0,15
21176,2022/11/20,9,4,5,1,14
75,2022/11/21,33,40,37,0,70
76,2022/11/21,38,48,40,0,78
99,2022/11/21,18,0,1,0,19
117,2022/11/21,6,4,3,0,9
118,2022/11/21,7,4,2,0,9
119,2022/11/21,7,4,0,0,7
120,2022/11/21,4,4,1,0,5
149,2022/11/21,9,0,2,0,11
184,2022/11/21,7,6,6,0,13
195,2022/11/21,30,36,38,0,68
218,2022/11/21,25,30,27,0,52
296,2022/11/21,7,4,6,0,13
300,2022/11/21,12,0,5,0,17
304,2022/11/21,11,0,8,0,19
317,2022/11/21,7,6,3,0,10
343,2022/11/21,7,4,0,1,7
353,2022/11/21,10,0,1,0,11
373,2022/11/21,19,6,2,0,21
374,2022/11/21,7,0,5,0,12
388,2022/11/21,35,27,29,0,64
419,2022/11/21,18,12,3,0,21
420,2022/11/21,11,0,1,0,12
462,2022/11/21,10,8,8,1,18
519,2022/11/21,17,6,8,0,25
525,2022/11/21,1,0,0,0,1
596,2022/11/21,13,0,8,0,21
597,2022/11/21,19,12,10,0,29
598,2022/11/21,10,6,5,0,15
1035,2022/11/21,7,0,4,0,11
1084,2022/11/21,13,10,14,0,27
1111,2022/11/21,4,0,1,0,5
1112,2022/11/21,8,0,0,0,8
1113,2022/11/21,9,0,0,0,9
1114,2022/11/21,7,6,0,0,7
1115,2022/11/21,-1,0,0,0,-1
1117,2022/11/21,10,0,2,0,12
1118,2022/11/21,6,0,3,0,9
1119,2022/11/21,5,0,0,0,5
1692,2022/11/21,8,6,6,0,14
1693,2022/11/21,10,0,0,0,10
1747,2022/11/21,23,25,23,0,46
1773,2022/11/21,6,0,0,0,6
1774,2022/11/21,12,0,1,0,13
1782,2022/11/21,13,9,10,0,23
1795,2022/11/21,15,14,11,0,26
1914,2022/11/21,6,0,0,0,6
1915,2022/11/21,6,0,0,0,6
1923,2022/11/21,12,6,1,0,13
1934,2022/11/21,5,5,4,0,9
1963,2022/11/21,20,12,9,0,29
1984,2022/11/21,13,6,3,0,16
2135,2022/11/21,0,6,0,0,0
2136,2022/11/21,5,0,0,0,5
2148,2022/11/21,6,0,2,0,8
2183,2022/11/21,10,0,0,0,10
2193,2022/11/21,19,18,18,0,37
2237,2022/11/21,3,0,1,0,4
2358,2022/11/21,21,0,4,0,25
2361,2022/11/21,6,7,2,0,8
2445,2022/11/21,12,6,4,0,16
2449,2022/11/21,11,0,4,0,15
2451,2022/11/21,38,0,10,0,48
2475,2022/11/21,8,0,0,0,8
2476,2022/11/21,4,0,0,0,4
2507,2022/11/21,13,12,13,0,26
2525,2022/11/21,7,0,0,0,7
2562,2022/11/21,13,6,0,0,13
2582,2022/11/21,1,0,2,0,3
2586,2022/11/21,15,16,14,0,29
2631,2022/11/21,7,6,0,0,7
2685,2022/11/21,12,8,9,0,21
2723,2022/11/21,8,0,1,0,9
2730,2022/11/21,1,0,0,0,1
2731,2022/11/21,6,0,0,0,6
2732,2022/11/21,6,0,0,0,6
2734,2022/11/21,11,0,5,0,16
2735,2022/11/21,4,0,4,0,8
2761,2022/11/21,26,20,13,0,39
2788,2022/11/21,27,24,19,0,46
2802,2022/11/21,7,0,0,0,7
2812,2022/11/21,6,0,0,0,6
2813,2022/11/21,7,0,0,0,7
2814,2022/11/21,6,0,1,0,7
2913,2022/11/21,7,0,2,0,9
2914,2022/11/21,7,0,0,0,7
3015,2022/11/21,8,0,6,0,14
3033,2022/11/21,4,0,1,0,5
3035,2022/11/21,10,0,2,0,12
4446,2022/11/21,6,15,10,0,16
12136,2022/11/21,25,27,27,0,52
12516,2022/11/21,9,0,3,0,12
12518,2022/11/21,8,4,5,0,13
12523,2022/11/21,9,0,4,0,13
16062,2022/11/21,5,0,0,0,5
16063,2022/11/21,9,0,0,0,9
16276,2022/11/21,7,0,1,0,8
19322,2022/11/21,6,0,0,0,6
19329,2022/11/21,6,0,1,0,7
19520,2022/11/21,12,0,3,0,15
19521,2022/11/21,11,0,0,0,11
20901,2022/11/21,4,0,0,0,4
20920,2022/11/21,7,0,2,0,9
21099,2022/11/21,10,0,1,0,11
21132,2022/11/21,14,18,15,0,29
21171,2022/11/21,9,4,4,1,13
21174,2022/11/21,12,12,10,0,22
21175,2022/11/21,11,12,12,0,23
21176,2022/11/21,11,8,6,3,17
75,2022/11/22,37,40,34,0,71
76,2022/11/22,30,32,32,0,62
99,2022/11/22,17,0,0,0,17
117,2022/11/22,3,0,0,0,3
118,2022/11/22,8,4,1,0,9
119,2022/11/22,7,0,0,1,7
120,2022/11/22,3,0,3,0,6
149,2022/11/22,7,0,1,0,8
184,2022/11/22,13,12,12,0,25
195,2022/11/22,22,30,21,0,43
218,2022/11/22,28,30,37,0,65
296,2022/11/22,1,0,4,0,5
300,2022/11/22,11,4,4,0,15
304,2022/11/22,7,4,4,0,11
317,2022/11/22,10,6,5,0,15
343,2022/11/22,6,0,1,0,7
353,2022/11/22,9,0,1,0,10
373,2022/11/22,17,0,3,2,20
374,2022/11/22,2,0,3,0,5
388,2022/11/22,33,27,31,0,64
419,2022/11/22,15,0,11,0,26
420,2022/11/22,10,0,2,0,12
462,2022/11/22,9,8,13,0,22
519,2022/11/22,9,0,5,0,14
525,2022/11/22,1,0,0,0,1
596,2022/11/22,5,0,4,0,9
597,2022/11/22,21,12,18,0,39
598,2022/11/22,5,0,2,0,7
1035,2022/11/22,9,6,1,0,10
1084,2022/11/22,9,10,9,0,18
1111,2022/11/22,3,0,2,0,5
1112,2022/11/22,8,0,0,0,8
1113,2022/11/22,9,0,1,0,10
1114,2022/11/22,13,6,4,0,17
1115,2022/11/22,-1,0,0,0,-1
1117,2022/11/22,8,0,0,0,8
1118,2022/11/22,9,6,1,0,10
1119,2022/11/22,11,6,0,0,11
1692,2022/11/22,8,6,1,0,9
1693,2022/11/22,10,0,1,0,11
1747,2022/11/22,27,25,24,0,51
1773,2022/11/22,6,0,3,0,9
1774,2022/11/22,11,0,3,0,14
1782,2022/11/22,27,24,26,0,53
1795,2022/11/22,3,0,3,0,6
1914,2022/11/22,6,0,0,0,6
1915,2022/11/22,6,0,1,0,7
1923,2022/11/22,11,0,2,0,13
1934,2022/11/22,1,0,0,0,1
1963,2022/11/22,11,0,6,0,17
1984,2022/11/22,10,0,5,0,15
2135,2022/11/22,0,0,2,0,2
2136,2022/11/22,5,0,1,0,6
2148,2022/11/22,4,0,0,0,4
2183,2022/11/22,16,6,2,0,18
2193,2022/11/22,16,15,20,0,36
2237,2022/11/22,8,6,2,0,10
2358,2022/11/22,21,4,7,0,28
2361,2022/11/22,4,0,4,0,8
2445,2022/11/22,8,0,3,0,11
2449,2022/11/22,13,6,1,0,14
2451,2022/11/22,28,0,8,0,36
2475,2022/11/22,8,0,2,0,10
2476,2022/11/22,4,0,0,0,4
2507,2022/11/22,7,6,5,0,12
2525,2022/11/22,7,0,0,0,7
2562,2022/11/22,13,0,2,0,15
2582,2022/11/22,-1,0,0,0,-1
2586,2022/11/22,1,0,0,0,1
2631,2022/11/22,13,6,1,0,14
2685,2022/11/22,11,8,11,0,22
2723,2022/11/22,7,0,1,0,8
2730,2022/11/22,7,6,3,0,10
2731,2022/11/22,6,0,4,0,10
2732,2022/11/22,6,0,2,0,8
2734,2022/11/22,6,0,3,0,9
2735,2022/11/22,4,4,3,0,7
2761,2022/11/22,28,15,29,0,57
2788,2022/11/22,29,20,27,0,56
2802,2022/11/22,7,0,1,0,8
2812,2022/11/22,6,0,3,0,9
2813,2022/11/22,7,0,0,0,7
2814,2022/11/22,5,0,0,0,5
2913,2022/11/22,5,0,1,0,6
2914,2022/11/22,7,0,0,0,7
3015,2022/11/22,2,0,1,0,3
3033,2022/11/22,3,0,1,0,4
3035,2022/11/22,8,0,0,0,8
4446,2022/11/22,18,12,19,0,37
12136,2022/11/22,28,30,28,0,56
12516,2022/11/22,6,0,7,0,13
12518,2022/11/22,3,0,2,0,5
12523,2022/11/22,5,0,3,0,8
16062,2022/11/22,11,6,0,0,11
16063,2022/11/22,9,0,0,0,9
16276,2022/11/22,6,0,1,0,7
19322,2022/11/22,6,0,1,0,7
19329,2022/11/22,5,0,0,0,5
19520,2022/11/22,9,0,0,0,9
19521,2022/11/22,11,0,0,0,11
20901,2022/11/22,4,0,0,0,4
20920,2022/11/22,17,12,1,0,18
21099,2022/11/22,9,0,0,0,9
21132,2022/11/22,14,15,14,0,28
21171,2022/11/22,4,0,3,0,7
21174,2022/11/22,16,12,13,0,29
21175,2022/11/22,7,8,7,0,14
21176,2022/11/22,10,8,5,0,15
75,2022/11/23,27,28,28,1,55
76,2022/11/23,34,36,35,0,69
99,2022/11/23,17,0,1,0,18
117,2022/11/23,7,4,1,0,8
118,2022/11/23,11,4,1,0,12
119,2022/11/23,6,0,1,0,7
120,2022/11/23,4,4,4,0,8
149,2022/11/23,6,0,0,0,6
184,2022/11/23,0,0,1,0,1
195,2022/11/23,6,30,28,0,34
218,2022/11/23,15,24,15,0,30
296,2022/11/23,1,4,1,0,2
300,2022/11/23,11,4,4,0,15
304,2022/11/23,7,4,4,0,11
317,2022/11/23,11,6,9,0,20
343,2022/11/23,9,4,1,0,10
353,2022/11/23,8,0,0,0,8
373,2022/11/23,12,0,6,0,18
374,2022/11/23,7,8,4,0,11
388,2022/11/23,19,24,19,0,38
419,2022/11/23,10,6,13,0,23
420,2022/11/23,8,0,2,0,10
462,2022/11/23,12,16,5,0,17
519,2022/11/23,16,12,9,0,25
525,2022/11/23,6,5,1,0,7
596,2022/11/23,4,4,4,0,8
597,2022/11/23,15,12,8,0,23
598,2022/11/23,3,0,1,0,4
1035,2022/11/23,8,0,1,0,9
1084,2022/11/23,10,10,10,0,20
1111,2022/11/23,7,6,2,0,9
1112,2022/11/23,8,0,0,0,8
1113,2022/11/23,8,0,0,0,8
1114,2022/11/23,15,6,2,0,17
1115,2022/11/23,5,6,1,0,6
1117,2022/11/23,8,0,0,0,8
1118,2022/11/23,14,6,1,0,15
1119,2022/11/23,11,0,1,0,12
1692,2022/11/23,7,0,2,0,9
1693,2022/11/23,9,0,4,0,13
1747,2022/11/23,25,20,24,0,49
1773,2022/11/23,9,6,1,0,10
1774,2022/11/23,8,0,3,0,11
1782,2022/11/23,23,24,23,0,46
1795,2022/11/23,13,14,6,0,19
1914,2022/11/23,6,0,0,0,6
1915,2022/11/23,11,6,0,0,11
1923,2022/11/23,9,0,2,0,11
1934,2022/11/23,6,5,3,0,9
1963,2022/11/23,5,0,7,0,12
1984,2022/11/23,11,6,1,0,12
2135,2022/11/23,-2,0,4,0,2
2136,2022/11/23,10,6,1,0,11
2148,2022/11/23,8,4,2,0,10
2183,2022/11/23,14,0,1,5,15
2193,2022/11/23,11,15,10,0,21
2237,2022/11/23,12,6,5,0,17
2358,2022/11/23,14,0,1,0,15
2361,2022/11/23,0,0,0,0,0
2445,2022/11/23,5,0,3,0,8
2449,2022/11/23,12,0,1,0,13
2451,2022/11/23,17,0,8,0,25
2475,2022/11/23,6,0,0,0,6
2476,2022/11/23,10,6,0,0,10
2507,2022/11/23,1,0,2,0,3
2525,2022/11/23,7,0,1,0,8
2562,2022/11/23,11,0,1,0,12
2582,2022/11/23,3,4,4,0,7
2586,2022/11/23,23,32,15,0,38
2631,2022/11/23,12,0,3,0,15
2685,2022/11/23,1,0,1,0,2
2723,2022/11/23,6,0,1,0,7
2730,2022/11/23,10,6,1,0,11
2731,2022/11/23,2,0,1,0,3
2732,2022/11/23,4,0,1,0,5
2734,2022/11/23,7,4,1,0,8
2735,2022/11/23,5,4,0,0,5
2761,2022/11/23,15,15,17,0,32
2788,2022/11/23,13,16,13,0,26
2802,2022/11/23,6,0,0,0,6
2812,2022/11/23,3,0,0,0,3
2813,2022/11/23,7,0,1,0,8
2814,2022/11/23,5,0,1,0,6
2913,2022/11/23,4,0,0,0,4
2914,2022/11/23,7,0,0,0,7
3015,2022/11/23,1,0,0,0,1
3033,2022/11/23,8,6,0,0,8
3035,2022/11/23,8,0,1,0,9
4446,2022/11/23,10,12,10,0,20
12136,2022/11/23,0,0,2,0,2
12516,2022/11/23,3,4,2,0,5
12518,2022/11/23,5,4,3,0,8
12523,2022/11/23,6,4,2,0,8
16062,2022/11/23,11,0,0,0,11
16063,2022/11/23,9,0,1,0,10
16276,2022/11/23,5,0,1,0,6
19322,2022/11/23,5,0,0,0,5
19329,2022/11/23,5,0,0,0,5
19520,2022/11/23,9,0,2,0,11
19521,2022/11/23,11,0,1,0,12
20901,2022/11/23,4,0,0,0,4
20920,2022/11/23,16,0,0,0,16
21132,2022/11/23,18,18,18,0,36
21171,2022/11/23,5,4,1,0,6
21174,2022/11/23,12,12,13,0,25
21175,2022/11/23,9,8,7,0,16
21176,2022/11/23,8,4,7,0,15
75,2022/11/24,38,40,34,1,72
76,2022/11/24,47,48,52,1,99
99,2022/11/24,16,0,1,0,17
117,2022/11/24,6,0,0,0,6
118,2022/11/24,10,0,4,0,14
119,2022/11/24,9,4,0,4,9
120,2022/11/24,0,0,0,0,0
149,2022/11/24,6,0,0,0,6
184,2022/11/24,20,21,14,0,34
195,2022/11/24,16,39,39,0,55
218,2022/11/24,29,30,30,0,59
296,2022/11/24,4,4,3,0,7
300,2022/11/24,7,0,3,0,10
304,2022/11/24,3,0,1,0,4
317,2022/11/24,8,6,4,0,12
343,2022/11/24,8,0,1,0,9
353,2022/11/24,8,0,0,0,8
373,2022/11/24,12,6,2,1,14
374,2022/11/24,7,4,4,0,11
388,2022/11/24,27,27,23,0,50
419,2022/11/24,3,6,5,0,8
420,2022/11/24,12,6,3,0,15
462,2022/11/24,15,8,5,0,20
519,2022/11/24,7,0,4,0,11
525,2022/11/24,5,0,0,0,5
596,2022/11/24,4,4,4,0,8
597,2022/11/24,19,12,14,0,33
598,2022/11/24,8,6,3,0,11
1035,2022/11/24,13,6,4,1,17
1084,2022/11/24,10,10,11,0,21
1111,2022/11/24,5,0,1,0,6
1112,2022/11/24,8,0,0,0,8
1113,2022/11/24,8,0,1,0,9
1114,2022/11/24,13,0,0,0,13
1115,2022/11/24,4,0,3,0,7
1117,2022/11/24,8,0,1,0,9
1118,2022/11/24,13,0,1,0,14
1119,2022/11/24,10,0,0,0,10
1692,2022/11/24,11,6,4,0,15
1693,2022/11/24,5,0,1,0,6
1747,2022/11/24,21,20,20,0,41
1773,2022/11/24,8,0,0,0,8
1774,2022/11/24,5,0,1,0,6
1782,2022/11/24,18,18,18,0,36
1795,2022/11/24,35,28,19,0,54
1914,2022/11/24,6,0,2,0,8
1915,2022/11/24,11,0,1,0,12
1923,2022/11/24,7,0,0,0,7
1934,2022/11/24,8,5,0,0,8
1963,2022/11/24,16,18,6,0,22
1984,2022/11/24,10,0,1,0,11
2135,2022/11/24,-6,0,0,0,-6
2136,2022/11/24,9,0,0,0,9
2148,2022/11/24,10,4,3,0,13
2183,2022/11/24,8,0,3,1,11
2193,2022/11/24,19,18,16,0,35
2237,2022/11/24,7,0,0,0,7
2358,2022/11/24,13,0,5,3,18
2361,2022/11/24,14,14,8,0,22
2445,2022/11/24,8,6,2,1,10
2449,2022/11/24,11,0,4,0,15
2451,2022/11/24,24,15,14,0,38
2475,2022/11/24,6,0,0,0,6
2476,2022/11/24,10,0,0,0,10
2507,2022/11/24,17,18,17,0,34
2525,2022/11/24,6,0,1,0,7
2562,2022/11/24,10,0,2,3,12
2582,2022/11/24,7,8,1,0,8
2586,2022/11/24,24,16,24,0,48
2631,2022/11/24,9,0,0,0,9
2685,2022/11/24,16,16,10,0,26
2723,2022/11/24,5,0,0,0,5
2730,2022/11/24,9,0,0,0,9
2731,2022/11/24,7,6,0,0,7
2732,2022/11/24,3,0,1,0,4
2734,2022/11/24,14,8,0,0,14
2735,2022/11/24,5,0,3,0,8
2761,2022/11/24,13,15,13,0,26
2788,2022/11/24,32,32,22,0,54
2802,2022/11/24,6,0,0,0,6
2812,2022/11/24,3,0,0,0,3
2813,2022/11/24,6,0,0,0,6
2814,2022/11/24,4,0,2,0,6
2913,2022/11/24,10,6,2,0,12
2914,2022/11/24,7,0,0,0,7
3015,2022/11/24,9,8,2,0,11
3033,2022/11/24,8,0,1,0,9
3035,2022/11/24,7,0,0,0,7
4446,2022/11/24,13,12,0,0,13
12136,2022/11/24,46,48,44,5,90
12516,2022/11/24,1,0,1,0,2
12518,2022/11/24,6,4,5,0,11
12523,2022/11/24,8,4,5,0,13
16062,2022/11/24,11,0,0,0,11
16063,2022/11/24,8,0,0,0,8
16276,2022/11/24,4,0,0,2,4
19322,2022/11/24,5,0,0,0,5
19329,2022/11/24,11,6,0,0,11
19520,2022/11/24,7,0,1,0,8
19521,2022/11/24,10,0,1,0,11
20901,2022/11/24,4,0,0,0,4
20920,2022/11/24,16,0,2,0,18
21132,2022/11/24,21,21,9,0,30
21171,2022/11/24,8,4,4,0,12
21174,2022/11/24,11,12,11,0,22
21175,2022/11/24,14,12,10,0,24
21176,2022/11/24,9,8,2,0,11
75,2022/11/25,47,44,46,0,93
76,2022/11/25,34,40,30,1,64
99,2022/11/25,15,0,0,0,15
117,2022/11/25,10,4,2,0,12
118,2022/11/25,10,4,2,0,12
119,2022/11/25,5,0,2,0,7
120,2022/11/25,0,0,0,0,0
149,2022/11/25,6,0,0,0,6
184,2022/11/25,18,12,12,0,30
195,2022/11/25,7,30,31,0,38
218,2022/11/25,29,30,32,0,61
296,2022/11/25,9,8,3,0,12
300,2022/11/25,8,4,5,0,13
304,2022/11/25,6,4,4,0,10
317,2022/11/25,10,6,5,0,15
343,2022/11/25,7,0,3,0,10
353,2022/11/25,8,0,2,0,10
373,2022/11/25,9,0,2,1,11
374,2022/11/25,7,4,3,0,10
388,2022/11/25,28,24,26,1,54
419,2022/11/25,4,6,4,0,8
420,2022/11/25,9,0,2,0,11
462,2022/11/25,18,8,5,0,23
519,2022/11/25,21,18,8,0,29
525,2022/11/25,10,5,1,0,11
596,2022/11/25,12,12,6,0,18
597,2022/11/25,29,24,20,0,49
598,2022/11/25,5,0,4,0,9
1035,2022/11/25,14,6,11,0,25
1084,2022/11/25,19,20,15,0,34
1111,2022/11/25,10,6,1,0,11
1112,2022/11/25,8,0,1,0,9
1113,2022/11/25,13,6,0,0,13
1114,2022/11/25,13,0,4,0,17
1115,2022/11/25,7,6,3,0,10
1117,2022/11/25,7,0,2,0,9
1118,2022/11/25,12,0,4,0,16
1119,2022/11/25,10,0,1,0,11
1692,2022/11/25,7,0,1,0,8
1693,2022/11/25,4,0,0,0,4
1747,2022/11/25,26,25,28,0,54
1773,2022/11/25,8,0,0,0,8
1774,2022/11/25,4,0,1,0,5
1782,2022/11/25,30,30,31,0,61
1795,2022/11/25,30,14,23,0,53
1914,2022/11/25,4,0,0,0,4
1915,2022/11/25,10,0,1,0,11
1923,2022/11/25,7,0,2,0,9
1934,2022/11/25,8,0,1,0,9
1963,2022/11/25,16,6,6,0,22
1984,2022/11/25,9,0,6,0,15
2135,2022/11/25,0,0,0,0,0
2136,2022/11/25,9,0,1,0,10
2148,2022/11/25,15,8,3,0,18
2183,2022/11/25,10,6,4,0,14
2193,2022/11/25,21,18,21,0,42
2237,2022/11/25,7,0,0,0,7
2358,2022/11/25,5,0,1,0,6
2361,2022/11/25,13,7,7,1,20
2445,2022/11/25,17,12,8,0,25
2449,2022/11/25,13,6,3,0,16
2451,2022/11/25,20,10,11,1,31
2475,2022/11/25,6,0,1,0,7
2476,2022/11/25,10,0,1,0,11
2507,2022/11/25,12,12,13,0,25
2525,2022/11/25,5,0,2,0,7
2562,2022/11/25,5,0,1,0,6
2582,2022/11/25,10,4,3,0,13
2586,2022/11/25,20,20,27,1,47
2631,2022/11/25,15,6,7,0,22
2685,2022/11/25,14,8,7,0,21
2723,2022/11/25,5,0,1,0,6
2730,2022/11/25,9,0,4,0,13
2731,2022/11/25,7,0,1,0,8
2732,2022/11/25,10,8,1,0,11
2734,2022/11/25,18,4,3,0,21
2735,2022/11/25,6,4,1,0,7
2761,2022/11/25,15,15,16,0,31
2788,2022/11/25,26,16,26,0,52
2802,2022/11/25,12,6,0,0,12
2812,2022/11/25,9,6,0,0,9
2813,2022/11/25,6,0,0,0,6
2814,2022/11/25,2,0,1,0,3
2913,2022/11/25,8,0,3,0,11
2914,2022/11/25,7,0,0,0,7
3015,2022/11/25,7,0,1,0,8
3033,2022/11/25,7,0,0,0,7
3035,2022/11/25,7,0,2,0,9
4446,2022/11/25,19,6,7,0,26
12136,2022/11/25,18,21,19,0,37
12516,2022/11/25,4,4,2,0,6
12518,2022/11/25,5,4,4,0,9
12523,2022/11/25,7,4,2,0,9
16062,2022/11/25,11,0,0,0,11
16063,2022/11/25,8,0,0,0,8
16276,2022/11/25,2,0,1,0,3
19322,2022/11/25,5,0,0,0,5
19329,2022/11/25,11,0,1,0,12
19520,2022/11/25,6,0,1,0,7
19521,2022/11/25,9,0,0,0,9
20901,2022/11/25,4,0,2,0,6
20920,2022/11/25,14,0,0,0,14
21099,2022/11/25,9,0,0,0,9
21132,2022/11/25,30,18,30,0,60
21171,2022/11/25,8,4,2,0,10
21174,2022/11/25,12,12,12,0,24
21175,2022/11/25,12,8,9,0,21
21176,2022/11/25,15,8,15,0,30
75,2022/11/26,29,28,32,0,61
76,2022/11/26,39,36,38,0,77
99,2022/11/26,15,0,0,0,15
117,2022/11/26,8,0,1,0,9
118,2022/11/26,8,0,2,1,10
119,2022/11/26,3,0,1,2,4
120,2022/11/26,4,4,4,0,8
149,2022/11/26,12,6,0,0,12
184,2022/11/26,18,12,16,1,34
195,2022/11/26,-3,21,23,0,20
218,2022/11/26,21,24,26,0,47
296,2022/11/26,14,8,3,0,17
300,2022/11/26,7,4,2,0,9
304,2022/11/26,6,4,3,0,9
317,2022/11/26,17,12,0,0,17
343,2022/11/26,4,0,3,0,7
353,2022/11/26,6,0,0,0,6
373,2022/11/26,6,0,1,0,7
374,2022/11/26,8,4,3,0,11
388,2022/11/26,31,30,27,0,58
419,2022/11/26,6,6,1,0,7
420,2022/11/26,7,0,1,0,8
462,2022/11/26,29,16,6,0,35
519,2022/11/26,25,12,10,0,35
525,2022/11/26,9,0,1,0,10
596,2022/11/26,6,0,5,0,11
597,2022/11/26,9,0,7,0,16
598,2022/11/26,1,0,0,0,1
1035,2022/11/26,9,6,2,0,11
1084,2022/11/26,4,0,4,0,8
1111,2022/11/26,15,6,2,0,17
1112,2022/11/26,7,0,0,0,7
1113,2022/11/26,13,0,3,0,16
1114,2022/11/26,15,6,4,0,19
1115,2022/11/26,10,6,1,0,11
1117,2022/11/26,5,0,0,0,5
1118,2022/11/26,14,6,4,0,18
1119,2022/11/26,9,0,0,0,9
1692,2022/11/26,6,0,1,0,7
1693,2022/11/26,4,0,0,0,4
1747,2022/11/26,18,20,16,0,34
1773,2022/11/26,14,6,0,0,14
1774,2022/11/26,3,0,2,0,5
1782,2022/11/26,23,24,22,0,45
1795,2022/11/26,42,35,18,0,60
1914,2022/11/26,4,0,0,0,4
1915,2022/11/26,9,0,3,0,12
1923,2022/11/26,5,0,0,0,5
1934,2022/11/26,12,5,4,0,16
1963,2022/11/26,10,0,6,0,16
1984,2022/11/26,9,6,1,0,10
2135,2022/11/26,0,0,0,0,0
2136,2022/11/26,8,0,1,0,9
2148,2022/11/26,16,4,0,0,16
2183,2022/11/26,12,6,4,0,16
2193,2022/11/26,18,18,9,0,27
2237,2022/11/26,13,6,6,0,19
2358,2022/11/26,8,4,2,0,10
2361,2022/11/26,12,7,5,0,17
2445,2022/11/26,15,6,3,0,18
2449,2022/11/26,10,0,3,0,13
2451,2022/11/26,23,15,9,0,32
2475,2022/11/26,5,0,0,0,5
2476,2022/11/26,9,0,1,0,10
2507,2022/11/26,11,12,10,0,21
2525,2022/11/26,3,0,1,0,4
2562,2022/11/26,4,0,2,0,6
2582,2022/11/26,11,4,0,0,11
2586,2022/11/26,-7,0,1,0,-6
2631,2022/11/26,14,6,2,0,16
2685,2022/11/26,15,8,8,1,23
2723,2022/11/26,12,8,1,0,13
2730,2022/11/26,11,6,1,0,12
2731,2022/11/26,12,6,0,0,12
2732,2022/11/26,9,0,1,0,10
2734,2022/11/26,15,0,1,0,16
2735,2022/11/26,9,4,4,0,13
2761,2022/11/26,19,20,17,0,36
2788,2022/11/26,16,16,19,0,35
2802,2022/11/26,12,0,1,0,13
2812,2022/11/26,9,0,0,0,9
2813,2022/11/26,6,0,0,0,6
2814,2022/11/26,7,6,0,0,7
2913,2022/11/26,5,0,1,0,6
2914,2022/11/26,7,0,0,0,7
3015,2022/11/26,6,0,1,0,7
3033,2022/11/26,7,0,0,0,7
3035,2022/11/26,5,0,0,0,5
4446,2022/11/26,30,18,12,0,42
12136,2022/11/26,20,21,20,0,40
12516,2022/11/26,6,4,1,0,7
12518,2022/11/26,5,4,2,0,7
12523,2022/11/26,13,8,9,0,22
16062,2022/11/26,11,0,0,0,11
16063,2022/11/26,8,0,0,0,8
16276,2022/11/26,1,0,0,0,1
19322,2022/11/26,5,0,0,0,5
19329,2022/11/26,10,0,3,0,13
19520,2022/11/26,5,0,0,0,5
19521,2022/11/26,9,0,0,0,9
20901,2022/11/26,8,6,1,0,9
20920,2022/11/26,14,0,1,0,15
21099,2022/11/26,9,0,0,0,9
21132,2022/11/26,12,12,13,0,25
21171,2022/11/26,10,4,5,1,15
21174,2022/11/26,12,12,12,0,24
21175,2022/11/26,11,8,9,0,20
21176,2022/11/26,8,8,9,0,17
75,2022/11/27,29,32,37,0,66
76,2022/11/27,37,36,49,0,86
99,2022/11/27,15,0,1,0,16
117,2022/11/27,7,0,1,0,8
118,2022/11/27,5,0,0,0,5
119,2022/11/27,0,0,0,0,0
120,2022/11/27,0,0,0,0,0
149,2022/11/27,12,0,1,0,13
184,2022/11/27,10,9,10,0,20
195,2022/11/27,-2,24,28,0,26
218,2022/11/27,13,18,16,0,29
296,2022/11/27,15,4,7,0,22
300,2022/11/27,9,4,5,0,14
304,2022/11/27,7,4,3,0,10
317,2022/11/27,17,0,6,0,23
343,2022/11/27,5,4,4,0,9
353,2022/11/27,6,0,0,0,6
373,2022/11/27,11,6,5,0,16
374,2022/11/27,13,8,2,0,15
388,2022/11/27,22,18,23,0,45
419,2022/11/27,11,6,6,0,17
420,2022/11/27,6,0,0,0,6
462,2022/11/27,31,8,9,0,40
519,2022/11/27,21,6,8,0,29
525,2022/11/27,8,0,1,3,9
596,2022/11/27,9,8,4,0,13
597,2022/11/27,14,12,8,0,22
598,2022/11/27,7,6,3,0,10
1035,2022/11/27,13,6,3,0,16
1084,2022/11/27,10,10,9,0,19
1111,2022/11/27,13,0,5,0,18
1112,2022/11/27,7,0,1,0,8
1113,2022/11/27,10,0,2,0,12
1114,2022/11/27,11,0,6,0,17
1115,2022/11/27,9,0,4,0,13
1117,2022/11/27,5,0,1,0,6
1118,2022/11/27,10,0,6,0,16
1119,2022/11/27,9,0,1,0,10
1692,2022/11/27,11,6,0,0,11
1693,2022/11/27,10,6,2,0,12
1747,2022/11/27,22,20,23,0,45
1773,2022/11/27,14,0,3,0,17
1774,2022/11/27,9,8,1,0,10
1782,2022/11/27,13,12,15,0,28
1795,2022/11/27,24,0,9,0,33
1914,2022/11/27,4,0,0,0,4
1915,2022/11/27,6,0,1,0,7
1923,2022/11/27,5,0,0,0,5
1934,2022/11/27,8,0,0,6,8
1963,2022/11/27,16,12,11,0,27
1984,2022/11/27,8,0,3,0,11
2135,2022/11/27,0,0,0,0,0
2136,2022/11/27,7,0,1,0,8
2148,2022/11/27,16,0,1,0,17
2183,2022/11/27,14,6,3,0,17
2193,2022/11/27,21,12,15,3,36
2237,2022/11/27,7,0,2,0,9
2358,2022/11/27,14,8,6,1,20
2361,2022/11/27,7,0,4,0,11
2445,2022/11/27,18,6,7,0,25
2449,2022/11/27,7,0,1,0,8
2451,2022/11/27,54,40,14,0,68
2475,2022/11/27,5,0,0,0,5
2476,2022/11/27,8,0,2,0,10
2507,2022/11/27,13,12,6,0,19
2525,2022/11/27,8,6,2,0,10
2562,2022/11/27,8,6,3,0,11
2582,2022/11/27,15,4,2,0,17
2586,2022/11/27,3,12,5,0,8
2631,2022/11/27,12,0,1,0,13
2685,2022/11/27,14,8,8,0,22
2723,2022/11/27,11,0,3,0,14
2730,2022/11/27,10,0,9,0,19
2731,2022/11/27,12,0,4,0,16
2732,2022/11/27,8,0,3,0,11
2734,2022/11/27,14,0,0,0,14
2735,2022/11/27,9,4,5,0,14
2761,2022/11/27,17,15,12,0,29
2788,2022/11/27,9,12,17,0,26
2802,2022/11/27,11,0,1,0,12
2812,2022/11/27,9,0,1,0,10
2813,2022/11/27,6,0,1,0,7
2814,2022/11/27,7,0,2,0,9
2913,2022/11/27,4,0,0,0,4
2914,2022/11/27,7,0,0,0,7
3015,2022/11/27,5,0,4,0,9
3033,2022/11/27,7,0,1,0,8
3035,2022/11/27,5,0,2,0,7
4446,2022/11/27,24,6,11,0,35
12136,2022/11/27,0,0,2,0,2
12516,2022/11/27,5,0,0,0,5
12518,2022/11/27,7,4,5,0,12
12523,2022/11/27,12,8,3,0,15
16062,2022/11/27,11,0,3,0,14
16063,2022/11/27,8,0,0,0,8
16276,2022/11/27,5,4,1,0,6
19322,2022/11/27,5,0,1,0,6
19329,2022/11/27,7,0,2,0,9
19520,2022/11/27,5,0,0,0,5
19521,2022/11/27,9,0,0,0,9
20901,2022/11/27,7,0,2,0,9
20920,2022/11/27,13,0,1,0,14
21099,2022/11/27,9,0,0,0,9
21102,2022/11/27,17,0,1,0,18
21132,2022/11/27,17,18,14,0,31
21171,2022/11/27,8,4,1,0,9
21174,2022/11/27,12,12,13,0,25
21175,2022/11/27,10,8,7,0,17
21176,2022/11/27,7,8,10,0,17
75,2022/11/28,30,36,31,0,61
76,2022/11/28,32,44,34,1,66
99,2022/11/28,14,0,1,0,15
117,2022/11/28,6,0,0,3,6
118,2022/11/28,9,4,3,1,12
119,2022/11/28,4,4,1,0,5
120,2022/11/28,4,4,3,0,7
149,2022/11/28,11,0,0,0,11
184,2022/11/28,12,12,8,0,20
195,2022/11/28,6,36,30,0,36
218,2022/11/28,27,30,30,0,57
296,2022/11/28,16,8,5,0,21
300,2022/11/28,8,4,4,0,12
304,2022/11/28,12,8,1,0,13
317,2022/11/28,11,0,3,0,14
343,2022/11/28,1,0,1,0,2
353,2022/11/28,6,0,2,0,8
373,2022/11/28,6,0,2,0,8
374,2022/11/28,11,0,1,0,12
388,2022/11/28,23,24,24,0,47
419,2022/11/28,11,6,3,0,14
420,2022/11/28,12,6,2,0,14
462,2022/11/28,30,8,12,0,42
519,2022/11/28,19,6,8,0,27
525,2022/11/28,4,0,0,0,4
596,2022/11/28,9,4,3,0,12
597,2022/11/28,18,12,11,0,29
598,2022/11/28,10,6,0,0,10
1035,2022/11/28,10,0,1,0,11
1084,2022/11/28,16,15,5,0,21
1111,2022/11/28,8,0,1,0,9
1112,2022/11/28,6,0,0,0,6
1113,2022/11/28,8,0,1,0,9
1114,2022/11/28,11,6,4,0,15
1115,2022/11/28,11,6,1,0,12
1117,2022/11/28,12,8,1,0,13
1118,2022/11/28,4,0,1,0,5
1119,2022/11/28,8,0,0,0,8
1692,2022/11/28,17,6,2,0,19
1693,2022/11/28,8,0,0,0,8
1747,2022/11/28,19,20,19,0,38
1773,2022/11/28,11,0,1,0,12
1774,2022/11/28,8,0,2,0,10
1782,2022/11/28,16,18,15,0,31
1795,2022/11/28,29,14,21,0,50
1914,2022/11/28,10,6,0,0,10
1915,2022/11/28,5,0,2,0,7
1923,2022/11/28,11,6,0,0,11
1934,2022/11/28,7,5,3,0,10
1963,2022/11/28,11,6,6,0,17
1984,2022/11/28,11,6,2,0,13
2135,2022/11/28,0,0,0,0,0
2136,2022/11/28,6,0,2,0,8
2148,2022/11/28,15,0,0,0,15
2183,2022/11/28,17,6,1,0,18
2193,2022/11/28,21,18,27,0,48
2237,2022/11/28,11,6,2,0,13
2358,2022/11/28,7,0,4,0,11
2361,2022/11/28,10,7,4,0,14
2445,2022/11/28,11,0,6,0,17
2449,2022/11/28,12,6,2,0,14
2451,2022/11/28,40,0,13,0,53
2475,2022/11/28,11,6,0,0,11
2476,2022/11/28,12,6,0,0,12
2507,2022/11/28,19,12,11,0,30
2525,2022/11/28,6,0,2,0,8
2562,2022/11/28,5,0,1,0,6
2582,2022/11/28,13,0,0,0,13
2586,2022/11/28,18,20,18,0,36
2631,2022/11/28,11,0,2,0,13
2685,2022/11/28,14,8,6,0,20
2723,2022/11/28,8,0,4,0,12
2730,2022/11/28,7,6,0,0,7
2731,2022/11/28,8,0,2,0,10
2732,2022/11/28,5,0,4,0,9
2734,2022/11/28,14,0,4,0,18
2735,2022/11/28,8,4,0,0,8
2761,2022/11/28,20,15,14,0,34
2788,2022/11/28,16,24,18,0,34
2802,2022/11/28,10,0,3,0,13
2812,2022/11/28,8,0,3,0,11
2813,2022/11/28,5,0,0,0,5
2814,2022/11/28,5,0,2,0,7
2913,2022/11/28,4,0,0,0,4
2914,2022/11/28,7,0,1,0,8
3015,2022/11/28,9,8,0,0,9
3033,2022/11/28,6,0,0,0,6
3035,2022/11/28,9,6,0,0,9
4446,2022/11/28,25,12,13,0,38
12136,2022/11/28,31,33,33,0,64
12516,2022/11/28,5,0,2,0,7
12518,2022/11/28,6,4,4,0,10
12523,2022/11/28,9,0,6,0,15
16062,2022/11/28,8,0,0,0,8
16063,2022/11/28,8,0,2,0,10
16276,2022/11/28,4,0,1,0,5
19322,2022/11/28,4,0,1,0,5
19329,2022/11/28,5,0,1,0,6
19520,2022/11/28,13,8,0,0,13
19521,2022/11/28,9,0,0,0,9
20901,2022/11/28,5,0,0,0,5
20920,2022/11/28,12,0,5,0,17
21099,2022/11/28,9,0,0,0,9
21102,2022/11/28,16,0,0,0,16
21132,2022/11/28,18,15,18,0,36
21171,2022/11/28,11,4,5,0,16
21174,2022/11/28,11,12,11,0,22
21175,2022/11/28,15,12,12,0,27
21176,2022/11/28,-3,0,3,0,0
75,2022/11/29,33,36,37,0,70
76,2022/11/29,33,36,32,0,65
99,2022/11/29,13,0,1,0,14
117,2022/11/29,7,4,1,0,8
118,2022/11/29,9,4,1,0,10
119,2022/11/29,3,0,2,1,5
120,2022/11/29,5,4,1,0,6
184,2022/11/29,13,9,5,0,18
195,2022/11/29,6,30,25,0,31
218,2022/11/29,30,33,32,0,62
296,2022/11/29,11,0,3,0,14
300,2022/11/29,8,4,4,0,12
304,2022/11/29,15,4,8,0,23
317,2022/11/29,14,6,1,0,15
343,2022/11/29,4,4,1,0,5
353,2022/11/29,4,0,1,0,5
373,2022/11/29,10,6,5,0,15
374,2022/11/29,14,4,5,0,19
388,2022/11/29,29,30,26,0,55
419,2022/11/29,14,6,10,0,24
420,2022/11/29,10,0,3,0,13
462,2022/11/29,26,8,12,0,38
519,2022/11/29,11,0,3,0,14
525,2022/11/29,4,0,0,0,4
596,2022/11/29,14,8,3,0,17
597,2022/11/29,25,18,14,2,39
598,2022/11/29,16,6,3,0,19
1035,2022/11/29,15,6,1,0,16
1084,2022/11/29,21,10,18,0,39
1111,2022/11/29,7,0,1,0,8
1112,2022/11/29,6,0,1,0,7
1113,2022/11/29,7,0,0,0,7
1114,2022/11/29,7,0,5,0,12
1115,2022/11/29,10,0,0,0,10
1117,2022/11/29,11,0,0,0,11
1118,2022/11/29,9,6,1,0,10
1119,2022/11/29,8,0,2,0,10
1692,2022/11/29,21,6,4,0,25
1693,2022/11/29,8,0,4,0,12
1747,2022/11/29,25,25,17,0,42
1773,2022/11/29,10,0,3,0,13
1774,2022/11/29,6,0,2,0,8
1782,2022/11/29,25,24,24,0,49
1795,2022/11/29,22,14,7,0,29
1914,2022/11/29,10,0,1,0,11
1915,2022/11/29,9,6,2,0,11
1923,2022/11/29,11,0,1,0,12
1934,2022/11/29,4,0,1,0,5
1963,2022/11/29,11,6,6,0,17
1984,2022/11/29,15,6,3,0,18
2135,2022/11/29,0,0,0,0,0
2136,2022/11/29,4,0,0,0,4
2148,2022/11/29,19,4,4,0,23
2183,2022/11/29,16,0,1,1,17
2193,2022/11/29,15,21,16,0,31
2237,2022/11/29,15,6,7,0,22
2358,2022/11/29,11,8,5,0,16
2361,2022/11/29,6,0,4,0,10
2445,2022/11/29,11,6,4,0,15
2449,2022/11/29,10,0,7,2,17
2451,2022/11/29,27,0,16,0,43
2475,2022/11/29,11,0,1,0,12
2476,2022/11/29,12,0,1,0,13
2507,2022/11/29,20,12,13,0,33
2525,2022/11/29,4,0,0,0,4
2562,2022/11/29,10,6,2,0,12
2582,2022/11/29,17,4,1,0,18
2586,2022/11/29,20,20,12,0,32
2631,2022/11/29,15,6,4,0,19
2685,2022/11/29,16,8,7,4,23
2723,2022/11/29,4,0,1,0,5
2730,2022/11/29,7,0,1,0,8
2731,2022/11/29,6,0,0,0,6
2732,2022/11/29,1,0,1,0,2
2734,2022/11/29,14,4,5,0,19
2735,2022/11/29,12,4,6,0,18
2761,2022/11/29,31,25,17,0,48
2788,2022/11/29,26,28,18,0,44
2802,2022/11/29,7,0,0,0,7
2812,2022/11/29,5,0,0,0,5
2813,2022/11/29,5,0,0,0,5
2814,2022/11/29,3,0,1,0,4
2913,2022/11/29,10,6,1,0,11
2914,2022/11/29,6,0,0,0,6
3015,2022/11/29,9,0,4,0,13
3033,2022/11/29,6,0,0,0,6
3035,2022/11/29,9,0,0,0,9
4446,2022/11/29,24,12,10,0,34
12136,2022/11/29,25,27,28,0,53
12516,2022/11/29,11,8,2,0,13
12518,2022/11/29,6,4,4,0,10
12523,2022/11/29,7,4,4,0,11
16062,2022/11/29,8,0,1,0,9
16063,2022/11/29,6,0,0,0,6
16276,2022/11/29,7,4,1,0,8
19322,2022/11/29,3,0,1,0,4
19329,2022/11/29,10,6,3,0,13
19520,2022/11/29,13,0,3,0,16
19521,2022/11/29,9,0,1,0,10
20901,2022/11/29,5,0,0,0,5
20920,2022/11/29,7,0,1,0,8
21099,2022/11/29,9,0,0,0,9
21102,2022/11/29,16,0,0,0,16
21132,2022/11/29,18,18,16,0,34
21171,2022/11/29,10,4,2,2,12
21174,2022/11/29,12,12,10,0,22
21175,2022/11/29,11,8,6,0,17
21176,2022/11/29,2,8,6,0,8
75,2022/11/30,32,36,37,0,69
76,2022/11/30,41,40,45,0,86
99,2022/11/30,12,0,0,0,12
117,2022/11/30,6,0,1,1,7
118,2022/11/30,8,0,5,0,13
119,2022/11/30,4,4,3,0,7
120,2022/11/30,8,4,2,0,10
184,2022/11/30,20,12,12,1,32
195,2022/11/30,14,33,34,0,48
218,2022/11/30,22,24,24,0,46
296,2022/11/30,12,4,2,0,14
300,2022/11/30,4,0,2,0,6
304,2022/11/30,11,4,2,0,13
317,2022/11/30,19,6,5,0,24
343,2022/11/30,3,0,2,0,5
353,2022/11/30,3,0,0,0,3
373,2022/11/30,11,6,0,1,11
374,2022/11/30,13,4,1,0,14
388,2022/11/30,23,21,26,0,49
419,2022/11/30,16,12,3,0,19
420,2022/11/30,13,6,3,0,16
462,2022/11/30,14,0,6,0,20
519,2022/11/30,11,6,1,0,12
525,2022/11/30,3,0,1,2,4
596,2022/11/30,19,8,7,0,26
597,2022/11/30,27,18,23,0,50
598,2022/11/30,13,0,2,0,15
1035,2022/11/30,20,6,1,0,21
1084,2022/11/30,18,15,10,0,28
1111,2022/11/30,6,0,0,0,6
1112,2022/11/30,11,6,0,0,11
1113,2022/11/30,7,0,1,0,8
1114,2022/11/30,2,0,1,0,3
1115,2022/11/30,10,0,1,0,11
1117,2022/11/30,11,0,2,0,13
1118,2022/11/30,14,6,1,0,15
1119,2022/11/30,6,0,0,0,6
1692,2022/11/30,17,0,5,0,22
1693,2022/11/30,4,0,0,0,4
1747,2022/11/30,33,25,35,0,68
1773,2022/11/30,7,0,0,0,7
1774,2022/11/30,4,0,0,0,4
1782,2022/11/30,25,24,17,0,42
1795,2022/11/30,29,14,21,0,50
1914,2022/11/30,9,0,0,0,9
1915,2022/11/30,7,0,1,0,8
1923,2022/11/30,10,0,0,0,10
1934,2022/11/30,3,0,3,0,6
1963,2022/11/30,11,6,2,0,13
1984,2022/11/30,12,0,0,3,12
2135,2022/11/30,0,0,0,0,0
2136,2022/11/30,10,6,1,0,11
2148,2022/11/30,15,0,0,0,15
2183,2022/11/30,14,0,1,1,15
2193,2022/11/30,8,9,6,0,14
2237,2022/11/30,8,0,1,0,9
2358,2022/11/30,6,0,3,0,9
2361,2022/11/30,9,7,6,0,15
2445,2022/11/30,7,0,2,0,9
2449,2022/11/30,7,6,4,0,11
2451,2022/11/30,11,0,8,0,19
2475,2022/11/30,10,0,0,0,10
2476,2022/11/30,11,0,0,0,11
2507,2022/11/30,19,12,9,0,28
2525,2022/11/30,4,0,0,0,4
2562,2022/11/30,8,0,2,0,10
2582,2022/11/30,16,0,1,0,17
2586,2022/11/30,24,16,23,0,47
2602,2022/11/30,8,0,1,0,9
2631,2022/11/30,11,0,1,5,12
2685,2022/11/30,13,8,7,0,20
2723,2022/11/30,11,8,1,0,12
2730,2022/11/30,12,6,1,0,13
2731,2022/11/30,12,6,2,0,14
2732,2022/11/30,8,8,0,0,8
2734,2022/11/30,9,0,2,0,11
2735,2022/11/30,10,4,0,0,10
2761,2022/11/30,34,20,23,0,57
2788,2022/11/30,28,20,31,0,59
2802,2022/11/30,7,0,1,0,8
2812,2022/11/30,5,0,0,0,5
2813,2022/11/30,5,0,0,0,5
2814,2022/11/30,8,6,3,0,11
2913,2022/11/30,9,0,2,0,11
2914,2022/11/30,12,6,0,0,12
3015,2022/11/30,5,0,1,0,6
3033,2022/11/30,6,0,0,0,6
3035,2022/11/30,9,0,0,0,9
4446,2022/11/30,26,12,12,0,38
12136,2022/11/30,24,27,30,0,54
12516,2022/11/30,13,4,2,0,15
12518,2022/11/30,6,4,3,0,9
12523,2022/11/30,7,4,2,0,9
16062,2022/11/30,13,6,1,0,14
16276,2022/11/30,6,0,0,0,6
19322,2022/11/30,8,6,2,0,10
19329,2022/11/30,7,0,0,0,7
19520,2022/11/30,10,0,0,0,10
19521,2022/11/30,8,0,0,0,8
20901,2022/11/30,5,0,0,0,5
20920,2022/11/30,6,0,0,0,6
21102,2022/11/30,16,0,0,0,16
21132,2022/11/30,20,18,21,0,41
21171,2022/11/30,6,0,1,1,7
21174,2022/11/30,14,12,14,0,28
21175,2022/11/30,13,8,8,0,21
21176,2022/11/30,2,8,7,0,9
75,2022/12/01,35,40,42,0,77
76,2022/12/01,48,52,45,0,93
99,2022/12/01,12,0,0,0,12
117,2022/12/01,4,0,1,0,5
118,2022/12/01,3,0,1,0,4
119,2022/12/01,1,0,2,0,3
120,2022/12/01,10,4,1,0,11
184,2022/12/01,19,12,14,0,33
195,2022/12/01,16,36,41,0,57
218,2022/12/01,28,30,26,0,54
296,2022/12/01,14,4,5,0,19
300,2022/12/01,10,8,1,0,11
304,2022/12/01,13,4,6,0,19
317,2022/12/01,20,6,1,0,21
343,2022/12/01,5,4,2,0,7
353,2022/12/01,9,6,0,0,9
373,2022/12/01,16,6,1,0,17
374,2022/12/01,16,4,6,0,22
388,2022/12/01,31,33,27,0,58
419,2022/12/01,19,6,3,0,22
420,2022/12/01,10,0,1,0,11
462,2022/12/01,16,8,5,0,21
519,2022/12/01,16,6,13,0,29
525,2022/12/01,5,5,5,0,10
596,2022/12/01,20,8,3,0,23
597,2022/12/01,22,18,12,0,34
598,2022/12/01,17,6,0,0,17
1035,2022/12/01,19,0,6,0,25
1084,2022/12/01,23,15,18,0,41
1111,2022/12/01,12,6,3,0,15
1112,2022/12/01,11,0,0,0,11
1113,2022/12/01,6,0,1,0,7
1114,2022/12/01,7,6,5,0,12
1115,2022/12/01,9,0,2,0,11
1117,2022/12/01,9,0,2,0,11
1118,2022/12/01,13,0,1,0,14
1119,2022/12/01,6,0,0,0,6
1692,2022/12/01,12,0,2,0,14
1693,2022/12/01,10,6,0,0,10
1747,2022/12/01,18,20,17,0,35
1773,2022/12/01,7,0,0,0,7
1774,2022/12/01,12,8,1,0,13
1782,2022/12/01,32,24,34,0,66
1795,2022/12/01,23,14,25,0,48
1914,2022/12/01,9,0,0,0,9
1915,2022/12/01,6,0,0,0,6
1923,2022/12/01,10,0,1,0,11
1934,2022/12/01,5,5,3,0,8
1963,2022/12/01,15,6,2,0,17
1984,2022/12/01,9,0,1,0,10
2135,2022/12/01,12,12,2,0,14
2136,2022/12/01,9,0,0,0,9
2148,2022/12/01,15,0,2,0,17
2183,2022/12/01,12,0,3,2,15
2193,2022/12/01,20,18,19,0,39
2237,2022/12/01,7,0,2,0,9
2358,2022/12/01,11,8,1,0,12
2361,2022/12/01,10,7,8,0,18
2445,2022/12/01,11,6,1,0,12
2449,2022/12/01,3,0,1,0,4
2451,2022/12/01,18,15,12,1,30
2475,2022/12/01,10,0,0,0,10
2476,2022/12/01,11,0,0,0,11
2507,2022/12/01,22,12,13,0,35
2525,2022/12/01,10,6,2,0,12
2562,2022/12/01,12,6,3,0,15
2582,2022/12/01,15,0,2,0,17
2586,2022/12/01,21,20,28,0,49
2602,2022/12/01,7,0,0,0,7
2631,2022/12/01,5,0,3,0,8
2685,2022/12/01,14,8,10,0,24
2723,2022/12/01,10,0,1,0,11
2730,2022/12/01,17,6,4,0,21
2731,2022/12/01,10,0,0,0,10
2732,2022/12/01,8,0,0,0,8
2734,2022/12/01,7,0,1,0,8
2735,2022/12/01,14,4,4,0,18
2761,2022/12/01,26,15,22,0,48
2788,2022/12/01,21,24,25,0,46
2802,2022/12/01,12,6,0,0,12
2812,2022/12/01,11,6,0,0,11
2813,2022/12/01,5,0,2,0,7
2814,2022/12/01,5,0,4,0,9
2913,2022/12/01,13,6,4,0,17
2914,2022/12/01,12,0,0,0,12
3015,2022/12/01,4,0,3,0,7
3033,2022/12/01,6,0,0,0,6
3035,2022/12/01,9,0,0,0,9
4446,2022/12/01,26,12,14,0,40
12136,2022/12/01,33,39,48,0,81
12516,2022/12/01,15,4,3,0,18
12518,2022/12/01,7,4,1,0,8
12523,2022/12/01,9,4,3,0,12
16062,2022/12/01,12,0,1,0,13
16276,2022/12/01,6,0,0,0,6
19322,2022/12/01,6,0,1,0,7
19329,2022/12/01,7,0,4,0,11
19520,2022/12/01,10,0,1,0,11
19521,2022/12/01,8,0,1,0,9
20901,2022/12/01,5,0,0,0,5
20920,2022/12/01,18,12,2,0,20
21102,2022/12/01,16,0,0,0,16
21132,2022/12/01,20,21,20,0,40
21171,2022/12/01,8,4,7,0,15
21174,2022/12/01,12,12,13,0,25
21175,2022/12/01,13,8,9,0,22
21176,2022/12/01,5,8,11,0,16
75,2022/12/02,33,40,37,0,70
76,2022/12/02,43,40,41,0,84
99,2022/12/02,12,0,1,0,13
117,2022/12/02,7,4,3,0,10
118,2022/12/02,6,4,1,0,7
119,2022/12/02,-1,0,0,0,-1
120,2022/12/02,9,0,0,0,9
184,2022/12/02,17,12,13,0,30
195,2022/12/02,5,30,32,0,37
218,2022/12/02,32,30,7,0,39
296,2022/12/02,13,4,5,1,18
300,2022/12/02,13,4,0,0,13
304,2022/12/02,7,0,4,0,11
317,2022/12/02,25,6,1,4,26
343,2022/12/02,7,4,4,0,11
353,2022/12/02,9,0,0,0,9
373,2022/12/02,15,0,8,6,23
374,2022/12/02,10,0,3,0,13
388,2022/12/02,28,24,24,0,52
419,2022/12/02,16,0,5,1,21
420,2022/12/02,9,0,2,0,11
462,2022/12/02,19,8,17,1,36
519,2022/12/02,15,12,13,0,28
525,2022/12/02,0,0,0,0,0
596,2022/12/02,29,12,9,0,38
597,2022/12/02,40,30,11,0,51
598,2022/12/02,17,0,4,0,21
1035,2022/12/02,13,0,6,5,19
1084,2022/12/02,25,20,16,0,41
1111,2022/12/02,9,0,0,0,9
1112,2022/12/02,11,0,1,0,12
1113,2022/12/02,11,6,1,0,12
1114,2022/12/02,8,6,6,0,14
1115,2022/12/02,13,6,3,0,16
1117,2022/12/02,7,0,3,0,10
1118,2022/12/02,12,0,4,0,16
1119,2022/12/02,6,0,0,0,6
1692,2022/12/02,10,0,1,3,11
1693,2022/12/02,10,0,2,0,12
1747,2022/12/02,26,25,2,0,28
1773,2022/12/02,13,6,4,0,17
1774,2022/12/02,11,0,0,0,11
1782,2022/12/02,28,30,27,0,55
1795,2022/12/02,18,21,17,0,35
1914,2022/12/02,9,0,0,0,9
1915,2022/12/02,12,6,0,0,12
1923,2022/12/02,9,0,2,0,11
1934,2022/12/02,2,0,2,0,4
1963,2022/12/02,19,6,3,2,22
1984,2022/12/02,8,0,8,0,16
2135,2022/12/02,22,12,6,0,28
2136,2022/12/02,9,0,0,0,9
2148,2022/12/02,13,0,4,0,17
2183,2022/12/02,7,0,5,1,12
2193,2022/12/02,22,21,24,0,46
2237,2022/12/02,11,6,4,0,15
2358,2022/12/02,14,4,2,0,16
2361,2022/12/02,9,7,4,0,13
2445,2022/12/02,16,6,10,0,26
2449,2022/12/02,2,0,1,0,3
2451,2022/12/02,15,10,11,0,26
2475,2022/12/02,10,0,0,0,10
2476,2022/12/02,11,0,0,0,11
2507,2022/12/02,21,12,16,1,37
2525,2022/12/02,14,6,0,0,14
2562,2022/12/02,9,0,0,0,9
2582,2022/12/02,13,0,0,0,13
2586,2022/12/02,21,28,22,0,43
2602,2022/12/02,7,0,0,0,7
2631,2022/12/02,8,6,5,0,13
2685,2022/12/02,12,8,4,1,16
2723,2022/12/02,9,0,0,0,9
2730,2022/12/02,13,0,1,0,14
2731,2022/12/02,10,0,4,0,14
2732,2022/12/02,8,0,1,0,9
2734,2022/12/02,10,4,2,0,12
2735,2022/12/02,10,0,3,0,13
2761,2022/12/02,24,20,20,0,44
2788,2022/12/02,20,24,19,0,39
2802,2022/12/02,12,0,0,0,12
2812,2022/12/02,11,0,1,0,12
2813,2022/12/02,3,0,0,0,3
2814,2022/12/02,1,0,0,0,1
2913,2022/12/02,9,0,1,0,10
2914,2022/12/02,12,0,0,0,12
3015,2022/12/02,9,8,3,0,12
3033,2022/12/02,6,0,1,0,7
3035,2022/12/02,9,0,0,0,9
4446,2022/12/02,24,12,11,0,35
12136,2022/12/02,15,30,21,0,36
12516,2022/12/02,12,0,3,0,15
12518,2022/12/02,10,4,5,0,15
12523,2022/12/02,10,4,5,0,15
16062,2022/12/02,11,0,2,0,13
16276,2022/12/02,6,0,0,0,6
19322,2022/12/02,5,0,0,0,5
19329,2022/12/02,9,6,1,0,10
19520,2022/12/02,9,0,0,0,9
19521,2022/12/02,7,0,0,0,7
20901,2022/12/02,5,0,0,0,5
20920,2022/12/02,16,0,0,0,16
21099,2022/12/02,9,0,1,0,10
21102,2022/12/02,16,0,1,0,17
21132,2022/12/02,18,18,22,0,40
21171,2022/12/02,1,0,0,1,1
21174,2022/12/02,11,12,10,0,21
21175,2022/12/02,12,8,7,0,19
21176,2022/12/02,6,12,5,0,11
75,2022/12/03,28,32,34,0,62
76,2022/12/03,42,40,45,0,87
99,2022/12/03,11,0,0,0,11
117,2022/12/03,4,0,0,0,4
118,2022/12/03,5,0,2,0,7
119,2022/12/03,3,4,3,0,6
120,2022/12/03,9,0,1,0,10
184,2022/12/03,16,12,10,0,26
195,2022/12/03,-3,24,24,0,21
218,2022/12/03,49,24,24,0,73
296,2022/12/03,7,0,5,1,12
300,2022/12/03,17,4,5,0,22
304,2022/12/03,7,4,5,0,12
317,2022/12/03,20,0,8,1,28
343,2022/12/03,3,0,1,0,4
353,2022/12/03,9,0,0,0,9
373,2022/12/03,1,0,1,0,2
374,2022/12/03,7,0,1,0,8
388,2022/12/03,22,18,17,0,39
419,2022/12/03,10,0,4,0,14
420,2022/12/03,7,0,1,0,8
462,2022/12/03,9,8,9,0,18
519,2022/12/03,14,12,6,0,20
525,2022/12/03,0,0,0,0,0
596,2022/12/03,20,0,5,4,25
597,2022/12/03,29,0,20,0,49
598,2022/12/03,13,0,3,0,16
1035,2022/12/03,8,6,3,0,11
1084,2022/12/03,9,0,7,0,16
1111,2022/12/03,9,0,2,0,11
1112,2022/12/03,10,0,0,0,10
1113,2022/12/03,10,0,1,0,11
1114,2022/12/03,8,6,5,0,13
1115,2022/12/03,10,0,4,0,14
1117,2022/12/03,4,0,1,0,5
1118,2022/12/03,14,6,0,0,14
1119,2022/12/03,6,0,0,0,6
1692,2022/12/03,6,0,0,0,6
1693,2022/12/03,8,0,3,0,11
1747,2022/12/03,39,15,16,0,55
1773,2022/12/03,9,0,0,0,9
1774,2022/12/03,11,0,1,0,12
1782,2022/12/03,22,21,21,0,43
1795,2022/12/03,29,28,19,0,48
1914,2022/12/03,9,0,0,0,9
1915,2022/12/03,12,0,2,0,14
1923,2022/12/03,7,0,1,0,8
1934,2022/12/03,5,5,5,0,10
1963,2022/12/03,20,6,7,0,27
1984,2022/12/03,0,0,0,0,0
2135,2022/12/03,16,0,3,0,19
2136,2022/12/03,9,0,2,0,11
2148,2022/12/03,9,0,3,0,12
2183,2022/12/03,7,6,6,0,13
2193,2022/12/03,10,12,13,0,23
2237,2022/12/03,13,6,5,0,18
2358,2022/12/03,16,4,6,0,22
2361,2022/12/03,12,7,2,0,14
2445,2022/12/03,12,6,8,0,20
2449,2022/12/03,7,6,3,0,10
2451,2022/12/03,24,20,6,0,30
2475,2022/12/03,10,0,0,0,10
2476,2022/12/03,11,0,2,0,13
2507,2022/12/03,16,12,10,0,26
2525,2022/12/03,14,0,2,0,16
2562,2022/12/03,9,0,0,0,9
2582,2022/12/03,13,0,0,0,13
2586,2022/12/03,15,16,16,0,31
2602,2022/12/03,7,0,0,0,7
2631,2022/12/03,3,0,2,0,5
2685,2022/12/03,15,8,8,0,23
2723,2022/12/03,9,0,4,0,13
2730,2022/12/03,12,0,3,0,15
2731,2022/12/03,6,0,0,0,6
2732,2022/12/03,7,0,2,0,9
2734,2022/12/03,8,0,1,0,9
2735,2022/12/03,11,4,3,0,14
2761,2022/12/03,19,15,9,0,28
2788,2022/12/03,21,20,21,3,42
2802,2022/12/03,12,0,2,0,14
2812,2022/12/03,10,0,0,0,10
2813,2022/12/03,3,0,1,0,4
2814,2022/12/03,7,6,0,0,7
2913,2022/12/03,8,0,3,0,11
2914,2022/12/03,12,0,0,0,12
3015,2022/12/03,6,0,2,0,8
3033,2022/12/03,5,0,0,0,5
3035,2022/12/03,9,0,2,0,11
4446,2022/12/03,19,6,6,0,25
12136,2022/12/03,15,21,24,0,39
12516,2022/12/03,9,0,2,0,11
12518,2022/12/03,9,4,2,0,11
12523,2022/12/03,13,8,4,0,17
16062,2022/12/03,9,0,1,0,10
16276,2022/12/03,6,0,1,0,7
19322,2022/12/03,11,6,1,0,12
19329,2022/12/03,8,0,0,0,8
19520,2022/12/03,9,0,0,0,9
20901,2022/12/03,5,0,1,0,6
20920,2022/12/03,16,0,0,0,16
21099,2022/12/03,8,0,0,0,8
21102,2022/12/03,15,0,0,0,15
21132,2022/12/03,14,18,14,0,28
21171,2022/12/03,4,4,0,0,4
21174,2022/12/03,13,12,17,0,30
21175,2022/12/03,13,8,8,0,21
21176,2022/12/03,9,8,11,1,20
75,2022/12/04,29,32,23,0,52
76,2022/12/04,37,40,40,0,77
99,2022/12/04,11,0,0,0,11
117,2022/12/04,4,0,0,1,4
118,2022/12/04,7,4,1,1,8
119,2022/12/04,0,0,2,0,2
120,2022/12/04,8,0,0,0,8
184,2022/12/04,18,12,18,0,36
195,2022/12/04,-1,24,22,0,21
218,2022/12/04,46,18,16,0,62
296,2022/12/04,5,4,4,0,9
300,2022/12/04,16,4,2,0,18
304,2022/12/04,6,4,3,0,9
317,2022/12/04,11,0,4,0,15
343,2022/12/04,6,4,3,0,9
353,2022/12/04,9,0,0,0,9
373,2022/12/04,6,6,3,0,9
374,2022/12/04,14,8,4,0,18
388,2022/12/04,26,21,24,0,50
419,2022/12/04,12,6,10,0,22
420,2022/12/04,12,6,2,0,14
462,2022/12/04,8,8,7,0,15
519,2022/12/04,14,6,9,0,23
525,2022/12/04,5,5,2,0,7
596,2022/12/04,19,8,5,1,24
597,2022/12/04,21,12,8,0,29
598,2022/12/04,10,0,0,0,10
1035,2022/12/04,5,0,4,0,9
1084,2022/12/04,12,10,10,0,22
1111,2022/12/04,13,6,3,0,16
1112,2022/12/04,10,0,0,0,10
1113,2022/12/04,9,0,2,0,11
1114,2022/12/04,9,6,7,0,16
1115,2022/12/04,6,0,1,0,7
1117,2022/12/04,3,0,4,0,7
1118,2022/12/04,14,0,2,0,16
1119,2022/12/04,6,0,1,0,7
1692,2022/12/04,6,0,2,0,8
1693,2022/12/04,5,0,0,0,5
1747,2022/12/04,43,20,20,0,63
1773,2022/12/04,9,0,3,0,12
1774,2022/12/04,10,0,3,0,13
1782,2022/12/04,13,12,15,0,28
1795,2022/12/04,10,0,10,0,20
1914,2022/12/04,9,0,3,0,12
1915,2022/12/04,10,0,1,0,11
1923,2022/12/04,6,0,0,0,6
1934,2022/12/04,5,5,0,0,5
1963,2022/12/04,19,6,12,0,31
1984,2022/12/04,6,6,1,0,7
2135,2022/12/04,13,0,3,0,16
2136,2022/12/04,7,0,0,0,7
2148,2022/12/04,6,0,0,0,6
2183,2022/12/04,1,0,0,0,1
2193,2022/12/04,12,15,14,0,26
2237,2022/12/04,8,0,1,0,9
2358,2022/12/04,18,8,2,0,20
2361,2022/12/04,17,7,3,0,20
2445,2022/12/04,10,6,7,0,17
2449,2022/12/04,10,6,6,0,16
2451,2022/12/04,63,45,18,0,81
2475,2022/12/04,10,0,1,0,11
2476,2022/12/04,9,0,0,0,9
2507,2022/12/04,18,12,15,0,33
2525,2022/12/04,12,0,1,0,13
2562,2022/12/04,9,0,4,0,13
2582,2022/12/04,13,0,0,0,13
2586,2022/12/04,11,12,9,1,20
2602,2022/12/04,7,0,0,0,7
2631,2022/12/04,7,6,6,0,13
2685,2022/12/04,15,8,6,0,21
2723,2022/12/04,5,0,2,0,7
2730,2022/12/04,9,0,0,0,9
2731,2022/12/04,6,0,4,0,10
2732,2022/12/04,5,0,1,0,6
2734,2022/12/04,15,8,0,0,15
2735,2022/12/04,12,4,0,0,12
2761,2022/12/04,25,15,15,0,40
2788,2022/12/04,13,16,18,0,31
2802,2022/12/04,10,0,1,0,11
2812,2022/12/04,10,0,2,0,12
2813,2022/12/04,8,6,2,0,10
2814,2022/12/04,7,0,0,0,7
2913,2022/12/04,5,0,0,0,5
2914,2022/12/04,12,0,3,0,15
3015,2022/12/04,4,0,0,0,4
3033,2022/12/04,5,0,1,0,6
3035,2022/12/04,7,0,0,0,7
4446,2022/12/04,25,12,9,0,34
12136,2022/12/04,9,18,10,0,19
12516,2022/12/04,7,0,1,0,8
12518,2022/12/04,11,4,6,0,17
12523,2022/12/04,17,8,7,0,24
16062,2022/12/04,8,0,1,0,9
16276,2022/12/04,5,0,1,0,6
19322,2022/12/04,10,0,2,0,12
19329,2022/12/04,8,0,1,0,9
19520,2022/12/04,9,0,0,0,9
20901,2022/12/04,4,0,0,0,4
20920,2022/12/04,16,0,0,0,16
21099,2022/12/04,8,0,0,0,8
21102,2022/12/04,15,0,1,0,16
21132,2022/12/04,12,12,13,0,25
21171,2022/12/04,8,4,5,0,13
21174,2022/12/04,8,12,7,0,15
21175,2022/12/04,13,8,9,0,22
21176,2022/12/04,5,8,7,1,12
75,2022/12/05,43,40,40,0,83
76,2022/12/05,37,40,40,0,77
99,2022/12/05,11,0,0,0,11
117,2022/12/05,7,4,0,0,7
118,2022/12/05,9,4,2,0,11
119,2022/12/05,-2,0,0,0,-2
120,2022/12/05,8,0,1,3,9
184,2022/12/05,9,9,4,0,13
195,2022/12/05,8,33,32,0,40
218,2022/12/05,57,30,33,0,90
296,2022/12/05,5,4,6,0,11
300,2022/12/05,14,0,5,0,19
304,2022/12/05,7,4,1,0,8
317,2022/12/05,7,0,1,0,8
343,2022/12/05,7,4,2,0,9
353,2022/12/05,9,0,0,0,9
373,2022/12/05,3,0,3,1,6
374,2022/12/05,10,0,4,0,14
388,2022/12/05,29,27,23,0,52
419,2022/12/05,8,6,8,0,16
420,2022/12/05,10,0,3,0,13
462,2022/12/05,17,16,7,0,24
519,2022/12/05,11,6,4,0,15
525,2022/12/05,3,0,0,0,3
596,2022/12/05,13,0,5,0,18
597,2022/12/05,25,12,6,0,31
598,2022/12/05,10,0,1,0,11
1035,2022/12/05,7,6,1,0,8
1084,2022/12/05,12,10,8,0,20
1111,2022/12/05,10,0,0,0,10
1112,2022/12/05,10,0,0,0,10
1113,2022/12/05,7,0,0,0,7
1114,2022/12/05,8,6,3,0,11
1115,2022/12/05,11,6,3,0,14
1117,2022/12/05,7,8,2,0,9
1118,2022/12/05,12,0,0,0,12
1119,2022/12/05,11,6,0,0,11
1692,2022/12/05,10,6,3,0,13
1693,2022/12/05,5,0,1,0,6
1747,2022/12/05,43,20,17,0,60
1773,2022/12/05,12,6,3,0,15
1774,2022/12/05,7,0,0,0,7
1782,2022/12/05,19,21,18,0,37
1795,2022/12/05,22,21,11,0,33
1914,2022/12/05,6,0,0,0,6
1915,2022/12/05,9,0,0,0,9
1923,2022/12/05,6,0,0,0,6
1934,2022/12/05,5,0,4,0,9
1963,2022/12/05,13,6,6,0,19
1984,2022/12/05,5,0,1,0,6
2135,2022/12/05,10,0,0,0,10
2136,2022/12/05,7,0,1,0,8
2148,2022/12/05,6,0,0,0,6
2183,2022/12/05,7,6,1,0,8
2193,2022/12/05,19,21,16,0,35
2237,2022/12/05,13,6,4,0,17
2358,2022/12/05,16,0,3,0,19
2361,2022/12/05,21,7,6,0,27
2445,2022/12/05,3,0,2,0,5
2449,2022/12/05,10,6,1,0,11
2451,2022/12/05,45,0,11,0,56
2475,2022/12/05,9,0,1,0,10
2476,2022/12/05,9,0,2,0,11
2507,2022/12/05,15,12,12,0,27
2525,2022/12/05,11,0,3,0,14
2562,2022/12/05,11,6,4,0,15
2582,2022/12/05,13,0,0,0,13
2586,2022/12/05,29,28,16,3,45
2602,2022/12/05,7,0,0,0,7
2631,2022/12/05,1,0,0,0,1
2685,2022/12/05,17,8,9,1,26
2723,2022/12/05,11,8,1,0,12
2730,2022/12/05,9,0,1,0,10
2731,2022/12/05,8,6,2,0,10
2732,2022/12/05,12,8,1,0,13
2734,2022/12/05,15,0,1,0,16
2735,2022/12/05,16,4,1,0,17
2761,2022/12/05,25,15,21,0,46
2788,2022/12/05,15,20,16,0,31
2802,2022/12/05,9,0,0,0,9
2812,2022/12/05,8,0,1,0,9
2813,2022/12/05,6,0,2,0,8
2814,2022/12/05,13,6,2,0,15
2913,2022/12/05,5,0,0,0,5
2914,2022/12/05,9,0,0,0,9
3015,2022/12/05,12,8,2,0,14
3033,2022/12/05,4,0,1,0,5
3035,2022/12/05,7,0,0,0,7
4446,2022/12/05,28,12,13,0,41
12136,2022/12/05,29,30,33,0,62
12516,2022/12/05,6,0,1,0,7
12518,2022/12/05,5,0,3,0,8
12523,2022/12/05,10,0,3,0,13
16062,2022/12/05,7,0,1,0,8
16276,2022/12/05,4,0,0,0,4
19322,2022/12/05,8,0,0,0,8
19329,2022/12/05,7,0,0,0,7
19520,2022/12/05,9,0,2,0,11
20901,2022/12/05,4,0,4,0,8
20920,2022/12/05,16,0,2,0,18
21099,2022/12/05,8,0,0,0,8
21102,2022/12/05,14,0,2,0,16
21132,2022/12/05,17,18,18,0,35
21171,2022/12/05,7,4,4,0,11
21174,2022/12/05,13,12,11,0,24
21175,2022/12/05,16,12,11,0,27
21176,2022/12/05,5,8,4,1,9
75,2022/12/06,38,36,42,0,80
76,2022/12/06,32,40,39,0,71
99,2022/12/06,11,0,0,0,11
117,2022/12/06,7,0,2,0,9
118,2022/12/06,7,0,4,0,11
119,2022/12/06,2,4,4,0,6
120,2022/12/06,4,0,0,0,4
184,2022/12/06,13,12,13,0,26
195,2022/12/06,27,27,27,0,54
218,2022/12/06,18,24,18,0,36
296,2022/12/06,7,8,6,0,13
300,2022/12/06,9,0,6,0,15
304,2022/12/06,14,8,3,0,17
317,2022/12/06,12,6,4,0,16
343,2022/12/06,5,0,5,0,10
353,2022/12/06,9,0,0,0,9
373,2022/12/06,-1,0,2,0,1
374,2022/12/06,10,4,6,0,16
388,2022/12/06,27,27,29,1,56
419,2022/12/06,6,6,8,2,14
420,2022/12/06,7,0,1,0,8
462,2022/12/06,18,8,10,0,28
519,2022/12/06,13,6,6,0,19
525,2022/12/06,3,0,1,0,4
596,2022/12/06,8,0,8,0,16
597,2022/12/06,13,0,12,0,25
598,2022/12/06,9,0,4,0,13
1035,2022/12/06,12,6,4,0,16
1084,2022/12/06,17,15,18,0,35
1111,2022/12/06,10,0,2,0,12
1112,2022/12/06,10,0,1,0,11
1113,2022/12/06,7,0,0,0,7
1114,2022/12/06,17,12,3,0,20
1115,2022/12/06,14,6,1,0,15
1117,2022/12/06,5,0,1,0,6
1118,2022/12/06,12,0,0,0,12
1119,2022/12/06,11,0,0,0,11
1692,2022/12/06,13,6,9,0,22
1693,2022/12/06,4,0,0,0,4
1747,2022/12/06,17,20,20,0,37
1773,2022/12/06,9,0,1,0,10
1774,2022/12/06,7,0,0,0,7
1782,2022/12/06,40,21,20,0,60
1795,2022/12/06,21,14,22,0,43
1914,2022/12/06,6,0,0,0,6
1915,2022/12/06,9,0,0,0,9
1923,2022/12/06,6,0,0,0,6
1934,2022/12/06,1,0,1,0,2
1963,2022/12/06,13,6,6,0,19
1984,2022/12/06,10,6,1,0,11
2135,2022/12/06,16,6,1,0,17
2136,2022/12/06,6,0,1,0,7
2148,2022/12/06,6,0,0,0,6
2183,2022/12/06,6,0,4,0,10
2193,2022/12/06,23,24,23,0,46
2237,2022/12/06,15,6,3,0,18
2358,2022/12/06,17,4,4,0,21
2361,2022/12/06,22,7,6,0,28
2445,2022/12/06,7,6,6,0,13
2449,2022/12/06,9,0,5,0,14
2451,2022/12/06,29,0,12,0,41
2475,2022/12/06,8,0,0,0,8
2476,2022/12/06,7,0,0,0,7
2507,2022/12/06,14,12,7,0,21
2525,2022/12/06,8,0,1,0,9
2562,2022/12/06,7,0,1,4,8
2582,2022/12/06,13,0,3,0,16
2586,2022/12/06,41,20,22,0,63
2602,2022/12/06,7,0,1,0,8
2631,2022/12/06,7,6,2,0,9
2685,2022/12/06,14,8,7,1,21
2723,2022/12/06,10,0,1,0,11
2730,2022/12/06,14,6,4,0,18
2731,2022/12/06,12,6,1,0,13
2732,2022/12/06,11,0,0,0,11
2734,2022/12/06,14,0,3,0,17
2735,2022/12/06,19,4,6,0,25
2761,2022/12/06,23,20,20,1,43
2788,2022/12/06,19,20,21,0,40
2802,2022/12/06,9,0,1,0,10
2812,2022/12/06,7,0,0,0,7
2813,2022/12/06,4,0,0,0,4
2814,2022/12/06,11,0,0,0,11
2913,2022/12/06,5,0,0,0,5
2914,2022/12/06,9,0,0,0,9
3015,2022/12/06,18,8,3,0,21
3033,2022/12/06,3,0,1,0,4
3035,2022/12/06,13,6,0,0,13
4446,2022/12/06,14,12,16,0,30
12136,2022/12/06,23,27,27,0,50
12516,2022/12/06,9,4,4,0,13
12518,2022/12/06,6,4,4,0,10
12523,2022/12/06,11,4,4,0,15
16062,2022/12/06,12,6,0,0,12
16276,2022/12/06,4,0,2,0,6
19329,2022/12/06,13,6,1,0,14
19520,2022/12/06,7,0,3,0,10
20901,2022/12/06,0,0,0,0,0
20920,2022/12/06,14,0,0,0,14
21099,2022/12/06,8,0,0,0,8
21102,2022/12/06,12,0,0,0,12
21132,2022/12/06,17,18,21,0,38
21171,2022/12/06,8,4,3,0,11
21174,2022/12/06,13,12,13,0,26
21175,2022/12/06,8,8,8,0,16
21176,2022/12/06,12,8,6,0,18
75,2022/12/07,32,36,35,0,67
76,2022/12/07,37,44,50,0,87
99,2022/12/07,11,0,0,0,11
117,2022/12/07,5,0,3,0,8
118,2022/12/07,7,4,1,0,8
119,2022/12/07,2,4,0,0,2
120,2022/12/07,4,0,0,0,4
184,2022/12/07,12,12,9,0,21
195,2022/12/07,30,30,35,0,65
218,2022/12/07,21,21,27,0,48
296,2022/12/07,5,4,8,0,13
300,2022/12/07,7,4,1,0,8
304,2022/12/07,15,4,5,0,20
317,2022/12/07,20,12,14,0,34
343,2022/12/07,0,0,0,0,0
353,2022/12/07,9,0,1,0,10
373,2022/12/07,3,6,9,0,12
374,2022/12/07,4,0,0,0,4
388,2022/12/07,24,27,28,0,52
419,2022/12/07,2,6,6,0,8
420,2022/12/07,6,0,0,0,6
462,2022/12/07,24,16,2,0,26
519,2022/12/07,13,6,3,0,16
525,2022/12/07,7,5,0,0,7
596,2022/12/07,8,8,8,0,16
597,2022/12/07,25,24,18,0,43
598,2022/12/07,11,6,1,0,12
1035,2022/12/07,14,6,5,0,19
1084,2022/12/07,9,10,9,0,18
1111,2022/12/07,14,6,1,0,15
1112,2022/12/07,9,0,0,0,9
1113,2022/12/07,13,6,1,0,14
1114,2022/12/07,20,6,6,0,26
1115,2022/12/07,13,0,2,0,15
1117,2022/12/07,12,8,0,0,12
1118,2022/12/07,12,0,1,0,13
1119,2022/12/07,11,0,2,0,13
1692,2022/12/07,4,0,2,0,6
1693,2022/12/07,10,6,4,0,14
1747,2022/12/07,17,20,15,0,32
1773,2022/12/07,8,0,0,0,8
1774,2022/12/07,7,0,0,0,7
1782,2022/12/07,41,21,16,0,57
1795,2022/12/07,20,21,22,0,42
1914,2022/12/07,12,6,1,0,13
1915,2022/12/07,9,0,0,0,9
1923,2022/12/07,6,0,0,0,6
1934,2022/12/07,5,5,3,0,8
1963,2022/12/07,7,0,4,3,11
1984,2022/12/07,15,6,3,0,18
2135,2022/12/07,15,0,1,0,16
2136,2022/12/07,5,0,0,0,5
2148,2022/12/07,10,4,2,0,12
2183,2022/12/07,8,6,1,1,9
2193,2022/12/07,15,15,14,0,29
2237,2022/12/07,12,0,2,0,14
2358,2022/12/07,13,0,5,0,18
2361,2022/12/07,16,0,4,0,20
2445,2022/12/07,7,6,5,0,12
2449,2022/12/07,4,0,2,0,6
2451,2022/12/07,17,0,9,0,26
2475,2022/12/07,8,0,1,0,9
2476,2022/12/07,7,0,0,0,7
2507,2022/12/07,19,12,11,0,30
2525,2022/12/07,7,0,1,0,8
2562,2022/12/07,2,0,2,0,4
2582,2022/12/07,10,0,1,0,11
2586,2022/12/07,39,20,28,0,67
2602,2022/12/07,6,0,1,0,7
2631,2022/12/07,5,0,3,0,8
2685,2022/12/07,14,8,11,0,25
2723,2022/12/07,9,0,1,0,10
2730,2022/12/07,10,0,3,0,13
2731,2022/12/07,11,0,2,0,13
2732,2022/12/07,11,0,1,0,12
2734,2022/12/07,11,0,0,0,11
2735,2022/12/07,13,0,4,0,17
2761,2022/12/07,22,20,22,0,44
2788,2022/12/07,14,16,15,0,29
2802,2022/12/07,8,0,0,0,8
2812,2022/12/07,13,6,0,0,13
2813,2022/12/07,10,6,2,0,12
2814,2022/12/07,11,0,0,0,11
2913,2022/12/07,11,6,4,0,15
2914,2022/12/07,9,0,1,0,10
3015,2022/12/07,15,0,1,0,16
3033,2022/12/07,8,6,2,0,10
3035,2022/12/07,13,0,1,0,14
4446,2022/12/07,7,9,9,0,16
12136,2022/12/07,23,27,26,0,49
12516,2022/12/07,5,0,3,0,8
12518,2022/12/07,6,4,4,0,10
12523,2022/12/07,11,4,4,0,15
16062,2022/12/07,12,0,0,0,12
16276,2022/12/07,6,4,0,0,6
19329,2022/12/07,12,0,3,0,15
19520,2022/12/07,4,0,1,0,5
20901,2022/12/07,0,0,0,0,0
20920,2022/12/07,14,0,0,0,14
21099,2022/12/07,8,0,0,0,8
21102,2022/12/07,12,0,0,0,12
21132,2022/12/07,17,21,23,0,40
21171,2022/12/07,5,0,0,1,5
21174,2022/12/07,12,12,11,0,23
21175,2022/12/07,8,8,7,0,15
21176,2022/12/07,14,8,12,0,26
75,2022/12/08,33,36,39,0,72
76,2022/12/08,35,48,44,0,79
99,2022/12/08,11,0,0,0,11
117,2022/12/08,6,4,0,0,6
118,2022/12/08,6,0,3,0,9
119,2022/12/08,6,4,4,0,10
120,2022/12/08,8,4,3,0,11
184,2022/12/08,18,15,13,0,31
195,2022/12/08,31,36,32,2,63
218,2022/12/08,3,9,6,0,9
296,2022/12/08,1,4,5,0,6
300,2022/12/08,6,0,3,0,9
304,2022/12/08,14,4,4,0,18
317,2022/12/08,6,0,4,0,10
343,2022/12/08,4,4,2,0,6
353,2022/12/08,8,0,0,0,8
373,2022/12/08,0,6,1,1,1
374,2022/12/08,8,4,6,0,14
388,2022/12/08,26,30,29,0,55
419,2022/12/08,-4,0,1,0,-3
420,2022/12/08,12,6,0,0,12
462,2022/12/08,30,8,5,0,35
519,2022/12/08,22,12,10,0,32
525,2022/12/08,7,0,0,0,7
596,2022/12/08,4,4,5,0,9
597,2022/12/08,19,12,19,0,38
598,2022/12/08,10,0,2,0,12
1035,2022/12/08,9,0,6,0,15
1084,2022/12/08,15,15,15,0,30
1111,2022/12/08,13,0,1,0,14
1112,2022/12/08,9,0,1,0,10
1113,2022/12/08,12,0,0,0,12
1114,2022/12/08,20,6,8,0,28
1115,2022/12/08,11,0,4,0,15
1117,2022/12/08,12,0,0,0,12
1118,2022/12/08,11,0,1,0,12
1119,2022/12/08,9,0,2,0,11
1692,2022/12/08,2,0,0,0,2
1693,2022/12/08,6,0,2,0,8
1747,2022/12/08,17,15,20,0,37
1773,2022/12/08,8,0,3,0,11
1774,2022/12/08,7,0,0,0,7
1782,2022/12/08,52,27,36,0,88
1795,2022/12/08,19,21,21,0,40
1914,2022/12/08,11,0,2,0,13
1915,2022/12/08,9,0,0,0,9
1923,2022/12/08,6,0,1,0,7
1934,2022/12/08,7,5,4,0,11
1963,2022/12/08,6,6,6,0,12
1984,2022/12/08,12,0,2,0,14
2135,2022/12/08,20,6,3,0,23
2136,2022/12/08,5,0,2,0,7
2148,2022/12/08,12,4,2,0,14
2183,2022/12/08,6,0,2,0,8
2193,2022/12/08,22,21,22,0,44
2237,2022/12/08,10,0,3,0,13
2358,2022/12/08,8,0,3,0,11
2361,2022/12/08,19,7,10,1,29
2445,2022/12/08,8,6,2,0,10
2449,2022/12/08,8,6,0,0,8
2451,2022/12/08,23,15,14,0,37
2475,2022/12/08,7,0,0,0,7
2476,2022/12/08,7,0,2,0,9
2507,2022/12/08,20,12,16,0,36
2525,2022/12/08,6,0,1,0,7
2562,2022/12/08,6,6,0,0,6
2582,2022/12/08,9,0,1,0,10
2586,2022/12/08,31,20,24,0,55
2602,2022/12/08,5,0,3,0,8
2631,2022/12/08,8,6,1,0,9
2685,2022/12/08,11,8,13,0,24
2723,2022/12/08,8,0,5,0,13
2730,2022/12/08,7,0,1,0,8
2731,2022/12/08,9,0,1,0,10
2732,2022/12/08,10,0,4,0,14
2734,2022/12/08,15,4,1,0,16
2735,2022/12/08,9,0,4,0,13
2761,2022/12/08,20,20,19,0,39
2788,2022/12/08,27,28,28,0,55
2802,2022/12/08,8,0,1,0,9
2812,2022/12/08,13,0,0,0,13
2813,2022/12/08,8,0,0,0,8
2814,2022/12/08,11,0,1,0,12
2913,2022/12/08,7,0,2,0,9
2914,2022/12/08,8,0,2,0,10
3015,2022/12/08,14,0,9,0,23
3033,2022/12/08,6,0,0,0,6
3035,2022/12/08,12,0,4,0,16
4446,2022/12/08,10,12,11,0,21
12136,2022/12/08,27,30,32,1,59
12516,2022/12/08,6,4,3,0,9
12518,2022/12/08,6,4,2,0,8
12523,2022/12/08,11,4,4,0,15
16062,2022/12/08,12,0,4,0,16
16276,2022/12/08,6,0,2,0,8
19322,2022/12/08,8,0,0,0,8
19329,2022/12/08,9,0,2,0,11
19520,2022/12/08,3,0,1,0,4
20901,2022/12/08,6,6,2,0,8
20920,2022/12/08,14,0,1,0,15
21099,2022/12/08,8,0,1,0,9
21102,2022/12/08,12,0,0,0,12
21132,2022/12/08,15,21,14,0,29
21171,2022/12/08,12,8,3,1,15
21174,2022/12/08,13,12,12,0,25
21175,2022/12/08,9,8,9,0,18
21176,2022/12/08,14,12,10,1,24
75,2022/12/09,42,48,52,1,94
76,2022/12/09,31,40,45,0,76
99,2022/12/09,11,0,1,0,12
117,2022/12/09,6,0,0,0,6
118,2022/12/09,7,4,6,1,13
119,2022/12/09,6,4,2,0,8
120,2022/12/09,5,0,1,0,6
184,2022/12/09,20,15,18,0,38
195,2022/12/09,27,30,37,0,64
218,2022/12/09,27,30,41,0,68
296,2022/12/09,0,4,4,0,4
300,2022/12/09,7,4,2,0,9
304,2022/12/09,10,0,7,0,17
317,2022/12/09,2,0,2,0,4
343,2022/12/09,2,0,2,0,4
353,2022/12/09,8,0,0,0,8
373,2022/12/09,-2,0,1,0,-1
374,2022/12/09,6,4,4,0,10
388,2022/12/09,24,27,24,0,48
419,2022/12/09,1,6,3,0,4
420,2022/12/09,12,0,1,0,13
462,2022/12/09,33,8,4,0,37
519,2022/12/09,24,12,12,0,36
525,2022/12/09,7,0,1,1,8
596,2022/12/09,15,16,6,0,21
597,2022/12/09,30,30,13,0,43
598,2022/12/09,14,6,4,0,18
1035,2022/12/09,9,6,3,0,12
1084,2022/12/09,25,25,18,0,43
1111,2022/12/09,12,0,6,0,18
1112,2022/12/09,8,0,1,0,9
1113,2022/12/09,12,0,0,0,12
1114,2022/12/09,12,0,3,0,15
1115,2022/12/09,7,0,6,0,13
1117,2022/12/09,12,0,2,0,14
1118,2022/12/09,10,0,2,0,12
1119,2022/12/09,7,0,2,0,9
1692,2022/12/09,8,6,4,0,12
1693,2022/12/09,4,0,0,0,4
1747,2022/12/09,12,15,21,0,33
1773,2022/12/09,11,6,3,0,14
1774,2022/12/09,7,0,0,0,7
1782,2022/12/09,43,27,22,0,65
1795,2022/12/09,19,21,12,0,31
1914,2022/12/09,9,0,1,0,10
1915,2022/12/09,9,0,0,0,9
1923,2022/12/09,5,0,0,0,5
1934,2022/12/09,8,5,3,0,11
1963,2022/12/09,12,12,3,0,15
1984,2022/12/09,16,6,3,0,19
2135,2022/12/09,17,0,2,0,19
2136,2022/12/09,3,0,0,0,3
2148,2022/12/09,10,0,5,0,15
2183,2022/12/09,10,6,5,0,15
2193,2022/12/09,24,24,25,1,49
2237,2022/12/09,7,0,4,0,11
2358,2022/12/09,5,0,1,1,6
2361,2022/12/09,8,0,7,0,15
2445,2022/12/09,12,6,8,0,20
2449,2022/12/09,8,0,2,0,10
2451,2022/12/09,19,10,8,0,27
2475,2022/12/09,7,0,1,0,8
2476,2022/12/09,11,6,0,0,11
2507,2022/12/09,22,18,19,0,41
2525,2022/12/09,11,6,0,0,11
2562,2022/12/09,6,0,1,0,7
2582,2022/12/09,8,0,5,0,13
2586,2022/12/09,23,16,35,0,58
2602,2022/12/09,2,0,0,0,2
2631,2022/12/09,7,0,6,0,13
2685,2022/12/09,6,8,3,0,9
2723,2022/12/09,3,0,0,0,3
2730,2022/12/09,12,6,4,0,16
2731,2022/12/09,8,0,1,0,9
2732,2022/12/09,6,0,3,0,9
2734,2022/12/09,14,0,0,0,14
2735,2022/12/09,5,0,4,0,9
2761,2022/12/09,21,20,23,0,44
2788,2022/12/09,23,24,26,0,49
2802,2022/12/09,7,0,1,0,8
2812,2022/12/09,13,0,1,0,14
2813,2022/12/09,8,0,1,0,9
2814,2022/12/09,10,0,1,0,11
2913,2022/12/09,5,0,0,0,5
2914,2022/12/09,6,0,0,0,6
3015,2022/12/09,5,0,1,0,6
3033,2022/12/09,6,0,1,0,7
3035,2022/12/09,8,0,0,0,8
4446,2022/12/09,8,9,10,0,18
12136,2022/12/09,24,30,42,0,66
12516,2022/12/09,3,0,2,0,5
12518,2022/12/09,8,4,2,0,10
12523,2022/12/09,11,4,3,0,14
16062,2022/12/09,8,0,0,0,8
16276,2022/12/09,4,0,2,0,6
19322,2022/12/09,8,0,0,0,8
19329,2022/12/09,7,0,1,0,8
19520,2022/12/09,10,8,0,0,10
20901,2022/12/09,4,0,0,0,4
20920,2022/12/09,13,0,0,0,13
21099,2022/12/09,7,0,0,0,7
21102,2022/12/09,12,0,1,0,13
21132,2022/12/09,25,24,24,0,49
21171,2022/12/09,12,4,4,0,16
21174,2022/12/09,13,12,12,0,25
21175,2022/12/09,8,8,10,0,18
21176,2022/12/09,11,8,5,0,16
75,2022/12/10,33,44,38,0,71
76,2022/12/10,26,40,36,0,62
99,2022/12/10,10,0,0,0,10
117,2022/12/10,6,0,2,1,8
118,2022/12/10,4,4,3,0,7
119,2022/12/10,8,4,1,0,9
120,2022/12/10,4,0,0,0,4
184,2022/12/10,14,12,14,0,28
195,2022/12/10,14,24,16,0,30
218,2022/12/10,10,24,9,0,19
296,2022/12/10,0,4,3,0,3
300,2022/12/10,9,4,4,0,13
304,2022/12/10,7,4,5,0,12
317,2022/12/10,0,0,0,0,0
343,2022/12/10,4,4,1,0,5
353,2022/12/10,8,0,0,0,8
373,2022/12/10,-3,0,4,1,1
374,2022/12/10,6,4,4,0,10
388,2022/12/10,24,24,32,0,56
419,2022/12/10,4,6,3,0,7
420,2022/12/10,11,0,3,0,14
462,2022/12/10,37,8,5,1,42
519,2022/12/10,18,6,3,1,21
525,2022/12/10,10,5,3,0,13
596,2022/12/10,9,0,7,0,16
597,2022/12/10,17,0,23,0,40
598,2022/12/10,10,0,5,3,15
1035,2022/12/10,12,6,3,0,15
1084,2022/12/10,7,0,7,0,14
1111,2022/12/10,6,0,0,0,6
1112,2022/12/10,7,0,0,0,7
1113,2022/12/10,12,0,1,0,13
1114,2022/12/10,9,0,0,0,9
1115,2022/12/10,7,6,3,0,10
1117,2022/12/10,10,0,0,0,10
1118,2022/12/10,14,6,1,0,15
1119,2022/12/10,5,0,0,0,5
1692,2022/12/10,4,0,1,0,5
1693,2022/12/10,4,0,0,0,4
1747,2022/12/10,11,20,19,0,30
1773,2022/12/10,8,0,2,0,10
1774,2022/12/10,7,0,1,0,8
1782,2022/12/10,42,21,17,0,59
1795,2022/12/10,28,21,12,0,40
1914,2022/12/10,8,0,0,0,8
1915,2022/12/10,9,0,0,0,9
1923,2022/12/10,11,6,3,0,14
1934,2022/12/10,10,5,2,0,12
1963,2022/12/10,9,0,6,0,15
1984,2022/12/10,13,0,3,0,16
2135,2022/12/10,15,0,1,0,16
2136,2022/12/10,9,6,0,0,9
2148,2022/12/10,5,0,1,0,6
2183,2022/12/10,11,6,2,0,13
2193,2022/12/10,16,18,22,0,38
2237,2022/12/10,9,6,3,0,12
2358,2022/12/10,7,4,4,0,11
2361,2022/12/10,8,7,2,0,10
2445,2022/12/10,10,6,8,0,18
2449,2022/12/10,12,6,3,0,15
2451,2022/12/10,21,10,11,0,32
2475,2022/12/10,6,0,2,0,8
2476,2022/12/10,11,0,1,0,12
2507,2022/12/10,15,12,13,0,28
2525,2022/12/10,11,0,1,0,12
2562,2022/12/10,11,6,3,0,14
2582,2022/12/10,3,0,1,0,4
2586,2022/12/10,4,16,9,0,13
2602,2022/12/10,10,8,1,0,11
2631,2022/12/10,7,6,2,0,9
2685,2022/12/10,11,8,10,0,21
2723,2022/12/10,3,0,1,0,4
2730,2022/12/10,8,0,3,0,11
2731,2022/12/10,13,6,6,0,19
2732,2022/12/10,3,0,1,0,4
2734,2022/12/10,14,0,2,0,16
2735,2022/12/10,5,4,3,1,8
2761,2022/12/10,18,20,20,0,38
2788,2022/12/10,21,24,28,0,49
2802,2022/12/10,6,0,0,0,6
2812,2022/12/10,12,0,2,0,14
2813,2022/12/10,7,0,2,0,9
2814,2022/12/10,9,0,3,0,12
2913,2022/12/10,5,0,0,0,5
2914,2022/12/10,6,0,0,0,6
3015,2022/12/10,4,0,1,0,5
3033,2022/12/10,11,6,2,0,13
3035,2022/12/10,8,0,0,0,8
4446,2022/12/10,13,15,17,0,30
12136,2022/12/10,6,24,19,0,25
12516,2022/12/10,5,4,3,0,8
12518,2022/12/10,10,4,3,0,13
12523,2022/12/10,8,0,4,0,12
16062,2022/12/10,8,0,2,0,10
16276,2022/12/10,2,0,0,0,2
19322,2022/12/10,8,0,0,0,8
19329,2022/12/10,6,0,1,0,7
19520,2022/12/10,10,0,3,0,13
20901,2022/12/10,10,6,2,0,12
20920,2022/12/10,13,0,0,0,13
21099,2022/12/10,7,0,0,0,7
21102,2022/12/10,11,0,1,0,12
21132,2022/12/10,22,21,22,0,44
21171,2022/12/10,8,0,3,1,11
21174,2022/12/10,17,16,21,0,38
21175,2022/12/10,6,8,7,0,13
21176,2022/12/10,14,8,8,0,22
75,2022/12/11,29,32,35,0,64
76,2022/12/11,36,44,43,0,79
99,2022/12/11,10,0,3,0,13
117,2022/12/11,7,4,0,0,7
118,2022/12/11,1,0,1,0,2
119,2022/12/11,7,0,4,0,11
120,2022/12/11,4,0,0,0,4
184,2022/12/11,18,18,14,0,32
195,2022/12/11,25,27,31,0,56
218,2022/12/11,26,24,28,0,54
296,2022/12/11,5,8,7,0,12
300,2022/12/11,9,4,4,0,13
304,2022/12/11,6,4,4,0,10
317,2022/12/11,12,12,5,0,17
343,2022/12/11,3,0,3,0,6
353,2022/12/11,8,0,0,0,8
373,2022/12/11,-2,6,2,0,0
374,2022/12/11,6,4,6,0,12
388,2022/12/11,20,24,21,0,41
419,2022/12/11,7,6,5,0,12
420,2022/12/11,8,0,1,0,9
462,2022/12/11,31,0,8,0,39
519,2022/12/11,20,6,5,0,25
525,2022/12/11,7,0,2,0,9
596,2022/12/11,10,8,7,0,17
597,2022/12/11,12,18,8,0,20
598,2022/12/11,2,0,2,0,4
1035,2022/12/11,15,6,4,0,19
1084,2022/12/11,15,15,5,0,20
1111,2022/12/11,6,0,0,0,6
1112,2022/12/11,7,0,1,0,8
1113,2022/12/11,11,0,2,0,13
1114,2022/12/11,15,6,10,0,25
1115,2022/12/11,10,6,5,0,15
1117,2022/12/11,10,0,2,0,12
1118,2022/12/11,13,0,4,0,17
1119,2022/12/11,5,0,2,0,7
1692,2022/12/11,9,6,6,0,15
1693,2022/12/11,10,6,3,0,13
1747,2022/12/11,18,20,14,0,32
1773,2022/12/11,6,0,1,0,7
1774,2022/12/11,6,0,3,0,9
1782,2022/12/11,17,15,15,0,32
1795,2022/12/11,16,0,13,0,29
1914,2022/12/11,8,0,2,0,10
1915,2022/12/11,9,0,2,0,11
1923,2022/12/11,8,0,2,0,10
1934,2022/12/11,13,5,3,1,16
1963,2022/12/11,15,12,11,0,26
1984,2022/12/11,16,6,2,0,18
2135,2022/12/11,14,0,1,0,15
2136,2022/12/11,9,0,2,0,11
2148,2022/12/11,8,4,2,0,10
2183,2022/12/11,15,6,4,0,19
2193,2022/12/11,13,18,16,0,29
2237,2022/12/11,12,6,2,0,14
2358,2022/12/11,15,12,5,0,20
2361,2022/12/11,13,7,6,0,19
2445,2022/12/11,8,6,1,0,9
2449,2022/12/11,15,6,2,0,17
2451,2022/12/11,45,35,20,4,65
2475,2022/12/11,4,0,2,0,6
2476,2022/12/11,10,0,1,0,11
2507,2022/12/11,20,18,9,0,29
2525,2022/12/11,10,0,3,0,13
2562,2022/12/11,8,0,0,0,8
2582,2022/12/11,2,0,0,0,2
2586,2022/12/11,14,16,14,0,28
2602,2022/12/11,9,0,2,0,11
2631,2022/12/11,11,6,3,0,14
2685,2022/12/11,14,12,8,0,22
2723,2022/12/11,10,8,1,0,11
2730,2022/12/11,5,0,1,0,6
2731,2022/12/11,7,0,1,0,8
2732,2022/12/11,10,8,1,0,11
2734,2022/12/11,16,4,1,0,17
2735,2022/12/11,5,4,4,0,9
2761,2022/12/11,19,20,19,0,38
2788,2022/12/11,18,24,26,0,44
2802,2022/12/11,6,0,1,0,7
2812,2022/12/11,10,0,0,0,10
2813,2022/12/11,5,0,1,0,6
2814,2022/12/11,6,0,6,0,12
2913,2022/12/11,11,6,2,0,13
2914,2022/12/11,12,6,1,0,13
3015,2022/12/11,11,8,3,0,14
3033,2022/12/11,10,0,0,0,10
3035,2022/12/11,8,0,1,0,9
4446,2022/12/11,11,12,9,0,20
12136,2022/12/11,13,24,20,0,33
12516,2022/12/11,6,4,0,0,6
12518,2022/12/11,11,4,4,0,15
12523,2022/12/11,16,12,5,0,21
16062,2022/12/11,6,0,1,0,7
16276,2022/12/11,6,4,2,0,8
19322,2022/12/11,8,0,0,0,8
19329,2022/12/11,11,6,1,0,12
19520,2022/12/11,7,0,0,0,7
20901,2022/12/11,8,0,2,0,10
20920,2022/12/11,13,0,1,0,14
21099,2022/12/11,7,0,0,0,7
21102,2022/12/11,10,0,1,0,11
21132,2022/12/11,20,21,16,0,36
21171,2022/12/11,8,4,4,0,12
21174,2022/12/11,11,12,8,0,19
21175,2022/12/11,11,8,7,0,18
21176,2022/12/11,14,8,1,0,15
75,2022/12/12,34,40,43,0,77
76,2022/12/12,37,44,47,0,84
99,2022/12/12,7,0,1,0,8
117,2022/12/12,7,0,0,0,7
118,2022/12/12,4,4,1,0,5
119,2022/12/12,7,4,1,1,8
120,2022/12/12,8,4,1,0,9
149,2022/12/12,11,0,2,0,13
184,2022/12/12,16,12,10,0,26
195,2022/12/12,27,33,31,0,58
218,2022/12/12,22,24,28,0,50
296,2022/12/12,6,8,8,0,14
300,2022/12/12,13,8,1,0,14
304,2022/12/12,6,4,1,0,7
317,2022/12/12,13,6,6,0,19
343,2022/12/12,4,4,0,0,4
353,2022/12/12,8,0,0,0,8
373,2022/12/12,2,6,9,2,11
374,2022/12/12,0,0,1,0,1
388,2022/12/12,23,24,21,0,44
419,2022/12/12,14,12,7,0,21
420,2022/12/12,7,0,1,0,8
462,2022/12/12,23,0,17,0,40
519,2022/12/12,21,6,3,0,24
525,2022/12/12,5,0,0,3,5
596,2022/12/12,11,8,5,0,16
597,2022/12/12,16,12,7,0,23
598,2022/12/12,0,0,0,0,0
1035,2022/12/12,11,0,0,0,11
1084,2022/12/12,20,10,15,0,35
1111,2022/12/12,12,6,4,0,16
1112,2022/12/12,6,0,0,0,6
1113,2022/12/12,9,0,0,0,9
1114,2022/12/12,11,6,3,0,14
1115,2022/12/12,11,6,2,0,13
1117,2022/12/12,8,0,1,0,9
1118,2022/12/12,9,0,1,0,10
1119,2022/12/12,3,0,0,0,3
1692,2022/12/12,3,0,1,0,4
1693,2022/12/12,7,0,1,0,8
1747,2022/12/12,24,20,17,0,41
1773,2022/12/12,11,6,2,0,13
1774,2022/12/12,3,0,0,0,3
1782,2022/12/12,23,21,17,0,40
1795,2022/12/12,24,21,8,0,32
1914,2022/12/12,6,0,0,0,6
1915,2022/12/12,7,0,0,0,7
1923,2022/12/12,6,0,0,0,6
1934,2022/12/12,9,0,0,0,9
1963,2022/12/12,10,6,7,0,17
1984,2022/12/12,14,0,4,0,18
2135,2022/12/12,13,0,2,0,15
2136,2022/12/12,7,0,0,0,7
2148,2022/12/12,6,0,2,0,8
2183,2022/12/12,11,0,3,0,14
2193,2022/12/12,20,24,15,0,35
2237,2022/12/12,16,6,4,0,20
2358,2022/12/12,10,0,1,0,11
2361,2022/12/12,14,7,4,0,18
2445,2022/12/12,13,6,4,0,17
2449,2022/12/12,19,6,7,0,26
2451,2022/12/12,21,0,11,0,32
2475,2022/12/12,2,0,1,0,3
2476,2022/12/12,9,0,4,0,13
2507,2022/12/12,23,12,9,0,32
2525,2022/12/12,7,0,1,0,8
2562,2022/12/12,8,0,2,0,10
2582,2022/12/12,2,0,1,0,3
2586,2022/12/12,16,16,15,0,31
2602,2022/12/12,7,0,2,0,9
2631,2022/12/12,8,0,1,0,9
2685,2022/12/12,13,8,1,0,14
2723,2022/12/12,9,0,0,0,9
2730,2022/12/12,10,6,0,0,10
2731,2022/12/12,6,0,0,0,6
2732,2022/12/12,9,0,0,0,9
2734,2022/12/12,15,0,2,0,17
2735,2022/12/12,5,4,7,0,12
2761,2022/12/12,19,20,16,0,35
2788,2022/12/12,12,20,22,0,34
2802,2022/12/12,5,0,1,0,6
2812,2022/12/12,10,0,0,0,10
2813,2022/12/12,4,0,2,0,6
2814,2022/12/12,0,0,1,0,1
2913,2022/12/12,9,0,1,0,10
2914,2022/12/12,11,0,0,0,11
3015,2022/12/12,8,0,4,0,12
3033,2022/12/12,9,0,1,0,10
3035,2022/12/12,13,6,0,0,13
4446,2022/12/12,14,12,7,0,21
12136,2022/12/12,23,30,29,0,52
12516,2022/12/12,6,0,2,0,8
12518,2022/12/12,11,4,3,0,14
12523,2022/12/12,11,0,7,0,18
16062,2022/12/12,5,0,0,0,5
16276,2022/12/12,4,0,0,0,4
19322,2022/12/12,8,0,0,0,8
19329,2022/12/12,10,0,0,0,10
19520,2022/12/12,7,0,1,0,8
20901,2022/12/12,6,0,0,0,6
20920,2022/12/12,12,0,1,0,13
21099,2022/12/12,7,0,0,0,7
21102,2022/12/12,9,0,0,0,9
21132,2022/12/12,19,15,26,0,45
21171,2022/12/12,8,4,1,2,9
21174,2022/12/12,16,12,5,0,21
21175,2022/12/12,20,16,10,0,30
21176,2022/12/12,21,8,6,3,27
75,2022/12/13,28,40,39,1,67
76,2022/12/13,34,44,43,0,77
99,2022/12/13,6,0,0,0,6
117,2022/12/13,7,0,1,2,8
118,2022/12/13,7,4,2,0,9
119,2022/12/13,9,4,3,0,12
120,2022/12/13,7,0,0,0,7
149,2022/12/13,9,0,0,0,9
184,2022/12/13,18,12,13,0,31
195,2022/12/13,27,30,28,0,55
218,2022/12/13,24,30,28,0,52
296,2022/12/13,6,8,1,0,7
300,2022/12/13,16,4,1,0,17
304,2022/12/13,9,4,0,0,9
317,2022/12/13,13,6,1,0,14
343,2022/12/13,8,4,0,0,8
353,2022/12/13,8,0,1,0,9
373,2022/12/13,-3,6,2,1,-1
374,2022/12/13,7,8,0,0,7
388,2022/12/13,32,30,31,0,63
419,2022/12/13,13,6,5,0,18
420,2022/12/13,12,6,1,0,13
462,2022/12/13,14,8,8,0,22
519,2022/12/13,24,6,6,0,30
525,2022/12/13,2,0,1,0,3
596,2022/12/13,14,8,6,0,20
597,2022/12/13,21,12,15,2,36
598,2022/12/13,6,6,3,0,9
1035,2022/12/13,17,6,0,0,17
1084,2022/12/13,25,20,20,0,45
1111,2022/12/13,8,0,0,0,8
1112,2022/12/13,6,0,0,0,6
1113,2022/12/13,9,0,1,0,10
1114,2022/12/13,14,6,1,0,15
1115,2022/12/13,9,0,2,0,11
1117,2022/12/13,7,0,0,0,7
1118,2022/12/13,8,0,5,0,13
1119,2022/12/13,9,6,0,0,9
1692,2022/12/13,8,6,2,0,10
1693,2022/12/13,6,0,0,0,6
1747,2022/12/13,32,25,32,0,64
1773,2022/12/13,9,0,0,0,9
1774,2022/12/13,11,8,0,0,11
1782,2022/12/13,21,15,20,0,41
1795,2022/12/13,37,21,8,0,45
1914,2022/12/13,6,0,1,0,7
1915,2022/12/13,7,0,0,0,7
1923,2022/12/13,6,0,1,0,7
1934,2022/12/13,9,0,3,0,12
1963,2022/12/13,9,6,6,0,15
1984,2022/12/13,10,0,0,1,10
2135,2022/12/13,11,0,0,0,11
2136,2022/12/13,7,0,2,0,9
2148,2022/12/13,8,4,2,0,10
2183,2022/12/13,8,0,1,0,9
2193,2022/12/13,27,24,31,0,58
2237,2022/12/13,12,0,4,0,16
2358,2022/12/13,13,4,3,0,16
2361,2022/12/13,17,7,9,0,26
2445,2022/12/13,15,6,4,0,19
2449,2022/12/13,12,0,1,0,13
2451,2022/12/13,10,0,4,0,14
2475,2022/12/13,7,6,0,0,7
2476,2022/12/13,5,0,2,0,7
2507,2022/12/13,20,6,11,0,31
2525,2022/12/13,6,0,0,0,6
2562,2022/12/13,12,6,2,0,14
2582,2022/12/13,5,4,1,0,6
2586,2022/12/13,21,20,26,0,47
2602,2022/12/13,5,0,0,0,5
2631,2022/12/13,13,6,3,0,16
2685,2022/12/13,20,8,8,2,28
2723,2022/12/13,9,0,0,0,9
2730,2022/12/13,10,0,1,0,11
2731,2022/12/13,12,6,2,0,14
2732,2022/12/13,9,0,2,0,11
2734,2022/12/13,13,0,2,0,15
2735,2022/12/13,2,4,3,0,5
2761,2022/12/13,23,20,10,0,33
2788,2022/12/13,11,20,17,0,28
2802,2022/12/13,4,0,0,0,4
2812,2022/12/13,10,0,0,0,10
2813,2022/12/13,8,6,0,0,8
2814,2022/12/13,5,6,1,0,6
2913,2022/12/13,8,0,3,0,11
2914,2022/12/13,11,0,0,0,11
3015,2022/12/13,4,0,1,0,5
3033,2022/12/13,8,0,0,0,8
3035,2022/12/13,13,0,0,0,13
4446,2022/12/13,16,12,16,0,32
12136,2022/12/13,18,27,26,0,44
12516,2022/12/13,8,4,0,0,8
12518,2022/12/13,12,4,1,0,13
12523,2022/12/13,12,8,2,0,14
16062,2022/12/13,5,0,1,0,6
16276,2022/12/13,8,4,0,0,8
19329,2022/12/13,10,0,0,0,10
19520,2022/12/13,14,8,0,0,14
20901,2022/12/13,6,0,0,0,6
20920,2022/12/13,11,0,0,0,11
21099,2022/12/13,7,0,1,0,8
21102,2022/12/13,9,0,0,0,9
21132,2022/12/13,11,21,18,0,29
21171,2022/12/13,5,0,3,1,8
21174,2022/12/13,22,12,19,0,41
21175,2022/12/13,18,8,13,0,31
21176,2022/12/13,20,8,6,4,26
75,2022/12/14,27,36,33,0,60
76,2022/12/14,35,44,38,0,73
99,2022/12/14,6,0,0,0,6
117,2022/12/14,8,4,1,0,9
118,2022/12/14,9,4,2,0,11
119,2022/12/14,6,0,5,0,11
120,2022/12/14,7,0,3,0,10
149,2022/12/14,9,0,0,0,9
184,2022/12/14,17,12,16,0,33
195,2022/12/14,31,33,40,0,71
218,2022/12/14,23,27,27,0,50
296,2022/12/14,13,8,6,0,19
300,2022/12/14,15,0,5,0,20
304,2022/12/14,17,8,5,0,22
317,2022/12/14,18,6,3,0,21
343,2022/12/14,8,0,1,0,9
353,2022/12/14,7,0,0,0,7
373,2022/12/14,-6,0,1,0,-5
374,2022/12/14,15,8,3,0,18
388,2022/12/14,29,27,25,0,54
419,2022/12/14,14,6,7,0,21
420,2022/12/14,11,0,1,0,12
462,2022/12/14,6,0,5,0,11
519,2022/12/14,18,0,5,0,23
525,2022/12/14,6,5,2,0,8
596,2022/12/14,16,8,8,0,24
597,2022/12/14,22,18,15,2,37
598,2022/12/14,3,0,3,0,6
1035,2022/12/14,23,6,2,4,25
1084,2022/12/14,15,10,17,0,32
1111,2022/12/14,8,0,0,0,8
1112,2022/12/14,6,0,0,0,6
1113,2022/12/14,8,0,0,0,8
1114,2022/12/14,13,0,5,0,18
1115,2022/12/14,7,0,4,0,11
1117,2022/12/14,7,0,0,0,7
1118,2022/12/14,3,0,0,0,3
1119,2022/12/14,9,0,0,0,9
1692,2022/12/14,6,0,2,0,8
1693,2022/12/14,6,0,0,0,6
1747,2022/12/14,20,20,16,0,36
1773,2022/12/14,9,0,3,0,12
1774,2022/12/14,11,0,0,0,11
1782,2022/12/14,16,15,15,0,31
1795,2022/12/14,78,49,22,1,100
1914,2022/12/14,5,0,0,0,5
1915,2022/12/14,7,0,2,0,9
1923,2022/12/14,5,0,0,0,5
1934,2022/12/14,6,0,1,6,7
1963,2022/12/14,9,6,2,0,11
1984,2022/12/14,9,0,2,0,11
2135,2022/12/14,11,0,0,0,11
2136,2022/12/14,5,0,1,0,6
2148,2022/12/14,6,0,2,0,8
2183,2022/12/14,7,0,0,0,7
2193,2022/12/14,19,21,19,0,38
2237,2022/12/14,8,0,3,0,11
2358,2022/12/14,14,4,1,0,15
2361,2022/12/14,15,7,11,0,26
2445,2022/12/14,17,6,6,0,23
2449,2022/12/14,11,0,5,0,16
2451,2022/12/14,6,0,1,0,7
2475,2022/12/14,7,0,0,0,7
2476,2022/12/14,3,0,0,0,3
2507,2022/12/14,21,12,21,0,42
2525,2022/12/14,6,0,0,0,6
2562,2022/12/14,10,0,1,0,11
2582,2022/12/14,8,4,2,0,10
2586,2022/12/14,23,28,19,0,42
2602,2022/12/14,5,0,0,0,5
2631,2022/12/14,10,0,2,0,12
2685,2022/12/14,18,8,9,0,27
2723,2022/12/14,9,0,2,0,11
2730,2022/12/14,9,0,3,0,12
2731,2022/12/14,10,0,1,0,11
2732,2022/12/14,7,0,3,0,10
2734,2022/12/14,11,0,3,0,14
2735,2022/12/14,3,4,4,0,7
2761,2022/12/14,33,20,21,0,54
2788,2022/12/14,21,28,22,0,43
2802,2022/12/14,4,0,0,0,4
2812,2022/12/14,10,0,1,0,11
2813,2022/12/14,8,0,3,0,11
2814,2022/12/14,4,0,2,0,6
2913,2022/12/14,5,0,0,0,5
2914,2022/12/14,11,0,0,0,11
3015,2022/12/14,3,0,2,0,5
3033,2022/12/14,8,0,0,0,8
3035,2022/12/14,13,0,1,0,14
4446,2022/12/14,15,12,16,0,31
12136,2022/12/14,25,30,32,0,57
12516,2022/12/14,12,4,5,0,17
12518,2022/12/14,11,0,1,0,12
12523,2022/12/14,10,0,2,0,12
16062,2022/12/14,4,0,0,0,4
16276,2022/12/14,8,0,0,0,8
19322,2022/12/14,8,0,1,0,9
19329,2022/12/14,10,0,1,0,11
19520,2022/12/14,14,0,2,0,16
20901,2022/12/14,6,0,1,0,7
20920,2022/12/14,11,0,1,0,12
21099,2022/12/14,6,0,0,0,6
21102,2022/12/14,28,0,1,0,29
21132,2022/12/14,17,21,19,0,36
21171,2022/12/14,5,4,5,0,10
21174,2022/12/14,19,16,15,0,34
21175,2022/12/14,13,8,9,2,22
21176,2022/12/14,24,12,9,0,33
75,2022/12/15,34,40,32,0,66
76,2022/12/15,41,44,41,0,82
99,2022/12/15,6,0,0,0,6
117,2022/12/15,7,0,1,0,8
118,2022/12/15,11,4,3,0,14
119,2022/12/15,1,0,0,0,1
120,2022/12/15,8,4,3,0,11
149,2022/12/15,9,0,0,0,9
184,2022/12/15,15,12,11,0,26
195,2022/12/15,28,36,28,0,56
218,2022/12/15,24,27,22,0,46
296,2022/12/15,11,4,2,0,13
300,2022/12/15,14,4,1,0,15
304,2022/12/15,16,4,6,0,22
317,2022/12/15,15,0,1,0,16
343,2022/12/15,11,4,1,0,12
353,2022/12/15,7,0,1,0,8
373,2022/12/15,-1,6,5,0,4
374,2022/12/15,16,4,5,0,21
388,2022/12/15,33,30,31,0,64
419,2022/12/15,7,0,1,0,8
420,2022/12/15,10,0,0,0,10
462,2022/12/15,9,8,5,0,14
519,2022/12/15,19,6,7,1,26
525,2022/12/15,4,0,0,0,4
596,2022/12/15,16,8,10,0,26
597,2022/12/15,23,18,29,2,52
598,2022/12/15,6,6,2,0,8
1035,2022/12/15,17,0,5,0,22
1084,2022/12/15,8,10,8,0,16
1111,2022/12/15,8,0,2,0,10
1112,2022/12/15,6,0,1,0,7
1113,2022/12/15,8,0,1,0,9
1114,2022/12/15,8,0,5,0,13
1115,2022/12/15,9,6,2,0,11
1117,2022/12/15,7,0,4,0,11
1118,2022/12/15,3,0,0,0,3
1119,2022/12/15,9,0,2,0,11
1692,2022/12/15,10,6,0,0,10
1693,2022/12/15,12,6,1,0,13
1747,2022/12/15,24,20,20,0,44
1773,2022/12/15,6,0,2,0,8
1774,2022/12/15,11,0,2,0,13
1782,2022/12/15,28,27,25,0,53
1795,2022/12/15,56,0,28,0,84
1914,2022/12/15,11,6,0,0,11
1915,2022/12/15,5,0,0,0,5
1923,2022/12/15,11,6,1,0,12
1934,2022/12/15,4,5,1,0,5
1963,2022/12/15,13,6,3,0,16
1984,2022/12/15,7,0,1,3,8
2135,2022/12/15,17,6,4,0,21
2136,2022/12/15,4,0,3,0,7
2148,2022/12/15,8,4,2,0,10
2183,2022/12/15,13,6,7,0,20
2193,2022/12/15,21,21,19,0,40
2237,2022/12/15,5,0,2,0,7
2358,2022/12/15,17,4,1,0,18
2361,2022/12/15,11,7,6,0,17
2445,2022/12/15,11,0,6,0,17
2449,2022/12/15,6,0,0,0,6
2451,2022/12/15,25,20,7,0,32
2475,2022/12/15,7,0,0,0,7
2476,2022/12/15,3,0,0,0,3
2507,2022/12/15,12,12,15,0,27
2525,2022/12/15,6,0,2,0,8
2562,2022/12/15,9,0,3,0,12
2582,2022/12/15,6,0,1,0,7
2586,2022/12/15,28,24,19,0,47
2602,2022/12/15,13,8,0,0,13
2631,2022/12/15,8,0,5,0,13
2685,2022/12/15,21,12,13,2,34
2723,2022/12/15,7,0,3,0,10
2730,2022/12/15,6,0,3,0,9
2731,2022/12/15,9,0,2,0,11
2732,2022/12/15,4,0,2,0,6
2734,2022/12/15,8,0,1,0,9
2735,2022/12/15,3,4,3,0,6
2761,2022/12/15,32,20,31,0,63
2788,2022/12/15,23,24,22,0,45
2802,2022/12/15,4,0,1,0,5
2812,2022/12/15,9,0,0,0,9
2813,2022/12/15,5,0,0,0,5
2814,2022/12/15,8,6,3,0,11
2913,2022/12/15,5,0,0,0,5
2914,2022/12/15,11,0,0,0,11
3015,2022/12/15,9,8,5,0,14
3033,2022/12/15,8,0,2,0,10
3035,2022/12/15,12,0,1,0,13
4446,2022/12/15,11,12,10,0,21
12136,2022/12/15,20,27,21,0,41
12516,2022/12/15,11,4,2,0,13
12518,2022/12/15,14,4,3,0,17
12523,2022/12/15,8,0,3,0,11
16062,2022/12/15,10,6,1,0,11
16276,2022/12/15,8,0,2,0,10
19322,2022/12/15,7,0,1,0,8
19329,2022/12/15,9,0,1,0,10
19520,2022/12/15,12,0,1,0,13
20901,2022/12/15,5,0,0,0,5
20920,2022/12/15,10,0,0,0,10
21097,2022/12/15,12,0,1,0,13
21102,2022/12/15,27,0,0,0,27
21132,2022/12/15,13,15,13,0,26
21171,2022/12/15,4,4,3,0,7
21174,2022/12/15,16,12,12,0,28
21175,2022/12/15,10,8,6,0,16
21176,2022/12/15,21,8,7,0,28
75,2022/12/16,44,40,36,0,80
76,2022/12/16,47,44,35,0,82
99,2022/12/16,6,0,0,0,6
117,2022/12/16,7,0,2,0,9
118,2022/12/16,14,4,2,0,16
119,2022/12/16,5,4,1,0,6
120,2022/12/16,9,4,3,0,12
149,2022/12/16,9,0,1,0,10
184,2022/12/16,21,18,18,0,39
195,2022/12/16,36,36,24,0,60
218,2022/12/16,31,30,23,0,54
296,2022/12/16,13,4,5,0,18
300,2022/12/16,17,4,0,0,17
304,2022/12/16,14,4,2,0,16
317,2022/12/16,20,6,1,0,21
343,2022/12/16,14,4,0,0,14
353,2022/12/16,6,0,0,0,6
373,2022/12/16,0,6,2,0,2
374,2022/12/16,15,4,2,0,17
388,2022/12/16,29,24,21,0,50
419,2022/12/16,12,6,3,0,15
420,2022/12/16,10,0,0,0,10
462,2022/12/16,22,16,8,0,30
519,2022/12/16,24,12,8,0,32
525,2022/12/16,9,5,1,0,10
596,2022/12/16,24,16,6,0,30
597,2022/12/16,32,36,17,0,49
598,2022/12/16,11,6,3,0,14
1035,2022/12/16,19,6,6,0,25
1084,2022/12/16,30,30,14,0,44
1111,2022/12/16,6,0,0,0,6
1112,2022/12/16,5,0,0,0,5
1113,2022/12/16,7,0,0,0,7
1114,2022/12/16,9,6,4,0,13
1115,2022/12/16,13,6,6,0,19
1117,2022/12/16,3,0,0,0,3
1118,2022/12/16,9,6,2,0,11
1119,2022/12/16,7,0,2,0,9
1692,2022/12/16,10,0,2,0,12
1693,2022/12/16,17,6,2,0,19
1747,2022/12/16,25,20,17,0,42
1773,2022/12/16,10,6,2,0,12
1774,2022/12/16,9,0,0,0,9
1782,2022/12/16,28,24,12,0,40
1795,2022/12/16,43,14,13,7,56
1914,2022/12/16,11,0,1,0,12
1915,2022/12/16,5,0,1,0,6
1923,2022/12/16,10,0,1,0,11
1934,2022/12/16,3,0,1,0,4
1963,2022/12/16,16,6,5,0,21
1984,2022/12/16,10,6,1,0,11
2135,2022/12/16,13,0,3,0,16
2136,2022/12/16,1,0,0,0,1
2148,2022/12/16,14,8,2,0,16
2183,2022/12/16,12,6,2,0,14
2193,2022/12/16,26,24,21,0,47
2237,2022/12/16,9,6,4,0,13
2358,2022/12/16,21,4,4,0,25
2361,2022/12/16,12,7,10,0,22
2445,2022/12/16,12,6,7,0,19
2449,2022/12/16,12,6,3,0,15
2451,2022/12/16,39,20,13,0,52
2475,2022/12/16,7,0,0,0,7
2476,2022/12/16,3,0,3,0,6
2507,2022/12/16,15,18,9,0,24
2525,2022/12/16,4,0,1,0,5
2562,2022/12/16,7,0,0,0,7
2582,2022/12/16,5,0,2,0,7
2586,2022/12/16,34,24,15,0,49
2602,2022/12/16,13,0,1,0,14
2631,2022/12/16,11,6,6,0,17
2685,2022/12/16,23,12,4,0,27
2723,2022/12/16,4,0,1,0,5
2730,2022/12/16,5,0,2,0,7
2731,2022/12/16,8,0,1,0,9
2732,2022/12/16,10,8,0,0,10
2734,2022/12/16,7,0,0,0,7
2735,2022/12/16,4,4,1,0,5
2761,2022/12/16,32,25,11,0,43
2788,2022/12/16,27,24,18,0,45
2802,2022/12/16,9,6,1,0,10
2812,2022/12/16,9,0,2,0,11
2813,2022/12/16,5,0,0,0,5
2814,2022/12/16,5,0,1,0,6
2913,2022/12/16,11,6,1,0,12
2914,2022/12/16,11,0,0,0,11
3015,2022/12/16,12,8,4,0,16
3033,2022/12/16,7,0,0,0,7
3035,2022/12/16,12,0,1,0,13
4446,2022/12/16,13,12,10,0,23
12136,2022/12/16,32,33,31,0,63
12516,2022/12/16,13,4,1,0,14
12518,2022/12/16,15,4,6,0,21
12523,2022/12/16,13,8,4,0,17
16062,2022/12/16,9,0,1,0,10
16276,2022/12/16,10,4,0,0,10
19322,2022/12/16,6,0,0,0,6
19329,2022/12/16,8,0,0,0,8
19520,2022/12/16,11,0,0,0,11
20901,2022/12/16,5,0,1,0,6
20920,2022/12/16,10,0,0,0,10
21097,2022/12/16,11,0,0,0,11
21102,2022/12/16,27,0,0,0,27
21132,2022/12/16,27,24,16,0,43
21171,2022/12/16,7,4,1,0,8
21174,2022/12/16,8,4,4,0,12
21175,2022/12/16,16,12,7,0,23
21176,2022/12/16,14,0,3,6,17
75,2022/12/17,46,40,45,0,91
76,2022/12/17,53,44,37,4,90
99,2022/12/17,18,12,0,0,18
117,2022/12/17,4,0,1,0,5
118,2022/12/17,10,0,1,0,11
119,2022/12/17,4,0,2,0,6
120,2022/12/17,6,0,0,0,6
149,2022/12/17,8,0,1,0,9
184,2022/12/17,14,12,7,0,21
195,2022/12/17,26,15,26,0,52
218,2022/12/17,8,0,6,0,14
296,2022/12/17,8,0,2,0,10
300,2022/12/17,17,0,2,0,19
304,2022/12/17,12,0,0,0,12
317,2022/12/17,19,0,4,0,23
343,2022/12/17,14,0,2,1,16
353,2022/12/17,6,0,1,0,7
373,2022/12/17,-2,0,4,0,2
374,2022/12/17,13,0,1,0,14
388,2022/12/17,35,30,24,0,59
419,2022/12/17,9,0,2,0,11
420,2022/12/17,10,0,1,0,11
462,2022/12/17,12,0,5,0,17
519,2022/12/17,15,0,5,0,20
525,2022/12/17,8,0,2,0,10
596,2022/12/17,16,0,6,0,22
597,2022/12/17,11,0,10,1,21
598,2022/12/17,7,0,0,0,7
1035,2022/12/17,12,0,4,1,16
1084,2022/12/17,16,0,9,0,25
1111,2022/12/17,12,6,3,0,15
1112,2022/12/17,5,0,0,0,5
1113,2022/12/17,7,0,0,0,7
1114,2022/12/17,17,12,13,0,30
1115,2022/12/17,13,6,2,0,15
1117,2022/12/17,3,0,1,0,4
1118,2022/12/17,13,6,2,0,15
1119,2022/12/17,11,6,0,0,11
1692,2022/12/17,8,0,1,0,9
1693,2022/12/17,15,0,2,0,17
1747,2022/12/17,27,20,23,0,50
1772,2022/12/17,11,0,2,0,13
1773,2022/12/17,14,6,3,0,17
1774,2022/12/17,9,0,1,0,10
1782,2022/12/17,33,18,28,0,61
1795,2022/12/17,49,28,16,2,65
1914,2022/12/17,10,0,0,0,10
1915,2022/12/17,10,6,2,0,12
1923,2022/12/17,9,0,1,0,10
1934,2022/12/17,7,5,7,0,14
1963,2022/12/17,17,6,6,0,23
1984,2022/12/17,8,0,0,0,8
2135,2022/12/17,10,0,1,0,11
2136,2022/12/17,7,6,1,0,8
2148,2022/12/17,12,0,0,0,12
2183,2022/12/17,10,0,1,0,11
2193,2022/12/17,5,0,3,0,8
2237,2022/12/17,11,6,2,0,13
2358,2022/12/17,16,0,2,0,18
2361,2022/12/17,2,0,2,0,4
2445,2022/12/17,4,0,5,0,9
2449,2022/12/17,9,0,0,0,9
2451,2022/12/17,30,5,7,0,37
2475,2022/12/17,7,0,1,0,8
2476,2022/12/17,6,6,1,0,7
2507,2022/12/17,6,0,10,0,16
2525,2022/12/17,9,6,0,0,9
2562,2022/12/17,12,6,2,0,14
2582,2022/12/17,7,4,0,0,7
2586,2022/12/17,30,12,20,0,50
2602,2022/12/17,12,0,0,0,12
2631,2022/12/17,3,0,3,0,6
2685,2022/12/17,14,0,9,0,23
2723,2022/12/17,11,8,0,0,11
2730,2022/12/17,7,6,1,0,8
2731,2022/12/17,12,6,2,0,14
2732,2022/12/17,18,8,1,0,19
2734,2022/12/17,7,0,2,0,9
2735,2022/12/17,7,4,1,0,8
2761,2022/12/17,35,20,12,0,47
2788,2022/12/17,7,0,7,0,14
2802,2022/12/17,8,0,0,0,8
2812,2022/12/17,7,0,2,0,9
2813,2022/12/17,11,6,2,0,13
2814,2022/12/17,10,6,2,0,12
2913,2022/12/17,10,0,1,0,11
2914,2022/12/17,11,0,0,0,11
3015,2022/12/17,8,0,3,0,11
3033,2022/12/17,6,0,1,0,7
3035,2022/12/17,10,0,1,0,11
4446,2022/12/17,15,12,15,0,30
12136,2022/12/17,1,0,3,0,4
12516,2022/12/17,12,0,0,0,12
12518,2022/12/17,9,0,1,0,10
12523,2022/12/17,17,8,3,0,20
16062,2022/12/17,8,0,1,0,9
16276,2022/12/17,10,0,0,0,10
19329,2022/12/17,8,0,1,0,9
19520,2022/12/17,11,0,1,0,12
20901,2022/12/17,4,0,1,0,5
20920,2022/12/17,10,0,0,0,10
21102,2022/12/17,27,0,1,0,28
21132,2022/12/17,29,21,24,3,53
21171,2022/12/17,4,0,1,0,5
21174,2022/12/17,4,0,0,0,4
21175,2022/12/17,9,0,6,0,15
21176,2022/12/17,5,0,1,0,6
75,2022/12/18,41,40,30,0,71
76,2022/12/18,52,40,24,0,76
99,2022/12/18,18,0,1,0,19
117,2022/12/18,3,0,1,0,4
118,2022/12/18,9,0,0,2,9
119,2022/12/18,6,4,1,0,7
120,2022/12/18,6,0,1,0,7
149,2022/12/18,7,0,0,0,7
184,2022/12/18,25,18,18,0,43
195,2022/12/18,30,30,25,0,55
218,2022/12/18,59,57,44,10,103
296,2022/12/18,14,8,6,0,20
300,2022/12/18,15,0,3,0,18
304,2022/12/18,16,4,1,0,17
317,2022/12/18,15,0,2,0,17
343,2022/12/18,11,0,3,1,14
353,2022/12/18,5,0,0,0,5
373,2022/12/18,-6,0,6,0,0
374,2022/12/18,16,4,3,0,19
388,2022/12/18,38,27,24,6,62
419,2022/12/18,13,6,2,0,15
420,2022/12/18,9,0,0,0,9
462,2022/12/18,15,8,8,0,23
519,2022/12/18,16,6,7,0,23
525,2022/12/18,11,5,0,0,11
596,2022/12/18,10,0,5,0,15
597,2022/12/18,12,12,12,0,24
598,2022/12/18,13,6,2,0,15
1035,2022/12/18,7,0,4,0,11
1084,2022/12/18,17,10,13,0,30
1111,2022/12/18,9,0,1,0,10
1112,2022/12/18,5,0,1,0,6
1113,2022/12/18,7,0,3,0,10
1114,2022/12/18,10,6,8,0,18
1115,2022/12/18,11,0,1,0,12
1117,2022/12/18,2,0,1,0,3
1118,2022/12/18,11,0,2,0,13
1119,2022/12/18,11,0,1,0,12
1692,2022/12/18,13,6,1,0,14
1693,2022/12/18,13,0,1,0,14
1747,2022/12/18,24,20,20,0,44
1772,2022/12/18,9,0,1,0,10
1773,2022/12/18,11,0,1,0,12
1774,2022/12/18,8,0,0,0,8
1782,2022/12/18,20,15,18,0,38
1795,2022/12/18,31,0,25,0,56
1914,2022/12/18,10,0,0,0,10
1915,2022/12/18,8,0,1,0,9
1923,2022/12/18,8,0,0,0,8
1934,2022/12/18,0,0,0,0,0
1963,2022/12/18,23,12,4,0,27
1984,2022/12/18,8,0,0,0,8
2135,2022/12/18,9,0,6,0,15
2136,2022/12/18,6,0,2,0,8
2148,2022/12/18,12,0,4,0,16
2183,2022/12/18,9,0,2,0,11
2193,2022/12/18,41,39,20,12,61
2237,2022/12/18,9,0,2,0,11
2358,2022/12/18,14,0,0,0,14
2361,2022/12/18,7,7,3,0,10
2445,2022/12/18,5,6,6,0,11
2449,2022/12/18,15,6,2,0,17
2451,2022/12/18,48,25,5,0,53
2475,2022/12/18,6,0,0,0,6
2476,2022/12/18,5,0,1,0,6
2507,2022/12/18,20,24,11,0,31
2525,2022/12/18,9,0,1,0,10
2562,2022/12/18,10,0,4,0,14
2582,2022/12/18,7,0,0,0,7
2586,2022/12/18,30,20,27,0,57
2602,2022/12/18,12,0,0,0,12
2631,2022/12/18,0,0,0,0,0
2685,2022/12/18,13,8,6,0,19
2723,2022/12/18,11,0,2,0,13
2730,2022/12/18,6,0,3,0,9
2731,2022/12/18,10,0,2,0,12
2732,2022/12/18,17,0,3,0,20
2734,2022/12/18,9,4,3,0,12
2735,2022/12/18,14,8,5,0,19
2761,2022/12/18,33,10,27,0,60
2788,2022/12/18,52,52,25,14,77
2802,2022/12/18,8,0,0,0,8
2812,2022/12/18,5,0,0,0,5
2813,2022/12/18,9,0,2,0,11
2814,2022/12/18,14,6,0,0,14
2913,2022/12/18,9,0,2,0,11
2914,2022/12/18,11,0,3,0,14
3015,2022/12/18,5,0,3,0,8
3033,2022/12/18,5,0,0,0,5
3035,2022/12/18,9,0,1,0,10
4446,2022/12/18,15,15,14,0,29
12136,2022/12/18,37,39,26,3,63
12516,2022/12/18,12,0,2,0,14
12518,2022/12/18,8,0,3,0,11
12523,2022/12/18,18,4,4,0,22
16062,2022/12/18,7,0,0,0,7
16276,2022/12/18,10,0,1,0,11
19322,2022/12/18,6,0,0,0,6
19329,2022/12/18,7,0,1,0,8
19520,2022/12/18,10,0,1,0,11
20901,2022/12/18,3,0,1,0,4
20920,2022/12/18,10,0,0,0,10
21097,2022/12/18,11,0,0,0,11
21099,2022/12/18,6,0,0,0,6
21102,2022/12/18,26,0,0,0,26
21132,2022/12/18,20,18,12,4,32
21171,2022/12/18,11,8,4,0,15
21174,2022/12/18,32,28,20,0,52
21175,2022/12/18,19,16,11,0,30
21176,2022/12/18,16,12,7,0,23
75,2022/12/19,51,40,38,4,89
76,2022/12/19,68,40,43,2,111
99,2022/12/19,17,0,0,0,17
117,2022/12/19,2,0,1,1,3
118,2022/12/19,7,0,1,1,8
119,2022/12/19,9,4,1,0,10
120,2022/12/19,5,0,0,0,5
149,2022/12/19,7,0,0,0,7
184,2022/12/19,20,12,11,0,31
195,2022/12/19,35,30,19,1,54
218,2022/12/19,35,30,27,0,62
296,2022/12/19,12,4,1,0,13
300,2022/12/19,12,0,3,0,15
304,2022/12/19,19,4,1,0,20
317,2022/12/19,19,6,1,0,20
343,2022/12/19,7,0,1,0,8
353,2022/12/19,5,0,0,0,5
373,2022/12/19,2,12,2,0,4
374,2022/12/19,13,0,1,0,14
388,2022/12/19,32,24,15,5,47
419,2022/12/19,17,6,2,0,19
420,2022/12/19,9,0,3,0,12
462,2022/12/19,23,16,7,0,30
519,2022/12/19,9,0,2,0,11
525,2022/12/19,11,0,1,2,12
596,2022/12/19,13,8,6,0,19
597,2022/12/19,12,12,9,0,21
598,2022/12/19,11,0,1,0,12
1035,2022/12/19,3,0,2,0,5
1084,2022/12/19,19,15,8,0,27
1111,2022/12/19,8,0,1,0,9
1112,2022/12/19,4,0,1,0,5
1113,2022/12/19,4,0,0,0,4
1114,2022/12/19,8,6,5,0,13
1115,2022/12/19,16,6,2,0,18
1117,2022/12/19,1,0,0,0,1
1118,2022/12/19,9,0,0,0,9
1119,2022/12/19,10,0,1,0,11
1692,2022/12/19,12,0,0,0,12
1693,2022/12/19,12,0,1,0,13
1747,2022/12/19,24,20,16,0,40
1772,2022/12/19,8,0,1,0,9
1773,2022/12/19,10,0,1,0,11
1774,2022/12/19,8,0,1,0,9
1782,2022/12/19,20,18,12,0,32
1795,2022/12/19,13,7,11,0,24
1914,2022/12/19,10,0,1,0,11
1915,2022/12/19,7,0,1,0,8
1923,2022/12/19,8,0,0,0,8
1934,2022/12/19,5,5,2,0,7
1963,2022/12/19,25,6,5,0,30
1984,2022/12/19,14,6,2,0,16
2135,2022/12/19,9,6,2,0,11
2136,2022/12/19,4,0,1,0,5
2148,2022/12/19,8,0,2,0,10
2183,2022/12/19,13,6,0,0,13
2193,2022/12/19,31,21,22,4,53
2237,2022/12/19,13,6,0,0,13
2358,2022/12/19,14,0,4,0,18
2361,2022/12/19,11,7,4,0,15
2445,2022/12/19,5,6,6,0,11
2449,2022/12/19,13,0,2,0,15
2451,2022/12/19,43,0,11,0,54
2475,2022/12/19,6,0,1,0,7
2476,2022/12/19,10,6,0,0,10
2507,2022/12/19,27,18,11,0,38
2525,2022/12/19,8,0,1,0,9
2562,2022/12/19,6,0,3,0,9
2582,2022/12/19,7,0,2,0,9
2586,2022/12/19,19,16,10,0,29
2602,2022/12/19,12,0,1,0,13
2631,2022/12/19,6,6,1,0,7
2685,2022/12/19,7,0,4,2,11
2723,2022/12/19,9,0,0,0,9
2730,2022/12/19,9,6,3,0,12
2731,2022/12/19,8,0,3,0,11
2732,2022/12/19,14,0,1,0,15
2734,2022/12/19,6,0,0,0,6
2735,2022/12/19,17,8,2,0,19
2761,2022/12/19,26,20,11,0,37
2788,2022/12/19,37,24,21,6,58
2802,2022/12/19,8,0,0,0,8
2812,2022/12/19,5,0,0,0,5
2813,2022/12/19,7,0,0,0,7
2814,2022/12/19,14,0,0,0,14
2913,2022/12/19,7,0,0,0,7
2914,2022/12/19,8,0,1,0,9
3015,2022/12/19,10,8,0,0,10
3033,2022/12/19,5,0,0,0,5
3035,2022/12/19,8,0,1,0,9
4446,2022/12/19,14,12,10,0,24
12136,2022/12/19,38,30,35,0,73
12516,2022/12/19,10,0,1,0,11
12518,2022/12/19,5,0,0,0,5
12523,2022/12/19,14,0,2,0,16
16062,2022/12/19,7,0,0,0,7
16276,2022/12/19,9,0,3,0,12
19322,2022/12/19,6,0,0,0,6
19329,2022/12/19,6,0,0,0,6
19520,2022/12/19,9,0,1,0,10
20901,2022/12/19,2,0,0,0,2
20920,2022/12/19,10,0,0,0,10
21097,2022/12/19,11,0,0,0,11
21099,2022/12/19,6,0,0,0,6
21102,2022/12/19,26,0,0,0,26
21132,2022/12/19,28,24,19,2,47
21171,2022/12/19,7,0,3,0,10
21174,2022/12/19,24,12,4,0,28
21175,2022/12/19,20,12,8,0,28
21176,2022/12/19,13,4,6,0,19
75,2022/12/20,45,36,24,2,69
76,2022/12/20,64,40,25,5,89
99,2022/12/20,17,0,0,0,17
117,2022/12/20,4,4,1,0,5
118,2022/12/20,9,4,0,2,9
119,2022/12/20,12,4,0,0,12
120,2022/12/20,5,0,0,1,5
149,2022/12/20,7,0,0,0,7
184,2022/12/20,23,15,12,0,35
195,2022/12/20,45,30,34,2,79
218,2022/12/20,38,30,31,0,69
296,2022/12/20,15,4,0,0,15
300,2022/12/20,9,0,0,1,9
304,2022/12/20,18,0,2,0,20
317,2022/12/20,18,0,4,0,22
343,2022/12/20,6,0,0,3,6
353,2022/12/20,5,0,0,0,5
373,2022/12/20,-2,0,1,0,-1
374,2022/12/20,16,4,3,0,19
388,2022/12/20,39,27,16,8,55
419,2022/12/20,21,6,3,7,24
420,2022/12/20,6,0,0,0,6
462,2022/12/20,24,8,5,0,29
519,2022/12/20,13,6,7,0,20
525,2022/12/20,8,0,1,0,9
596,2022/12/20,15,8,8,4,23
597,2022/12/20,21,18,8,0,29
598,2022/12/20,16,6,1,0,17
1035,2022/12/20,7,6,3,0,10
1084,2022/12/20,31,20,13,2,44
1111,2022/12/20,7,0,0,0,7
1112,2022/12/20,3,0,0,0,3
1113,2022/12/20,4,0,2,0,6
1114,2022/12/20,3,0,1,0,4
1115,2022/12/20,14,0,0,0,14
1117,2022/12/20,1,0,0,0,1
1118,2022/12/20,15,6,2,0,17
1119,2022/12/20,9,0,1,0,10
1692,2022/12/20,12,0,0,0,12
1693,2022/12/20,11,0,2,0,13
1747,2022/12/20,33,25,20,0,53
1772,2022/12/20,7,0,1,0,8
1773,2022/12/20,9,0,1,0,10
1774,2022/12/20,7,0,0,0,7
1782,2022/12/20,26,18,15,1,41
1795,2022/12/20,16,14,10,0,26
1914,2022/12/20,9,0,0,0,9
1915,2022/12/20,6,0,1,0,7
1923,2022/12/20,8,0,0,0,8
1934,2022/12/20,3,0,2,0,5
1963,2022/12/20,26,6,4,0,30
1984,2022/12/20,12,0,1,0,13
2135,2022/12/20,7,0,2,0,9
2136,2022/12/20,9,6,1,0,10
2148,2022/12/20,10,4,2,0,12
2183,2022/12/20,13,0,3,0,16
2193,2022/12/20,29,24,16,5,45
2237,2022/12/20,13,0,3,0,16
2358,2022/12/20,10,0,6,1,16
2361,2022/12/20,21,14,4,0,25
2445,2022/12/20,5,6,4,0,9
2449,2022/12/20,11,0,2,0,13
2451,2022/12/20,32,0,9,1,41
2475,2022/12/20,5,0,0,0,5
2476,2022/12/20,10,0,0,0,10
2507,2022/12/20,34,18,6,0,40
2525,2022/12/20,7,0,0,0,7
2562,2022/12/20,3,0,3,0,6
2582,2022/12/20,9,4,0,0,9
2586,2022/12/20,25,16,7,0,32
2602,2022/12/20,11,0,1,0,12
2631,2022/12/20,5,0,0,0,5
2685,2022/12/20,13,12,10,1,23
2723,2022/12/20,9,0,1,0,10
2730,2022/12/20,6,0,2,0,8
2731,2022/12/20,5,0,0,0,5
2732,2022/12/20,13,0,1,0,14
2734,2022/12/20,10,4,0,0,10
2735,2022/12/20,15,0,0,0,15
2761,2022/12/20,30,15,20,0,50
2788,2022/12/20,30,20,18,2,48
2802,2022/12/20,8,0,0,0,8
2812,2022/12/20,11,6,3,0,14
2813,2022/12/20,7,0,0,0,7
2814,2022/12/20,14,0,3,0,17
2913,2022/12/20,7,0,1,0,8
2914,2022/12/20,7,0,1,0,8
3015,2022/12/20,10,0,3,0,13
3033,2022/12/20,5,0,0,0,5
3035,2022/12/20,7,0,0,0,7
4446,2022/12/20,15,12,3,0,18
12136,2022/12/20,33,30,28,0,61
12516,2022/12/20,9,0,1,0,10
12518,2022/12/20,9,4,3,0,12
12523,2022/12/20,16,4,2,0,18
16062,2022/12/20,7,0,4,0,11
16276,2022/12/20,6,0,1,0,7
19322,2022/12/20,6,0,0,0,6
19329,2022/12/20,6,0,0,0,6
19520,2022/12/20,8,0,0,0,8
20901,2022/12/20,2,0,0,0,2
20920,2022/12/20,10,0,0,0,10
21097,2022/12/20,11,0,0,0,11
21099,2022/12/20,6,0,0,0,6
21102,2022/12/20,26,0,1,0,27
21132,2022/12/20,25,18,17,3,42
21171,2022/12/20,8,4,3,0,11
21174,2022/12/20,40,20,18,5,58
21175,2022/12/20,24,12,9,2,33
21176,2022/12/20,19,12,7,0,26
75,2022/12/21,51,32,36,1,87
76,2022/12/21,70,36,43,2,113
99,2022/12/21,17,0,1,0,18
117,2022/12/21,3,0,0,0,3
118,2022/12/21,7,0,4,0,11
119,2022/12/21,16,4,2,3,18
120,2022/12/21,4,0,0,0,4
149,2022/12/21,7,0,0,0,7
184,2022/12/21,23,12,12,0,35
195,2022/12/21,48,39,27,2,75
218,2022/12/21,31,24,22,1,53
296,2022/12/21,19,4,4,0,23
300,2022/12/21,8,0,1,1,9
304,2022/12/21,16,0,4,0,20
317,2022/12/21,14,0,1,8,15
343,2022/12/21,3,0,1,2,4
353,2022/12/21,5,0,0,0,5
373,2022/12/21,6,6,4,4,10
374,2022/12/21,13,0,0,0,13
388,2022/12/21,39,24,25,0,64
419,2022/12/21,17,6,3,6,20
462,2022/12/21,19,0,4,0,23
519,2022/12/21,6,0,5,0,11
525,2022/12/21,7,0,1,0,8
596,2022/12/21,11,8,5,0,16
597,2022/12/21,31,18,22,0,53
598,2022/12/21,15,0,1,0,16
1035,2022/12/21,4,0,3,0,7
1084,2022/12/21,36,20,14,0,50
1111,2022/12/21,7,0,0,0,7
1112,2022/12/21,3,0,1,0,4
1113,2022/12/21,8,6,0,0,8
1114,2022/12/21,14,12,10,0,24
1115,2022/12/21,20,6,1,0,21
1117,2022/12/21,1,0,0,0,1
1118,2022/12/21,13,0,1,0,14
1119,2022/12/21,8,0,0,0,8
1692,2022/12/21,12,0,2,3,14
1693,2022/12/21,9,0,2,2,11
1747,2022/12/21,33,20,20,0,53
1772,2022/12/21,6,0,0,0,6
1773,2022/12/21,8,0,4,0,12
1774,2022/12/21,7,0,0,0,7
1782,2022/12/21,31,21,23,0,54
1795,2022/12/21,20,14,18,0,38
1914,2022/12/21,9,0,1,0,10
1915,2022/12/21,5,0,3,0,8
1923,2022/12/21,8,0,2,0,10
1934,2022/12/21,6,5,1,0,7
1963,2022/12/21,22,0,2,10,24
1984,2022/12/21,11,0,4,0,15
2135,2022/12/21,11,6,0,0,11
2136,2022/12/21,8,0,0,0,8
2148,2022/12/21,8,0,1,0,9
2183,2022/12/21,10,0,5,0,15
2193,2022/12/21,25,18,12,5,37
2237,2022/12/21,16,6,3,0,19
2358,2022/12/21,3,0,0,0,3
2361,2022/12/21,24,7,8,0,32
2445,2022/12/21,7,6,1,0,8
2449,2022/12/21,15,6,2,4,17
2451,2022/12/21,22,0,5,5,27
2475,2022/12/21,5,0,1,0,6
2476,2022/12/21,10,0,1,0,11
2507,2022/12/21,40,12,12,0,52
2525,2022/12/21,7,0,1,0,8
2562,2022/12/21,0,0,0,0,0
2582,2022/12/21,9,0,5,0,14
2586,2022/12/21,38,20,10,0,48
2602,2022/12/21,10,0,3,0,13
2631,2022/12/21,11,6,2,0,13
2685,2022/12/21,10,8,5,0,15
2723,2022/12/21,8,0,2,0,10
2730,2022/12/21,10,6,1,0,11
2731,2022/12/21,5,0,0,0,5
2732,2022/12/21,12,0,2,0,14
2734,2022/12/21,10,0,2,0,12
2735,2022/12/21,15,0,2,0,17
2761,2022/12/21,30,20,9,0,39
2788,2022/12/21,30,20,17,2,47
2802,2022/12/21,8,0,0,0,8
2812,2022/12/21,8,0,3,0,11
2813,2022/12/21,7,0,0,0,7
2814,2022/12/21,11,0,1,0,12
2913,2022/12/21,6,0,0,0,6
2914,2022/12/21,6,0,0,0,6
3015,2022/12/21,15,8,4,0,19
3033,2022/12/21,5,0,0,0,5
3035,2022/12/21,7,0,1,0,8
4446,2022/12/21,27,15,15,0,42
12136,2022/12/21,32,27,29,0,61
12516,2022/12/21,8,0,2,0,10
12518,2022/12/21,6,0,0,0,6
12523,2022/12/21,14,0,1,0,15
16062,2022/12/21,3,0,3,0,6
16276,2022/12/21,5,0,1,2,6
19322,2022/12/21,6,0,0,0,6
19329,2022/12/21,6,0,1,0,7
19520,2022/12/21,8,0,2,0,10
20901,2022/12/21,2,0,3,0,5
20920,2022/12/21,10,0,0,0,10
21097,2022/12/21,11,0,0,0,11
21099,2022/12/21,6,0,0,0,6
21102,2022/12/21,25,0,0,0,25
21132,2022/12/21,26,21,9,4,35
21171,2022/12/21,9,4,1,3,10
21174,2022/12/21,17,0,14,0,31
21175,2022/12/21,13,0,9,0,22
21176,2022/12/21,12,0,1,0,13
75,2022/12/22,42,28,31,0,73
76,2022/12/22,56,32,38,2,94
99,2022/12/22,16,0,0,0,16
117,2022/12/22,3,0,1,0,4
118,2022/12/22,3,0,1,0,4
119,2022/12/22,11,0,2,1,13
120,2022/12/22,4,0,0,0,4
149,2022/12/22,7,0,1,0,8
184,2022/12/22,23,12,12,0,35
195,2022/12/22,46,27,27,6,73
218,2022/12/22,32,24,27,0,59
296,2022/12/22,19,4,5,0,24
300,2022/12/22,6,0,5,0,11
304,2022/12/22,12,0,3,0,15
317,2022/12/22,5,0,2,0,7
343,2022/12/22,0,0,0,0,0
353,2022/12/22,5,0,0,0,5
373,2022/12/22,-2,0,2,0,0
374,2022/12/22,13,0,1,0,14
388,2022/12/22,41,27,20,4,61
419,2022/12/22,8,0,0,1,8
462,2022/12/22,23,8,6,0,29
519,2022/12/22,13,12,2,0,15
525,2022/12/22,6,0,0,1,6
596,2022/12/22,14,8,5,0,19
597,2022/12/22,33,24,11,0,44
598,2022/12/22,14,0,1,0,15
1035,2022/12/22,7,6,5,0,12
1084,2022/12/22,37,15,9,0,46
1111,2022/12/22,13,6,4,0,17
1112,2022/12/22,8,6,0,0,8
1113,2022/12/22,8,0,0,0,8
1114,2022/12/22,16,12,4,0,20
1115,2022/12/22,19,0,1,0,20
1117,2022/12/22,1,0,0,0,1
1118,2022/12/22,12,0,4,0,16
1119,2022/12/22,8,0,1,0,9
1692,2022/12/22,7,0,0,2,7
1693,2022/12/22,5,0,1,0,6
1747,2022/12/22,33,20,22,3,55
1772,2022/12/22,6,0,1,0,7
1773,2022/12/22,10,6,2,0,12
1774,2022/12/22,7,0,2,0,9
1782,2022/12/22,32,24,24,3,56
1795,2022/12/22,16,14,16,0,32
1914,2022/12/22,8,0,1,0,9
1915,2022/12/22,8,6,3,0,11
1923,2022/12/22,6,0,0,0,6
1934,2022/12/22,5,0,3,0,8
1963,2022/12/22,10,0,1,3,11
1984,2022/12/22,7,0,3,0,10
2135,2022/12/22,17,6,1,0,18
2136,2022/12/22,8,0,1,0,9
2148,2022/12/22,7,0,1,0,8
2183,2022/12/22,5,0,0,0,5
2193,2022/12/22,26,18,18,4,44
2237,2022/12/22,13,0,2,0,15
2358,2022/12/22,3,0,0,0,3
2361,2022/12/22,23,7,3,0,26
2445,2022/12/22,12,6,2,0,14
2449,2022/12/22,9,0,6,0,15
2451,2022/12/22,22,10,7,1,29
2475,2022/12/22,10,6,1,0,11
2476,2022/12/22,9,0,1,0,10
2507,2022/12/22,34,6,13,0,47
2525,2022/12/22,6,0,0,0,6
2562,2022/12/22,0,0,0,0,0
2582,2022/12/22,4,0,1,0,5
2586,2022/12/22,48,20,15,3,63
2602,2022/12/22,7,0,1,0,8
2631,2022/12/22,15,6,4,0,19
2685,2022/12/22,17,12,5,0,22
2723,2022/12/22,6,0,1,0,7
2730,2022/12/22,9,0,3,0,12
2731,2022/12/22,11,6,2,0,13
2732,2022/12/22,10,0,0,0,10
2734,2022/12/22,8,0,2,0,10
2735,2022/12/22,17,4,2,0,19
2761,2022/12/22,51,30,17,0,68
2788,2022/12/22,31,20,22,6,53
2802,2022/12/22,8,0,0,0,8
2812,2022/12/22,5,0,1,0,6
2813,2022/12/22,7,0,1,0,8
2814,2022/12/22,10,0,2,0,12
2913,2022/12/22,6,0,1,0,7
2914,2022/12/22,12,6,3,0,15
3015,2022/12/22,11,0,3,0,14
3033,2022/12/22,5,0,1,0,6
3035,2022/12/22,6,0,0,0,6
4446,2022/12/22,24,12,10,0,34
12136,2022/12/22,24,21,23,3,47
12516,2022/12/22,10,4,2,0,12
12518,2022/12/22,10,4,1,0,11
12523,2022/12/22,13,0,4,0,17
16062,2022/12/22,0,0,0,0,0
16276,2022/12/22,2,0,0,0,2
19322,2022/12/22,6,0,0,0,6
19329,2022/12/22,5,0,2,0,7
19520,2022/12/22,6,0,1,0,7
20901,2022/12/22,-1,0,0,0,-1
20920,2022/12/22,10,0,1,0,11
21097,2022/12/22,11,0,0,0,11
21102,2022/12/22,25,0,0,0,25
21132,2022/12/22,31,18,17,12,48
21171,2022/12/22,5,0,1,0,6
21174,2022/12/22,15,12,9,0,24
21175,2022/12/22,12,8,8,0,20
21176,2022/12/22,15,4,4,0,19
75,2022/12/23,47,36,24,4,71
76,2022/12/23,48,32,33,2,81
99,2022/12/23,16,0,1,0,17
117,2022/12/23,6,4,0,0,6
118,2022/12/23,6,4,4,0,10
119,2022/12/23,8,0,2,0,10
120,2022/12/23,4,0,0,0,4
149,2022/12/23,6,0,0,0,6
184,2022/12/23,26,15,18,2,44
195,2022/12/23,34,21,18,8,52
218,2022/12/23,29,24,23,0,52
296,2022/12/23,14,0,4,0,18
300,2022/12/23,1,0,4,0,5
304,2022/12/23,9,0,1,0,10
317,2022/12/23,3,0,1,0,4
343,2022/12/23,4,4,0,0,4
353,2022/12/23,5,0,0,0,5
373,2022/12/23,2,6,3,1,5
374,2022/12/23,12,0,2,0,14
388,2022/12/23,35,18,23,8,58
419,2022/12/23,13,6,3,0,16
462,2022/12/23,17,0,8,0,25
519,2022/12/23,17,6,10,0,27
525,2022/12/23,5,0,0,5,5
596,2022/12/23,21,12,3,0,24
597,2022/12/23,58,36,5,7,63
598,2022/12/23,13,0,1,0,14
1035,2022/12/23,8,6,6,0,14
1084,2022/12/23,53,25,9,7,62
1111,2022/12/23,9,0,2,0,11
1112,2022/12/23,8,0,0,0,8
1113,2022/12/23,8,0,4,0,12
1114,2022/12/23,18,6,12,0,30
1115,2022/12/23,18,0,5,0,23
1117,2022/12/23,1,0,4,0,5
1118,2022/12/23,8,0,0,0,8
1119,2022/12/23,7,0,0,0,7
1692,2022/12/23,5,0,0,0,5
1693,2022/12/23,4,0,0,0,4
1747,2022/12/23,23,15,21,0,44
1772,2022/12/23,5,0,1,0,6
1773,2022/12/23,8,0,0,0,8
1774,2022/12/23,5,0,1,0,6
1782,2022/12/23,11,6,19,1,30
1795,2022/12/23,21,21,11,0,32
1914,2022/12/23,7,0,4,0,11
1915,2022/12/23,5,0,3,0,8
1923,2022/12/23,6,0,1,0,7
1934,2022/12/23,7,5,3,0,10
1963,2022/12/23,6,0,1,0,7
1984,2022/12/23,4,0,1,0,5
2135,2022/12/23,16,0,3,0,19
2136,2022/12/23,7,0,0,0,7
2148,2022/12/23,10,4,4,0,14
2183,2022/12/23,5,0,3,0,8
2193,2022/12/23,22,18,13,2,35
2237,2022/12/23,11,0,3,0,14
2358,2022/12/23,7,4,3,0,10
2361,2022/12/23,27,7,4,0,31
2445,2022/12/23,16,6,3,0,19
2449,2022/12/23,3,0,2,0,5
2451,2022/12/23,14,0,4,0,18
2475,2022/12/23,9,0,1,0,10
2476,2022/12/23,8,0,2,0,10
2507,2022/12/23,21,0,16,4,37
2525,2022/12/23,6,0,1,0,7
2562,2022/12/23,6,6,0,0,6
2582,2022/12/23,3,0,3,0,6
2586,2022/12/23,42,12,14,0,56
2602,2022/12/23,6,0,0,0,6
2631,2022/12/23,17,6,4,0,21
2685,2022/12/23,20,8,5,1,25
2723,2022/12/23,13,8,0,0,13
2730,2022/12/23,12,6,4,0,16
2731,2022/12/23,9,0,0,0,9
2732,2022/12/23,10,0,1,0,11
2734,2022/12/23,6,0,0,0,6
2735,2022/12/23,15,0,4,0,19
2761,2022/12/23,34,0,16,5,50
2788,2022/12/23,19,16,17,10,36
2802,2022/12/23,8,0,0,0,8
2812,2022/12/23,10,6,0,0,10
2813,2022/12/23,6,0,1,0,7
2814,2022/12/23,8,0,0,0,8
2913,2022/12/23,11,6,0,0,11
2914,2022/12/23,9,0,1,0,10
3015,2022/12/23,16,8,0,0,16
3033,2022/12/23,4,0,0,0,4
3035,2022/12/23,6,0,1,0,7
4446,2022/12/23,26,12,11,1,37
12136,2022/12/23,25,27,20,0,45
12516,2022/12/23,8,0,2,0,10
12518,2022/12/23,9,0,6,0,15
12523,2022/12/23,13,4,5,0,18
16062,2022/12/23,6,6,0,0,6
16276,2022/12/23,2,0,0,0,2
19322,2022/12/23,6,0,0,0,6
19329,2022/12/23,3,0,1,0,4
19520,2022/12/23,5,0,0,0,5
20901,2022/12/23,5,6,2,0,7
20920,2022/12/23,9,0,0,0,9
21097,2022/12/23,11,0,0,0,11
21102,2022/12/23,25,0,1,0,26
21132,2022/12/23,14,12,9,5,23
21171,2022/12/23,8,4,1,3,9
21174,2022/12/23,14,8,10,0,24
21175,2022/12/23,12,8,7,0,19
21176,2022/12/23,15,4,1,3,16
75,2022/12/24,43,24,10,0,53
76,2022/12/24,37,24,20,1,57
99,2022/12/24,15,0,1,0,16
117,2022/12/24,6,0,0,0,6
118,2022/12/24,2,0,1,0,3
119,2022/12/24,6,0,1,1,7
120,2022/12/24,4,0,0,0,4
149,2022/12/24,6,0,0,0,6
184,2022/12/24,18,12,7,1,25
195,2022/12/24,26,18,8,5,34
218,2022/12/24,24,18,17,1,41
296,2022/12/24,10,0,1,0,11
300,2022/12/24,1,4,0,0,1
304,2022/12/24,12,4,2,0,14
317,2022/12/24,2,0,1,0,3
343,2022/12/24,4,0,2,0,6
353,2022/12/24,11,6,0,0,11
373,2022/12/24,4,6,2,0,6
374,2022/12/24,14,4,4,0,18
388,2022/12/24,19,15,13,0,32
419,2022/12/24,10,0,5,0,15
462,2022/12/24,17,8,8,0,25
519,2022/12/24,19,12,8,0,27
525,2022/12/24,0,0,0,0,0
596,2022/12/24,18,0,1,0,19
597,2022/12/24,46,0,5,0,51
598,2022/12/24,12,0,0,0,12
1035,2022/12/24,8,6,2,0,10
1084,2022/12/24,37,0,9,0,46
1111,2022/12/24,7,0,6,0,13
1112,2022/12/24,8,0,2,0,10
1113,2022/12/24,4,0,0,0,4
1114,2022/12/24,24,18,14,0,38
1115,2022/12/24,13,0,7,0,20
1117,2022/12/24,-3,0,1,0,-2
1118,2022/12/24,14,6,6,0,20
1119,2022/12/24,7,0,1,0,8
1692,2022/12/24,5,0,1,0,6
1693,2022/12/24,4,0,0,0,4
1747,2022/12/24,12,10,11,0,23
1772,2022/12/24,4,0,0,0,4
1773,2022/12/24,14,6,1,0,15
1774,2022/12/24,4,0,0,0,4
1782,2022/12/24,3,12,6,6,9
1795,2022/12/24,45,35,10,0,55
1914,2022/12/24,3,0,2,0,5
1915,2022/12/24,2,0,0,0,2
1923,2022/12/24,5,0,0,0,5
1934,2022/12/24,9,5,0,0,9
1963,2022/12/24,11,6,7,0,18
1984,2022/12/24,3,0,0,0,3
2135,2022/12/24,13,0,5,0,18
2136,2022/12/24,7,0,1,0,8
2148,2022/12/24,6,0,1,0,7
2183,2022/12/24,8,6,5,0,13
2193,2022/12/24,22,15,7,5,29
2237,2022/12/24,8,0,4,0,12
2358,2022/12/24,8,4,1,0,9
2361,2022/12/24,23,0,4,3,27
2445,2022/12/24,19,6,9,0,28
2449,2022/12/24,1,0,0,0,1
2451,2022/12/24,25,15,5,0,30
2475,2022/12/24,8,0,3,0,11
2476,2022/12/24,6,0,3,0,9
2507,2022/12/24,7,6,12,4,19
2525,2022/12/24,11,6,0,0,11
2562,2022/12/24,12,6,2,0,14
2582,2022/12/24,0,0,0,0,0
2586,2022/12/24,36,8,4,8,40
2602,2022/12/24,14,8,4,0,18
2631,2022/12/24,13,0,4,0,17
2685,2022/12/24,22,8,4,2,26
2723,2022/12/24,13,0,0,0,13
2730,2022/12/24,8,0,3,0,11
2731,2022/12/24,9,0,0,0,9
2732,2022/12/24,9,0,1,0,10
2734,2022/12/24,6,0,0,0,6
2735,2022/12/24,11,0,2,0,13
2761,2022/12/24,23,10,10,0,33
2788,2022/12/24,8,16,6,3,14
2802,2022/12/24,8,0,0,0,8
2812,2022/12/24,10,0,2,0,12
2813,2022/12/24,5,0,0,0,5
2814,2022/12/24,8,0,1,0,9
2913,2022/12/24,11,0,3,0,14
2914,2022/12/24,8,0,2,0,10
3015,2022/12/24,16,0,1,0,17
3033,2022/12/24,4,0,0,0,4
3035,2022/12/24,5,0,1,0,6
4446,2022/12/24,14,0,9,2,23
12136,2022/12/24,23,18,16,4,39
12516,2022/12/24,6,0,0,0,6
12518,2022/12/24,7,4,1,0,8
12523,2022/12/24,8,0,0,0,8
16062,2022/12/24,12,6,4,0,16
16276,2022/12/24,2,0,0,0,2
19329,2022/12/24,8,6,2,0,10
19520,2022/12/24,5,0,0,0,5
20901,2022/12/24,9,6,0,0,9
20920,2022/12/24,9,0,1,0,10
21102,2022/12/24,24,0,0,0,24
21132,2022/12/24,18,18,7,1,25
21171,2022/12/24,8,4,0,0,8
21174,2022/12/24,16,12,11,0,27
21175,2022/12/24,13,8,3,0,16
21176,2022/12/24,19,8,5,1,24
75,2022/12/25,65,32,20,0,85
76,2022/12/25,40,24,17,0,57
99,2022/12/25,14,0,4,0,18
117,2022/12/25,10,4,1,0,11
118,2022/12/25,5,4,2,0,7
119,2022/12/25,4,0,3,3,7
120,2022/12/25,4,0,0,0,4
149,2022/12/25,6,0,2,0,8
184,2022/12/25,25,15,13,0,38
195,2022/12/25,31,18,9,4,40
218,2022/12/25,29,24,16,1,45
296,2022/12/25,13,4,1,2,14
300,2022/12/25,5,4,5,0,10
304,2022/12/25,10,0,2,6,12
317,2022/12/25,7,6,4,1,11
343,2022/12/25,6,4,1,0,7
353,2022/12/25,11,0,4,0,15
373,2022/12/25,2,0,4,5,6
374,2022/12/25,10,0,5,0,15
388,2022/12/25,27,21,17,1,44
419,2022/12/25,5,0,2,0,7
420,2022/12/25,6,0,0,0,6
462,2022/12/25,9,0,3,4,12
519,2022/12/25,17,6,15,0,32
525,2022/12/25,0,0,0,0,0
596,2022/12/25,25,8,3,0,28
597,2022/12/25,53,12,19,0,72
598,2022/12/25,12,0,2,0,14
1035,2022/12/25,12,6,3,0,15
1084,2022/12/25,28,0,6,0,34
1111,2022/12/25,1,0,2,0,3
1112,2022/12/25,6,0,2,0,8
1113,2022/12/25,4,0,4,0,8
1114,2022/12/25,16,6,7,0,23
1115,2022/12/25,6,0,0,0,6
1117,2022/12/25,-4,0,1,0,-3
1118,2022/12/25,8,0,1,0,9
1119,2022/12/25,6,0,3,0,9
1692,2022/12/25,10,6,4,0,14
1693,2022/12/25,10,6,0,0,10
1747,2022/12/25,21,20,10,11,31
1772,2022/12/25,4,0,1,0,5
1773,2022/12/25,13,0,4,0,17
1774,2022/12/25,4,0,1,0,5
1782,2022/12/25,12,21,12,0,24
1795,2022/12/25,35,0,15,0,50
1914,2022/12/25,1,0,1,0,2
1915,2022/12/25,8,6,5,0,13
1923,2022/12/25,5,0,0,0,5
1934,2022/12/25,9,0,0,0,9
1963,2022/12/25,4,0,3,0,7
1984,2022/12/25,9,6,2,0,11
2135,2022/12/25,8,0,7,0,15
2136,2022/12/25,6,0,1,0,7
2148,2022/12/25,9,4,0,0,9
2183,2022/12/25,3,0,2,0,5
2193,2022/12/25,25,15,6,5,31
2237,2022/12/25,10,6,7,0,17
2358,2022/12/25,15,8,6,0,21
2361,2022/12/25,23,7,6,1,29
2445,2022/12/25,16,6,11,0,27
2449,2022/12/25,1,0,0,0,1
2451,2022/12/25,50,30,6,0,56
2475,2022/12/25,5,0,3,0,8
2476,2022/12/25,4,0,6,0,10
2507,2022/12/25,3,12,12,1,15
2525,2022/12/25,11,0,8,0,19
2562,2022/12/25,16,6,3,0,19
2582,2022/12/25,4,4,1,0,5
2586,2022/12/25,40,16,5,5,45
2602,2022/12/25,10,0,1,0,11
2631,2022/12/25,9,0,1,3,10
2685,2022/12/25,24,8,1,5,25
2723,2022/12/25,13,0,0,0,13
2730,2022/12/25,5,0,4,0,9
2731,2022/12/25,15,6,7,0,22
2732,2022/12/25,8,0,0,0,8
2734,2022/12/25,6,0,0,0,6
2735,2022/12/25,9,0,2,0,11
2761,2022/12/25,33,20,6,0,39
2788,2022/12/25,19,20,14,5,33
2802,2022/12/25,8,0,3,0,11
2812,2022/12/25,8,0,4,0,12
2813,2022/12/25,5,0,2,0,7
2814,2022/12/25,7,0,1,0,8
2913,2022/12/25,8,0,3,0,11
2914,2022/12/25,6,0,0,0,6
3015,2022/12/25,15,0,6,0,21
3033,2022/12/25,4,0,2,0,6
3035,2022/12/25,4,0,1,0,5
4446,2022/12/25,15,12,2,1,17
12136,2022/12/25,27,24,15,0,42
12516,2022/12/25,6,0,3,0,9
12518,2022/12/25,6,0,3,0,9
12523,2022/12/25,8,0,2,0,10
16062,2022/12/25,8,0,1,0,9
16276,2022/12/25,6,4,0,0,6
19322,2022/12/25,6,0,1,0,7
19329,2022/12/25,6,0,2,0,8
19520,2022/12/25,13,8,1,0,14
20901,2022/12/25,9,0,3,0,12
20920,2022/12/25,8,0,0,0,8
21097,2022/12/25,11,0,1,0,12
21099,2022/12/25,6,0,2,0,8
21102,2022/12/25,24,0,3,0,27
21132,2022/12/25,22,12,10,8,32
21171,2022/12/25,8,0,0,2,8
21174,2022/12/25,17,12,3,0,20
21175,2022/12/25,18,8,8,1,26
21176,2022/12/25,21,8,3,1,24
75,2022/12/26,81,36,24,5,105
76,2022/12/26,63,40,23,3,86
99,2022/12/26,10,0,4,0,14
117,2022/12/26,9,0,1,1,10
118,2022/12/26,3,0,0,0,3
119,2022/12/26,-2,0,0,0,-2
120,2022/12/26,8,4,1,0,9
149,2022/12/26,4,0,0,0,4
184,2022/12/26,21,9,16,0,37
195,2022/12/26,45,27,14,8,59
218,2022/12/26,43,30,15,5,58
296,2022/12/26,14,4,3,0,17
300,2022/12/26,4,4,2,0,6
304,2022/12/26,2,0,0,0,2
317,2022/12/26,2,0,1,0,3
343,2022/12/26,5,0,2,0,7
353,2022/12/26,7,0,1,0,8
373,2022/12/26,-1,6,0,3,-1
374,2022/12/26,5,0,1,0,6
388,2022/12/26,30,21,10,7,40
419,2022/12/26,3,0,4,0,7
420,2022/12/26,6,0,0,0,6
462,2022/12/26,10,8,7,0,17
519,2022/12/26,8,6,11,0,19
525,2022/12/26,5,5,0,0,5
596,2022/12/26,26,4,3,9,29
597,2022/12/26,34,0,12,0,46
598,2022/12/26,10,0,2,0,12
1035,2022/12/26,15,6,11,0,26
1084,2022/12/26,27,5,6,6,33
1111,2022/12/26,5,6,6,0,11
1112,2022/12/26,4,0,0,0,4
1113,2022/12/26,6,6,3,0,9
1114,2022/12/26,9,0,4,0,13
1115,2022/12/26,6,0,2,0,8
1117,2022/12/26,-5,0,2,0,-3
1118,2022/12/26,7,0,1,0,8
1119,2022/12/26,3,0,0,0,3
1692,2022/12/26,6,0,3,1,9
1693,2022/12/26,10,0,1,0,11
1747,2022/12/26,20,20,19,0,39
1772,2022/12/26,3,0,0,0,3
1773,2022/12/26,9,0,4,0,13
1774,2022/12/26,3,0,0,0,3
1782,2022/12/26,18,18,16,0,34
1795,2022/12/26,34,14,5,0,39
1914,2022/12/26,6,6,2,0,8
1915,2022/12/26,3,0,2,0,5
1923,2022/12/26,5,0,0,0,5
1934,2022/12/26,14,5,1,0,15
1963,2022/12/26,7,6,2,1,9
1984,2022/12/26,7,0,2,0,9
2135,2022/12/26,1,0,0,0,1
2136,2022/12/26,5,0,0,0,5
2148,2022/12/26,9,0,4,0,13
2183,2022/12/26,7,6,6,0,13
2193,2022/12/26,35,21,11,4,46
2237,2022/12/26,3,0,3,0,6
2358,2022/12/26,9,0,1,0,10
2361,2022/12/26,16,0,5,0,21
2445,2022/12/26,5,0,4,3,9
2449,2022/12/26,7,6,1,0,8
2451,2022/12/26,44,0,7,0,51
2475,2022/12/26,2,0,1,0,3
2476,2022/12/26,3,6,3,0,6
2507,2022/12/26,2,12,6,0,8
2525,2022/12/26,3,0,1,0,4
2562,2022/12/26,13,0,5,0,18
2582,2022/12/26,3,0,1,0,4
2586,2022/12/26,46,16,11,2,57
2602,2022/12/26,9,0,2,0,11
2631,2022/12/26,5,0,4,0,9
2685,2022/12/26,22,4,10,3,32
2723,2022/12/26,13,0,2,0,15
2730,2022/12/26,7,6,6,0,13
2731,2022/12/26,8,0,3,0,11
2732,2022/12/26,8,0,1,0,9
2734,2022/12/26,6,0,0,0,6
2735,2022/12/26,7,0,3,0,10
2761,2022/12/26,32,5,14,3,46
2788,2022/12/26,20,20,7,7,27
2802,2022/12/26,5,0,0,0,5
2812,2022/12/26,4,0,0,0,4
2813,2022/12/26,3,0,0,0,3
2814,2022/12/26,6,0,1,0,7
2913,2022/12/26,5,0,0,0,5
2914,2022/12/26,6,0,0,0,6
3015,2022/12/26,9,0,2,0,11
3033,2022/12/26,2,0,1,0,3
3035,2022/12/26,3,0,0,0,3
4446,2022/12/26,24,12,11,0,35
12136,2022/12/26,42,30,15,5,57
12516,2022/12/26,3,0,0,0,3
12518,2022/12/26,3,0,1,0,4
12523,2022/12/26,6,0,2,0,8
16062,2022/12/26,7,0,1,0,8
16276,2022/12/26,6,0,0,0,6
19322,2022/12/26,5,0,0,0,5
19329,2022/12/26,4,0,2,0,6
19520,2022/12/26,12,0,1,0,13
20901,2022/12/26,6,0,2,0,8
20920,2022/12/26,8,0,1,0,9
21097,2022/12/26,10,0,0,0,10
21099,2022/12/26,4,0,0,0,4
21102,2022/12/26,21,0,0,0,21
21103,2022/12/26,10,10,1,0,11
21132,2022/12/26,25,21,12,4,37
21171,2022/12/26,10,4,2,0,12
21174,2022/12/26,22,8,13,1,35
21175,2022/12/26,17,8,7,2,24
21176,2022/12/26,17,0,6,2,23
75,2022/12/27,76,24,24,8,100
76,2022/12/27,73,36,32,7,105
99,2022/12/27,6,0,1,0,7
117,2022/12/27,7,0,3,0,10
118,2022/12/27,7,4,2,0,9
119,2022/12/27,2,4,0,0,2
120,2022/12/27,7,0,1,0,8
149,2022/12/27,4,0,0,1,4
184,2022/12/27,20,15,11,0,31
195,2022/12/27,50,27,25,13,75
218,2022/12/27,50,27,29,5,79
296,2022/12/27,15,4,5,0,20
300,2022/12/27,6,4,3,0,9
304,2022/12/27,2,0,0,0,2
317,2022/12/27,7,6,0,0,7
343,2022/12/27,3,0,2,0,5
353,2022/12/27,6,0,0,0,6
373,2022/12/27,2,6,2,0,4
374,2022/12/27,4,0,1,0,5
388,2022/12/27,31,18,19,5,50
419,2022/12/27,5,6,2,2,7
420,2022/12/27,6,0,0,0,6
462,2022/12/27,11,8,9,0,20
519,2022/12/27,3,6,3,0,6
525,2022/12/27,5,0,3,0,8
596,2022/12/27,18,4,8,4,26
597,2022/12/27,34,12,10,16,44
598,2022/12/27,8,0,0,1,8
1035,2022/12/27,10,6,7,0,17
1084,2022/12/27,25,10,13,11,38
1111,2022/12/27,5,6,2,0,7
1112,2022/12/27,10,6,0,0,10
1113,2022/12/27,3,0,0,0,3
1114,2022/12/27,17,12,7,0,24
1115,2022/12/27,10,6,4,0,14
1117,2022/12/27,-7,0,0,0,-7
1118,2022/12/27,12,6,2,0,14
1119,2022/12/27,3,0,0,0,3
1692,2022/12/27,2,0,0,0,2
1693,2022/12/27,9,0,5,0,14
1747,2022/12/27,21,20,23,0,44
1772,2022/12/27,3,0,0,0,3
1773,2022/12/27,5,0,0,0,5
1774,2022/12/27,3,0,0,0,3
1782,2022/12/27,23,21,29,0,52
1795,2022/12/27,43,14,15,0,58
1914,2022/12/27,4,0,1,0,5
1915,2022/12/27,7,6,1,0,8
1923,2022/12/27,11,6,3,0,14
1934,2022/12/27,13,0,0,9,13
1963,2022/12/27,10,6,4,0,14
1984,2022/12/27,11,6,5,0,16
2135,2022/12/27,1,0,0,0,1
2136,2022/12/27,5,0,1,0,6
2148,2022/12/27,9,4,2,0,11
2183,2022/12/27,1,0,1,0,2
2193,2022/12/27,35,15,10,13,45
2237,2022/12/27,6,6,1,0,7
2358,2022/12/27,12,4,5,0,17
2361,2022/12/27,11,0,1,7,12
2445,2022/12/27,-2,0,0,0,-2
2449,2022/12/27,12,6,2,0,14
2451,2022/12/27,37,0,8,0,45
2475,2022/12/27,7,6,1,0,8
2476,2022/12/27,0,0,0,0,0
2507,2022/12/27,8,12,9,0,17
2525,2022/12/27,2,0,2,0,4
2562,2022/12/27,8,0,2,0,10
2582,2022/12/27,6,4,3,0,9
2586,2022/12/27,33,0,10,1,43
2602,2022/12/27,15,8,2,0,17
2631,2022/12/27,1,0,1,0,2
2685,2022/12/27,13,4,6,3,19
2723,2022/12/27,11,0,1,0,12
2730,2022/12/27,7,6,2,0,9
2731,2022/12/27,5,0,4,0,9
2732,2022/12/27,7,0,2,0,9
2734,2022/12/27,10,4,1,0,11
2735,2022/12/27,8,4,1,0,9
2761,2022/12/27,35,20,10,0,45
2788,2022/12/27,26,20,16,8,42
2802,2022/12/27,5,0,1,0,6
2812,2022/12/27,4,0,0,0,4
2813,2022/12/27,3,0,0,0,3
2814,2022/12/27,11,6,3,0,14
2913,2022/12/27,5,0,0,0,5
2914,2022/12/27,12,6,0,0,12
3015,2022/12/27,7,0,3,0,10
3033,2022/12/27,1,0,0,0,1
3035,2022/12/27,3,0,0,0,3
4446,2022/12/27,25,12,12,0,37
12136,2022/12/27,49,27,23,12,72
12516,2022/12/27,7,4,4,0,11
12518,2022/12/27,2,0,0,0,2
12523,2022/12/27,8,4,2,0,10
16062,2022/12/27,12,6,3,0,15
16276,2022/12/27,10,4,0,0,10
19322,2022/12/27,5,0,1,0,6
19329,2022/12/27,2,0,0,0,2
19520,2022/12/27,11,0,1,0,12
20901,2022/12/27,4,0,0,0,4
20920,2022/12/27,7,0,2,0,9
21097,2022/12/27,10,0,0,0,10
21099,2022/12/27,4,0,0,0,4
21102,2022/12/27,21,0,0,0,21
21103,2022/12/27,9,0,0,0,9
21132,2022/12/27,21,12,14,9,35
21171,2022/12/27,8,0,6,0,14
21174,2022/12/27,8,0,4,0,12
21175,2022/12/27,16,8,10,0,26
21176,2022/12/27,9,0,4,0,13
75,2022/12/28,33,8,21,11,54
76,2022/12/28,45,24,38,8,83
99,2022/12/28,5,0,0,0,5
117,2022/12/28,4,0,2,0,6
118,2022/12/28,5,0,0,0,5
119,2022/12/28,2,0,4,0,6
120,2022/12/28,6,0,1,0,7
149,2022/12/28,9,6,0,0,9
184,2022/12/28,18,9,5,0,23
195,2022/12/28,35,24,24,2,59
218,2022/12/28,26,21,29,4,55
296,2022/12/28,10,0,3,1,13
300,2022/12/28,7,4,1,0,8
304,2022/12/28,6,4,2,0,8
317,2022/12/28,7,0,5,0,12
343,2022/12/28,1,0,0,0,1
353,2022/12/28,6,0,0,0,6
373,2022/12/28,0,0,3,0,3
374,2022/12/28,7,4,2,0,9
388,2022/12/28,29,24,17,0,46
419,2022/12/28,1,0,4,0,5
462,2022/12/28,10,8,6,0,16
519,2022/12/28,6,6,6,0,12
525,2022/12/28,2,0,0,0,2
596,2022/12/28,6,0,3,0,9
597,2022/12/28,19,12,4,0,23
598,2022/12/28,7,0,1,4,8
1035,2022/12/28,2,0,1,0,3
1084,2022/12/28,11,10,7,0,18
1111,2022/12/28,9,6,1,0,10
1112,2022/12/28,10,0,0,0,10
1113,2022/12/28,9,6,2,0,11
1114,2022/12/28,16,6,2,0,18
1115,2022/12/28,12,6,0,0,12
1118,2022/12/28,16,6,2,0,18
1119,2022/12/28,3,0,0,0,3
1692,2022/12/28,2,0,0,0,2
1693,2022/12/28,4,0,0,0,4
1747,2022/12/28,18,20,16,3,34
1772,2022/12/28,3,0,0,0,3
1773,2022/12/28,11,6,3,0,14
1774,2022/12/28,11,8,1,0,12
1782,2022/12/28,18,24,12,1,30
1795,2022/12/28,38,14,11,8,49
1914,2022/12/28,9,6,0,0,9
1915,2022/12/28,12,6,1,0,13
1923,2022/12/28,14,6,1,0,15
1934,2022/12/28,4,0,0,4,4
1963,2022/12/28,6,0,0,0,6
1984,2022/12/28,3,0,3,0,6
2135,2022/12/28,1,0,0,0,1
2136,2022/12/28,10,6,1,0,11
2148,2022/12/28,7,0,1,0,8
2183,2022/12/28,5,6,2,0,7
2193,2022/12/28,18,12,12,9,30
2237,2022/12/28,11,6,1,0,12
2358,2022/12/28,7,0,3,0,10
2361,2022/12/28,3,0,3,0,6
2445,2022/12/28,6,6,7,0,13
2449,2022/12/28,10,0,1,0,11
2451,2022/12/28,29,0,7,0,36
2475,2022/12/28,12,6,1,0,13
2476,2022/12/28,6,6,2,0,8
2507,2022/12/28,17,18,9,0,26
2525,2022/12/28,6,6,1,0,7
2562,2022/12/28,6,0,3,0,9
2582,2022/12/28,7,4,3,0,10
2586,2022/12/28,22,0,6,4,28
2602,2022/12/28,13,0,0,0,13
2631,2022/12/28,6,6,1,0,7
2685,2022/12/28,4,0,2,1,6
2723,2022/12/28,10,0,1,0,11
2730,2022/12/28,11,6,3,0,14
2731,2022/12/28,7,6,0,0,7
2732,2022/12/28,5,0,1,0,6
2734,2022/12/28,9,0,3,0,12
2735,2022/12/28,7,0,3,0,10
2761,2022/12/28,35,10,13,1,48
2788,2022/12/28,32,20,7,0,39
2802,2022/12/28,10,6,0,0,10
2812,2022/12/28,10,6,1,0,11
2813,2022/12/28,3,0,0,0,3
2814,2022/12/28,8,0,0,0,8
2913,2022/12/28,0,0,0,0,0
2914,2022/12/28,12,0,2,0,14
3015,2022/12/28,12,8,4,0,16
3033,2022/12/28,1,0,0,0,1
3035,2022/12/28,3,0,0,0,3
4446,2022/12/28,25,12,11,4,36
12136,2022/12/28,44,27,25,13,69
12516,2022/12/28,3,0,0,2,3
12518,2022/12/28,6,4,2,0,8
12523,2022/12/28,10,4,5,0,15
16062,2022/12/28,9,0,1,0,10
16276,2022/12/28,10,0,0,0,10
19322,2022/12/28,4,0,0,0,4
19329,2022/12/28,2,0,0,0,2
19520,2022/12/28,10,0,0,0,10
20901,2022/12/28,4,0,1,0,5
20920,2022/12/28,5,0,0,0,5
21097,2022/12/28,10,0,1,0,11
21099,2022/12/28,10,6,0,0,10
21102,2022/12/28,21,0,0,0,21
21103,2022/12/28,9,0,5,0,14
21132,2022/12/28,8,6,7,1,15
21171,2022/12/28,6,4,3,1,9
21174,2022/12/28,16,12,14,0,30
21175,2022/12/28,6,4,10,1,16
21176,2022/12/28,9,4,7,0,16
75,2022/12/29,21,20,20,0,41
76,2022/12/29,35,36,22,0,57
99,2022/12/29,17,12,0,0,17
117,2022/12/29,2,0,0,0,2
118,2022/12/29,9,4,0,0,9
119,2022/12/29,3,4,1,0,4
120,2022/12/29,1,0,0,0,1
149,2022/12/29,9,0,0,0,9
184,2022/12/29,31,18,19,0,50
195,2022/12/29,33,24,30,3,63
218,2022/12/29,20,27,24,0,44
296,2022/12/29,6,0,7,0,13
300,2022/12/29,10,4,1,0,11
304,2022/12/29,6,4,2,0,8
317,2022/12/29,8,6,1,0,9
343,2022/12/29,1,0,1,0,2
353,2022/12/29,12,6,1,0,13
373,2022/12/29,3,6,2,0,5
374,2022/12/29,9,4,1,0,10
388,2022/12/29,36,24,17,5,53
419,2022/12/29,3,6,5,0,8
462,2022/12/29,12,8,8,0,20
519,2022/12/29,6,6,5,0,11
525,2022/12/29,2,0,1,0,3
596,2022/12/29,7,4,4,1,11
597,2022/12/29,27,12,16,2,43
598,2022/12/29,2,0,2,0,4
1035,2022/12/29,1,0,1,0,2
1084,2022/12/29,14,10,13,0,27
1111,2022/12/29,14,6,0,0,14
1112,2022/12/29,10,0,0,0,10
1113,2022/12/29,13,6,0,0,13
1114,2022/12/29,20,6,6,0,26
1115,2022/12/29,12,0,1,0,13
1118,2022/12/29,14,0,3,0,17
1119,2022/12/29,3,0,0,0,3
1692,2022/12/29,8,6,1,0,9
1693,2022/12/29,4,0,0,0,4
1747,2022/12/29,24,25,25,2,49
1772,2022/12/29,3,0,0,0,3
1773,2022/12/29,8,0,1,0,9
1774,2022/12/29,10,0,3,0,13
1782,2022/12/29,29,24,20,8,49
1795,2022/12/29,26,7,14,3,40
1914,2022/12/29,9,0,0,0,9
1915,2022/12/29,11,0,1,0,12
1923,2022/12/29,13,0,1,0,14
1934,2022/12/29,0,0,4,0,4
1963,2022/12/29,6,0,6,0,12
1984,2022/12/29,0,0,0,0,0
2135,2022/12/29,1,0,0,0,1
2136,2022/12/29,9,0,1,0,10
2148,2022/12/29,6,0,2,0,8
2183,2022/12/29,9,6,4,0,13
2193,2022/12/29,12,15,14,2,26
2237,2022/12/29,10,0,0,0,10
2358,2022/12/29,4,4,4,0,8
2361,2022/12/29,7,7,2,0,9
2445,2022/12/29,5,6,2,0,7
2449,2022/12/29,9,0,3,0,12
2451,2022/12/29,32,10,11,0,43
2475,2022/12/29,11,0,0,0,11
2476,2022/12/29,10,6,2,0,12
2507,2022/12/29,26,18,21,0,47
2525,2022/12/29,5,0,3,0,8
2562,2022/12/29,3,0,0,0,3
2582,2022/12/29,8,4,4,0,12
2586,2022/12/29,24,12,8,1,32
2602,2022/12/29,13,0,2,0,15
2631,2022/12/29,5,0,4,0,9
2685,2022/12/29,5,4,2,1,7
2723,2022/12/29,9,0,1,0,10
2730,2022/12/29,8,0,1,0,9
2731,2022/12/29,7,0,3,0,10
2732,2022/12/29,4,0,0,0,4
2734,2022/12/29,6,0,0,0,6
2735,2022/12/29,4,0,4,0,8
2761,2022/12/29,36,15,16,0,52
2788,2022/12/29,49,24,13,12,62
2802,2022/12/29,10,0,0,0,10
2812,2022/12/29,9,0,0,0,9
2813,2022/12/29,3,0,0,0,3
2814,2022/12/29,8,0,1,0,9
2913,2022/12/29,6,6,1,0,7
2914,2022/12/29,10,0,0,0,10
3015,2022/12/29,8,0,2,0,10
3033,2022/12/29,1,0,0,0,1
3035,2022/12/29,3,0,0,0,3
4446,2022/12/29,22,12,8,0,30
12136,2022/12/29,30,24,27,5,57
12516,2022/12/29,5,4,2,0,7
12518,2022/12/29,8,4,2,0,10
12523,2022/12/29,5,0,1,0,6
16062,2022/12/29,8,0,0,0,8
16276,2022/12/29,10,0,1,0,11
19322,2022/12/29,4,0,0,0,4
19329,2022/12/29,2,0,0,0,2
19520,2022/12/29,10,0,1,0,11
20901,2022/12/29,3,0,0,0,3
20920,2022/12/29,5,0,0,0,5
21097,2022/12/29,9,0,0,0,9
21099,2022/12/29,10,0,0,0,10
21102,2022/12/29,21,0,0,0,21
21103,2022/12/29,4,0,0,0,4
21132,2022/12/29,18,18,13,0,31
21171,2022/12/29,2,0,1,0,3
21174,2022/12/29,14,12,8,0,22
21175,2022/12/29,3,8,10,0,13
21176,2022/12/29,6,4,1,0,7
75,2022/12/30,21,20,21,0,42
76,2022/12/30,41,28,33,7,74
99,2022/12/30,17,0,0,0,17
117,2022/12/30,2,0,2,0,4
118,2022/12/30,9,0,1,0,10
119,2022/12/30,6,4,1,0,7
120,2022/12/30,1,0,0,0,1
149,2022/12/30,9,0,0,0,9
184,2022/12/30,36,24,22,0,58
195,2022/12/30,18,18,18,0,36
218,2022/12/30,17,21,23,0,40
296,2022/12/30,-1,0,1,0,0
300,2022/12/30,13,4,1,0,14
304,2022/12/30,4,0,2,0,6
317,2022/12/30,7,0,2,0,9
343,2022/12/30,4,4,1,0,5
353,2022/12/30,11,0,0,0,11
373,2022/12/30,1,0,3,0,4
374,2022/12/30,8,0,1,0,9
388,2022/12/30,38,24,29,0,67
419,2022/12/30,-2,0,1,0,-1
462,2022/12/30,4,0,5,0,9
519,2022/12/30,19,18,5,0,24
525,2022/12/30,1,0,0,0,1
596,2022/12/30,6,4,3,0,9
597,2022/12/30,27,18,16,0,43
598,2022/12/30,0,0,0,0,0
1035,2022/12/30,6,6,2,0,8
1084,2022/12/30,21,20,8,0,29
1111,2022/12/30,14,0,2,0,16
1112,2022/12/30,10,0,1,0,11
1113,2022/12/30,13,0,2,0,15
1114,2022/12/30,32,18,6,0,38
1115,2022/12/30,11,0,0,0,11
1118,2022/12/30,11,0,1,0,12
1119,2022/12/30,3,0,0,0,3
1692,2022/12/30,7,0,0,0,7
1693,2022/12/30,4,0,0,0,4
1747,2022/12/30,22,25,22,0,44
1772,2022/12/30,3,0,0,0,3
1773,2022/12/30,7,0,0,0,7
1774,2022/12/30,7,0,1,0,8
1782,2022/12/30,22,21,19,0,41
1795,2022/12/30,23,14,19,0,42
1914,2022/12/30,9,0,0,0,9
1915,2022/12/30,10,0,1,0,11
1923,2022/12/30,12,0,1,0,13
1934,2022/12/30,-4,0,1,0,-3
1963,2022/12/30,6,6,3,0,9
1984,2022/12/30,0,0,0,0,0
2135,2022/12/30,1,0,0,0,1
2136,2022/12/30,8,0,0,0,8
2148,2022/12/30,4,0,0,0,4
2183,2022/12/30,5,0,2,0,7
2193,2022/12/30,8,12,12,0,20
2237,2022/12/30,16,6,7,0,23
2358,2022/12/30,0,0,0,0,0
2361,2022/12/30,12,7,5,1,17
2445,2022/12/30,3,0,3,0,6
2449,2022/12/30,12,6,4,0,16
2451,2022/12/30,21,0,4,2,25
2475,2022/12/30,11,0,2,0,13
2476,2022/12/30,8,0,0,0,8
2507,2022/12/30,23,18,21,0,44
2525,2022/12/30,2,0,2,0,4
2562,2022/12/30,9,6,1,0,10
2582,2022/12/30,4,0,1,0,5
2586,2022/12/30,27,12,16,0,43
2602,2022/12/30,11,0,1,0,12
2631,2022/12/30,1,0,1,0,2
2685,2022/12/30,10,8,3,0,13
2723,2022/12/30,8,0,0,0,8
2730,2022/12/30,7,0,3,0,10
2731,2022/12/30,10,6,1,0,11
2732,2022/12/30,4,0,2,0,6
2734,2022/12/30,6,0,0,0,6
2735,2022/12/30,4,4,1,0,5
2761,2022/12/30,35,15,13,0,48
2788,2022/12/30,40,16,15,9,55
2802,2022/12/30,10,0,0,0,10
2812,2022/12/30,9,0,1,0,10
2813,2022/12/30,9,6,2,0,11
2814,2022/12/30,7,0,2,0,9
2913,2022/12/30,5,0,0,0,5
2914,2022/12/30,10,0,1,0,11
3015,2022/12/30,6,0,2,0,8
3033,2022/12/30,1,0,1,0,2
3035,2022/12/30,3,0,0,0,3
4446,2022/12/30,20,6,15,0,35
12136,2022/12/30,19,21,21,0,40
12516,2022/12/30,3,0,0,0,3
12518,2022/12/30,10,4,1,0,11
12523,2022/12/30,4,0,1,0,5
16062,2022/12/30,8,0,2,0,10
16276,2022/12/30,9,0,0,0,9
19322,2022/12/30,10,6,0,0,10
19329,2022/12/30,2,0,0,0,2
19520,2022/12/30,9,0,2,0,11
20901,2022/12/30,3,0,0,0,3
20920,2022/12/30,5,0,0,0,5
21099,2022/12/30,10,0,0,0,10
21102,2022/12/30,21,0,0,0,21
21103,2022/12/30,4,0,1,0,5
21132,2022/12/30,17,12,14,4,31
21171,2022/12/30,1,0,0,0,1
21174,2022/12/30,22,16,14,0,36
21175,2022/12/30,1,8,10,2,11
21176,2022/12/30,9,4,2,0,11
75,2022/12/31,24,24,39,0,63
76,2022/12/31,29,28,30,1,59
99,2022/12/31,17,0,0,0,17
117,2022/12/31,4,4,1,0,5
118,2022/12/31,12,4,1,0,13
119,2022/12/31,5,0,3,0,8
120,2022/12/31,1,0,1,0,2
149,2022/12/31,9,0,1,0,10
184,2022/12/31,23,9,12,0,35
195,2022/12/31,9,9,12,0,21
218,2022/12/31,15,21,21,0,36
296,2022/12/31,2,4,3,0,5
300,2022/12/31,20,8,4,0,24
304,2022/12/31,2,0,2,0,4
317,2022/12/31,5,0,0,0,5
343,2022/12/31,7,4,1,0,8
353,2022/12/31,11,0,0,0,11
373,2022/12/31,4,6,0,2,4
374,2022/12/31,11,4,5,0,16
388,2022/12/31,24,15,21,0,45
419,2022/12/31,3,6,1,0,4
462,2022/12/31,15,16,8,0,23
519,2022/12/31,32,18,14,1,46
525,2022/12/31,6,5,1,0,7
596,2022/12/31,3,0,3,0,6
597,2022/12/31,11,0,18,4,29
598,2022/12/31,0,0,0,0,0
1035,2022/12/31,16,12,9,0,25
1084,2022/12/31,13,0,12,0,25
1111,2022/12/31,12,0,3,0,15
1112,2022/12/31,9,0,0,0,9
1113,2022/12/31,11,0,1,0,12
1114,2022/12/31,26,0,9,0,35
1115,2022/12/31,17,6,1,0,18
1118,2022/12/31,10,0,4,0,14
1119,2022/12/31,3,0,0,0,3
1692,2022/12/31,7,0,3,0,10
1693,2022/12/31,4,0,0,0,4
1747,2022/12/31,10,10,22,3,32
1772,2022/12/31,3,0,0,0,3
1773,2022/12/31,7,0,0,0,7
1774,2022/12/31,6,0,0,0,6
1782,2022/12/31,15,12,21,1,36
1795,2022/12/31,25,21,26,0,51
1914,2022/12/31,9,0,5,0,14
1915,2022/12/31,9,0,5,0,14
1923,2022/12/31,11,0,3,0,14
1934,2022/12/31,0,5,2,0,2
1963,2022/12/31,9,6,1,0,10
1984,2022/12/31,6,6,4,0,10
2135,2022/12/31,13,12,6,0,19
2136,2022/12/31,8,0,1,0,9
2148,2022/12/31,8,4,3,0,11
2183,2022/12/31,9,6,9,0,18
2193,2022/12/31,8,12,12,0,20
2237,2022/12/31,9,0,4,0,13
2358,2022/12/31,0,0,0,0,0
2361,2022/12/31,13,7,7,0,20
2445,2022/12/31,18,18,14,0,32
2449,2022/12/31,8,0,0,0,8
2451,2022/12/31,15,0,6,0,21
2475,2022/12/31,9,0,1,0,10
2476,2022/12/31,8,0,3,0,11
2507,2022/12/31,14,12,19,3,33
2525,2022/12/31,6,6,0,0,6
2562,2022/12/31,8,0,0,0,8
2582,2022/12/31,7,4,0,0,7
2586,2022/12/31,15,4,6,0,21
2602,2022/12/31,10,0,0,0,10
2631,2022/12/31,12,12,6,0,18
2685,2022/12/31,11,4,11,0,22
2723,2022/12/31,8,0,1,0,9
2730,2022/12/31,10,6,1,0,11
2731,2022/12/31,9,0,3,0,12
2732,2022/12/31,10,8,2,0,12
2734,2022/12/31,6,0,0,0,6
2735,2022/12/31,7,4,1,0,8
2761,2022/12/31,22,0,18,3,40
2788,2022/12/31,24,8,17,0,41
2802,2022/12/31,10,0,0,0,10
2812,2022/12/31,8,0,1,0,9
2813,2022/12/31,7,0,0,0,7
2814,2022/12/31,5,0,1,0,6
2913,2022/12/31,11,6,3,0,14
2914,2022/12/31,9,0,1,0,10
3015,2022/12/31,4,0,3,0,7
3033,2022/12/31,0,0,0,0,0
3035,2022/12/31,9,6,2,0,11
4446,2022/12/31,11,6,7,0,18
12136,2022/12/31,7,9,9,0,16
12516,2022/12/31,7,4,2,0,9
12518,2022/12/31,9,0,4,0,13
12523,2022/12/31,7,4,1,0,8
16062,2022/12/31,6,0,0,0,6
16276,2022/12/31,9,0,0,0,9
19322,2022/12/31,10,0,1,0,11
19329,2022/12/31,2,0,1,0,3
19520,2022/12/31,7,0,2,0,9
20901,2022/12/31,3,0,0,0,3
20920,2022/12/31,5,0,1,0,6
21099,2022/12/31,10,0,0,0,10
21102,2022/12/31,21,0,1,0,22
21103,2022/12/31,3,0,0,0,3
21132,2022/12/31,11,12,10,1,21
21171,2022/12/31,1,0,0,0,1
21174,2022/12/31,16,8,11,0,27
21175,2022/12/31,-3,8,8,0,5
21176,2022/12/31,11,4,6,0,17
75,2023/01/01,5,20,5,0,10
76,2023/01/01,22,24,23,0,45
99,2023/01/01,17,0,0,0,17
117,2023/01/01,3,0,2,0,5
118,2023/01/01,11,0,4,0,15
119,2023/01/01,6,4,2,0,8
120,2023/01/01,4,4,1,0,5
149,2023/01/01,8,0,0,0,8
184,2023/01/01,14,3,5,0,19
195,2023/01/01,9,12,9,0,18
218,2023/01/01,18,24,37,0,55
296,2023/01/01,3,4,2,0,5
300,2023/01/01,20,4,4,0,24
304,2023/01/01,4,4,4,0,8
317,2023/01/01,11,6,1,0,12
343,2023/01/01,6,0,6,0,12
353,2023/01/01,11,0,0,0,11
373,2023/01/01,8,6,1,2,9
374,2023/01/01,14,8,1,1,15
388,2023/01/01,15,12,5,0,20
419,2023/01/01,8,6,2,0,10
420,2023/01/01,12,6,3,0,15
462,2023/01/01,15,8,6,0,21
519,2023/01/01,35,18,9,0,44
525,2023/01/01,5,0,2,0,7
596,2023/01/01,4,4,4,0,8
597,2023/01/01,1,12,9,0,10
598,2023/01/01,6,6,1,0,7
1035,2023/01/01,13,6,7,0,20
1084,2023/01/01,11,10,11,0,22
1111,2023/01/01,15,6,4,0,19
1112,2023/01/01,9,0,2,0,11
1113,2023/01/01,10,0,2,0,12
1114,2023/01/01,23,6,10,0,33
1115,2023/01/01,22,6,5,0,27
1117,2023/01/01,-7,0,0,0,-7
1118,2023/01/01,6,0,4,0,10
1119,2023/01/01,3,0,1,0,4
1692,2023/01/01,10,6,1,0,11
1693,2023/01/01,10,6,3,0,13
1747,2023/01/01,-5,10,10,0,5
1772,2023/01/01,11,8,2,0,13
1773,2023/01/01,13,6,4,0,17
1774,2023/01/01,6,0,0,0,6
1782,2023/01/01,8,15,15,0,23
1795,2023/01/01,-1,0,0,0,-1
1914,2023/01/01,10,6,5,0,15
1915,2023/01/01,4,0,2,0,6
1923,2023/01/01,8,0,2,0,10
1934,2023/01/01,-2,0,3,0,1
1963,2023/01/01,8,0,2,0,10
1984,2023/01/01,8,6,2,0,10
2135,2023/01/01,13,6,5,0,18
2136,2023/01/01,7,0,3,0,10
2148,2023/01/01,9,4,2,0,11
2183,2023/01/01,6,6,6,0,12
2193,2023/01/01,5,9,11,0,16
2237,2023/01/01,11,6,1,0,12
2358,2023/01/01,8,8,5,0,13
2361,2023/01/01,13,7,8,0,21
2445,2023/01/01,16,12,5,0,21
2449,2023/01/01,8,0,2,0,10
2451,2023/01/01,44,35,21,0,65
2475,2023/01/01,14,6,2,0,16
2476,2023/01/01,11,6,3,0,14
2507,2023/01/01,-2,6,6,0,4
2525,2023/01/01,12,6,2,0,14
2562,2023/01/01,14,6,1,0,15
2582,2023/01/01,11,4,2,0,13
2586,2023/01/01,13,4,5,0,18
2602,2023/01/01,10,0,1,0,11
2631,2023/01/01,6,0,3,0,9
2685,2023/01/01,8,8,8,0,16
2723,2023/01/01,7,0,6,0,13
2730,2023/01/01,15,6,7,0,22
2731,2023/01/01,12,6,7,0,19
2732,2023/01/01,8,0,7,0,15
2734,2023/01/01,10,4,2,0,12
2735,2023/01/01,10,4,3,0,13
2761,2023/01/01,11,10,9,0,20
2788,2023/01/01,15,8,7,0,22
2802,2023/01/01,10,0,0,0,10
2812,2023/01/01,7,0,1,0,8
2813,2023/01/01,7,0,1,0,8
2814,2023/01/01,4,0,0,0,4
2913,2023/01/01,8,0,7,0,15
2914,2023/01/01,8,0,1,0,9
3015,2023/01/01,9,8,8,0,17
3033,2023/01/01,0,0,0,0,0
3035,2023/01/01,7,0,3,0,10
4446,2023/01/01,16,12,14,0,30
12136,2023/01/01,19,21,16,0,35
12516,2023/01/01,9,4,1,0,10
12518,2023/01/01,5,0,0,0,5
12523,2023/01/01,14,8,4,0,18
16062,2023/01/01,6,0,0,0,6
16276,2023/01/01,9,0,1,0,10
19322,2023/01/01,9,0,3,0,12
19329,2023/01/01,1,0,0,0,1
19520,2023/01/01,5,0,2,0,7
20901,2023/01/01,9,6,1,0,10
20920,2023/01/01,4,0,1,0,5
21099,2023/01/01,10,0,1,0,11
21102,2023/01/01,20,0,1,0,21
21103,2023/01/01,3,0,1,0,4
21132,2023/01/01,12,12,13,0,25
21171,2023/01/01,5,4,2,0,7
21174,2023/01/01,13,8,9,0,22
21175,2023/01/01,-3,8,8,0,5
21176,2023/01/01,13,8,8,0,21
75,2023/01/02,24,24,23,0,47
76,2023/01/02,31,32,23,0,54
99,2023/01/02,17,0,0,0,17
117,2023/01/02,5,4,1,0,6
118,2023/01/02,7,0,1,0,8
119,2023/01/02,4,0,2,0,6
120,2023/01/02,3,0,1,0,4
149,2023/01/02,8,0,0,0,8
184,2023/01/02,24,15,10,0,34
195,2023/01/02,27,27,18,7,45
218,2023/01/02,8,27,21,0,29
296,2023/01/02,5,4,5,0,10
300,2023/01/02,16,0,3,0,19
304,2023/01/02,0,0,0,0,0
317,2023/01/02,10,0,1,0,11
343,2023/01/02,0,0,0,0,0
353,2023/01/02,11,0,0,0,11
373,2023/01/02,5,0,2,3,7
374,2023/01/02,12,0,2,0,14
388,2023/01/02,25,15,15,0,40
419,2023/01/02,6,0,3,0,9
420,2023/01/02,9,0,0,0,9
462,2023/01/02,17,8,10,0,27
519,2023/01/02,38,12,2,0,40
525,2023/01/02,3,0,2,0,5
596,2023/01/02,8,8,8,0,16
597,2023/01/02,4,12,10,0,14
598,2023/01/02,5,0,1,0,6
1035,2023/01/02,18,12,10,0,28
1084,2023/01/02,15,15,15,0,30
1111,2023/01/02,11,0,1,0,12
1112,2023/01/02,7,0,0,0,7
1113,2023/01/02,8,0,2,0,10
1114,2023/01/02,13,0,6,0,19
1115,2023/01/02,17,0,3,0,20
1117,2023/01/02,-7,0,0,0,-7
1118,2023/01/02,2,0,0,0,2
1119,2023/01/02,2,0,1,0,3
1692,2023/01/02,9,0,1,0,10
1693,2023/01/02,7,0,0,0,7
1747,2023/01/02,10,25,25,0,35
1772,2023/01/02,9,0,2,0,11
1773,2023/01/02,9,0,3,0,12
1774,2023/01/02,14,8,1,0,15
1782,2023/01/02,11,18,17,0,28
1795,2023/01/02,-1,0,0,0,-1
1914,2023/01/02,5,0,3,0,8
1915,2023/01/02,2,0,0,0,2
1923,2023/01/02,6,0,0,0,6
1934,2023/01/02,0,5,4,0,4
1963,2023/01/02,6,0,3,1,9
1984,2023/01/02,6,0,1,0,7
2135,2023/01/02,8,0,7,0,15
2136,2023/01/02,4,0,1,0,5
2148,2023/01/02,7,0,0,0,7
2183,2023/01/02,6,6,5,0,11
2193,2023/01/02,9,15,13,0,22
2237,2023/01/02,10,0,2,0,12
2358,2023/01/02,3,0,3,0,6
2361,2023/01/02,5,0,1,0,6
2445,2023/01/02,17,6,2,0,19
2449,2023/01/02,6,0,1,4,7
2451,2023/01/02,23,0,7,0,30
2475,2023/01/02,12,0,3,0,15
2476,2023/01/02,8,0,3,0,11
2507,2023/01/02,10,18,10,0,20
2525,2023/01/02,10,0,0,0,10
2562,2023/01/02,13,0,4,1,17
2582,2023/01/02,9,0,0,0,9
2586,2023/01/02,16,8,7,0,23
2602,2023/01/02,9,0,2,0,11
2631,2023/01/02,9,6,5,0,14
2685,2023/01/02,8,8,6,0,14
2723,2023/01/02,1,0,1,0,2
2730,2023/01/02,8,0,3,0,11
2731,2023/01/02,11,6,4,0,15
2732,2023/01/02,1,0,0,0,1
2734,2023/01/02,8,0,2,0,10
2735,2023/01/02,7,0,3,1,10
2761,2023/01/02,17,15,12,0,29
2788,2023/01/02,20,12,11,0,31
2802,2023/01/02,10,0,2,0,12
2812,2023/01/02,6,0,2,0,8
2813,2023/01/02,6,0,2,0,8
2814,2023/01/02,4,0,3,0,7
2913,2023/01/02,1,0,1,0,2
2914,2023/01/02,7,0,1,0,8
3015,2023/01/02,1,0,0,0,1
3033,2023/01/02,0,0,0,0,0
3035,2023/01/02,4,0,1,0,5
4446,2023/01/02,11,9,7,0,18
12136,2023/01/02,27,24,23,0,50
12516,2023/01/02,8,0,1,0,9
12518,2023/01/02,9,4,2,0,11
12523,2023/01/02,10,0,2,0,12
16062,2023/01/02,12,6,5,0,17
16276,2023/01/02,8,0,0,0,8
19322,2023/01/02,6,0,2,0,8
19520,2023/01/02,3,0,0,0,3
20901,2023/01/02,8,0,2,0,10
20920,2023/01/02,3,0,0,0,3
21099,2023/01/02,9,0,0,0,9
21102,2023/01/02,19,0,0,0,19
21103,2023/01/02,12,10,1,0,13
21132,2023/01/02,14,15,11,0,25
21171,2023/01/02,7,4,3,0,10
21174,2023/01/02,16,12,6,0,22
21175,2023/01/02,5,16,9,0,14
21176,2023/01/02,13,8,5,0,18
75,2023/01/03,29,28,12,0,41
76,2023/01/03,48,40,24,10,72
99,2023/01/03,17,0,1,0,18
117,2023/01/03,4,0,1,0,5
118,2023/01/03,6,0,1,0,7
119,2023/01/03,6,4,0,0,6
120,2023/01/03,2,0,2,0,4
149,2023/01/03,8,0,1,0,9
184,2023/01/03,29,15,1,0,30
195,2023/01/03,32,30,17,4,49
218,2023/01/03,17,30,20,1,37
296,2023/01/03,8,8,4,0,12
300,2023/01/03,13,0,1,0,14
304,2023/01/03,4,4,4,0,8
317,2023/01/03,9,0,2,0,11
343,2023/01/03,4,4,2,0,6
353,2023/01/03,11,0,1,0,12
373,2023/01/03,6,6,1,0,7
374,2023/01/03,10,0,2,0,12
388,2023/01/03,34,24,12,0,46
419,2023/01/03,9,6,7,0,16
420,2023/01/03,9,0,1,0,10
462,2023/01/03,15,8,6,0,21
519,2023/01/03,36,0,12,0,48
525,2023/01/03,1,0,1,0,2
596,2023/01/03,4,4,2,0,6
597,2023/01/03,12,18,4,0,16
598,2023/01/03,4,0,3,0,7
1035,2023/01/03,8,0,4,0,12
1084,2023/01/03,10,10,6,0,16
1111,2023/01/03,10,0,2,0,12
1112,2023/01/03,7,0,0,0,7
1113,2023/01/03,6,0,0,0,6
1114,2023/01/03,7,0,2,0,9
1115,2023/01/03,14,0,1,0,15
1117,2023/01/03,-7,0,0,0,-7
1118,2023/01/03,8,6,1,0,9
1119,2023/01/03,1,0,0,0,1
1692,2023/01/03,8,0,5,0,13
1693,2023/01/03,7,0,1,0,8
1747,2023/01/03,10,25,11,0,21
1772,2023/01/03,7,0,2,0,9
1773,2023/01/03,6,0,0,0,6
1774,2023/01/03,13,0,3,0,16
1782,2023/01/03,21,27,17,0,38
1795,2023/01/03,13,14,8,0,21
1914,2023/01/03,8,6,0,0,8
1915,2023/01/03,8,6,5,0,13
1923,2023/01/03,12,6,0,0,12
1934,2023/01/03,1,5,1,0,2
1963,2023/01/03,8,6,5,0,13
1984,2023/01/03,11,6,0,0,11
2135,2023/01/03,7,6,1,0,8
2136,2023/01/03,3,0,1,0,4
2148,2023/01/03,11,4,3,0,14
2183,2023/01/03,1,0,1,0,2
2193,2023/01/03,11,15,10,0,21
2237,2023/01/03,8,0,2,0,10
2358,2023/01/03,8,8,0,0,8
2361,2023/01/03,11,7,1,0,12
2445,2023/01/03,15,0,1,0,16
2449,2023/01/03,7,6,4,0,11
2451,2023/01/03,16,0,5,0,21
2475,2023/01/03,9,0,1,0,10
2476,2023/01/03,11,6,0,0,11
2507,2023/01/03,12,12,6,0,18
2525,2023/01/03,16,6,1,0,17
2562,2023/01/03,14,6,5,0,19
2582,2023/01/03,13,4,3,0,16
2586,2023/01/03,21,12,9,0,30
2602,2023/01/03,7,0,0,0,7
2631,2023/01/03,4,0,1,0,5
2685,2023/01/03,6,4,2,0,8
2723,2023/01/03,8,8,1,0,9
2730,2023/01/03,11,6,2,0,13
2731,2023/01/03,7,0,1,0,8
2732,2023/01/03,1,0,0,0,1
2734,2023/01/03,6,0,0,0,6
2735,2023/01/03,7,4,1,0,8
2761,2023/01/03,20,15,18,0,38
2788,2023/01/03,21,12,1,0,22
2802,2023/01/03,8,0,0,0,8
2812,2023/01/03,4,0,0,0,4
2813,2023/01/03,4,0,0,0,4
2814,2023/01/03,1,0,0,0,1
2913,2023/01/03,0,0,0,0,0
2914,2023/01/03,6,0,1,0,7
3015,2023/01/03,9,8,3,0,12
3033,2023/01/03,0,0,0,0,0
3035,2023/01/03,3,0,0,0,3
4446,2023/01/03,19,15,5,0,24
12136,2023/01/03,31,27,10,0,41
12516,2023/01/03,7,0,4,0,11
12518,2023/01/03,7,0,4,0,11
12523,2023/01/03,8,0,1,0,9
16062,2023/01/03,7,0,1,0,8
16276,2023/01/03,8,0,0,0,8
19322,2023/01/03,4,0,1,0,5
19520,2023/01/03,3,0,0,0,3
20901,2023/01/03,6,0,0,0,6
20920,2023/01/03,15,12,1,0,16
21099,2023/01/03,9,0,1,0,10
21102,2023/01/03,19,0,0,0,19
21103,2023/01/03,11,0,0,0,11
21132,2023/01/03,21,18,15,1,36
21171,2023/01/03,4,0,1,0,5
21174,2023/01/03,22,12,11,0,33
21175,2023/01/03,8,12,6,0,14
21176,2023/01/03,8,0,3,0,11
75,2023/01/04,49,32,30,8,79
76,2023/01/04,54,40,32,13,86
99,2023/01/04,16,0,0,0,16
117,2023/01/04,7,4,0,0,7
118,2023/01/04,5,0,0,3,5
119,2023/01/04,6,0,1,0,7
120,2023/01/04,4,4,0,0,4
149,2023/01/04,7,0,0,0,7
184,2023/01/04,43,15,10,2,53
195,2023/01/04,41,30,29,5,70
218,2023/01/04,26,30,32,9,58
296,2023/01/04,12,8,5,0,17
300,2023/01/04,12,0,3,0,15
304,2023/01/04,4,4,1,0,5
317,2023/01/04,13,6,3,0,16
343,2023/01/04,2,0,2,0,4
353,2023/01/04,10,0,0,0,10
373,2023/01/04,11,6,4,0,15
374,2023/01/04,8,0,0,0,8
388,2023/01/04,43,21,15,8,58
419,2023/01/04,8,6,4,0,12
420,2023/01/04,8,0,1,0,9
462,2023/01/04,17,8,4,0,21
519,2023/01/04,24,0,6,1,30
525,2023/01/04,5,5,1,0,6
596,2023/01/04,10,8,3,0,13
597,2023/01/04,26,18,5,0,31
598,2023/01/04,7,6,1,0,8
1035,2023/01/04,10,6,1,0,11
1084,2023/01/04,14,10,8,0,22
1111,2023/01/04,8,0,1,0,9
1112,2023/01/04,7,0,1,0,8
1113,2023/01/04,6,0,1,0,7
1114,2023/01/04,17,12,5,0,22
1115,2023/01/04,13,0,0,0,13
1118,2023/01/04,13,6,2,0,15
1119,2023/01/04,1,0,0,0,1
1692,2023/01/04,9,6,2,0,11
1693,2023/01/04,6,0,1,0,7
1747,2023/01/04,24,25,19,0,43
1772,2023/01/04,5,0,2,0,7
1773,2023/01/04,6,0,2,0,8
1774,2023/01/04,10,0,1,0,11
1782,2023/01/04,16,12,9,1,25
1795,2023/01/04,19,14,13,0,32
1914,2023/01/04,14,6,0,0,14
1915,2023/01/04,3,0,1,0,4
1923,2023/01/04,12,0,2,0,14
1934,2023/01/04,0,0,1,0,1
1963,2023/01/04,3,0,2,0,5
1984,2023/01/04,17,6,3,0,20
2135,2023/01/04,6,0,2,0,8
2136,2023/01/04,2,0,0,0,2
2148,2023/01/04,8,0,3,0,11
2183,2023/01/04,6,6,1,0,7
2193,2023/01/04,16,15,9,4,25
2237,2023/01/04,6,0,0,0,6
2358,2023/01/04,8,0,1,0,9
2361,2023/01/04,17,7,5,0,22
2445,2023/01/04,20,6,3,0,23
2449,2023/01/04,3,0,2,0,5
2451,2023/01/04,11,0,0,0,11
2475,2023/01/04,8,0,1,0,9
2476,2023/01/04,11,0,2,0,13
2507,2023/01/04,24,18,8,0,32
2525,2023/01/04,15,0,1,0,16
2562,2023/01/04,9,0,7,1,16
2582,2023/01/04,10,0,0,0,10
2586,2023/01/04,24,12,12,0,36
2602,2023/01/04,7,0,1,0,8
2631,2023/01/04,9,6,2,0,11
2685,2023/01/04,8,4,7,0,15
2723,2023/01/04,7,0,0,0,7
2730,2023/01/04,15,6,0,0,15
2731,2023/01/04,12,6,0,0,12
2732,2023/01/04,9,8,1,0,10
2734,2023/01/04,6,0,0,0,6
2735,2023/01/04,6,0,2,0,8
2761,2023/01/04,22,20,12,0,34
2788,2023/01/04,36,16,10,0,46
2802,2023/01/04,8,0,0,0,8
2812,2023/01/04,4,0,0,0,4
2813,2023/01/04,4,0,0,0,4
2814,2023/01/04,1,0,0,0,1
2913,2023/01/04,0,0,1,0,1
2914,2023/01/04,5,0,0,0,5
3015,2023/01/04,14,8,2,0,16
3033,2023/01/04,0,0,0,0,0
3035,2023/01/04,9,6,1,0,10
4446,2023/01/04,26,12,7,0,33
12136,2023/01/04,48,27,29,5,77
12516,2023/01/04,7,4,2,0,9
12518,2023/01/04,7,4,3,0,10
12523,2023/01/04,11,4,2,0,13
16062,2023/01/04,6,0,0,0,6
16276,2023/01/04,8,0,2,0,10
19322,2023/01/04,3,0,0,0,3
19520,2023/01/04,11,8,1,0,12
20901,2023/01/04,6,0,0,0,6
20920,2023/01/04,14,0,3,0,17
21099,2023/01/04,8,0,0,0,8
21102,2023/01/04,19,0,0,0,19
21103,2023/01/04,11,0,1,0,12
21132,2023/01/04,20,15,4,7,24
21171,2023/01/04,7,4,2,0,9
21174,2023/01/04,23,12,7,4,30
21175,2023/01/04,10,8,7,5,17
21176,2023/01/04,13,8,5,0,18
75,2023/01/05,35,24,25,11,60
76,2023/01/05,45,36,43,4,88
99,2023/01/05,16,0,0,0,16
117,2023/01/05,7,0,1,0,8
118,2023/01/05,2,0,1,0,3
119,2023/01/05,9,4,0,0,9
120,2023/01/05,4,0,0,0,4
149,2023/01/05,7,0,1,0,8
184,2023/01/05,46,15,28,0,74
195,2023/01/05,19,12,16,7,35
218,2023/01/05,9,24,25,7,34
296,2023/01/05,15,8,3,0,18
300,2023/01/05,9,0,3,0,12
304,2023/01/05,7,4,3,0,10
317,2023/01/05,10,0,2,0,12
343,2023/01/05,4,4,2,0,6
353,2023/01/05,10,0,0,0,10
373,2023/01/05,7,0,8,0,15
374,2023/01/05,8,0,1,0,9
388,2023/01/05,41,21,29,2,70
419,2023/01/05,10,6,4,0,14
420,2023/01/05,7,0,1,0,8
462,2023/01/05,21,8,8,0,29
519,2023/01/05,17,0,10,0,27
525,2023/01/05,4,0,0,0,4
596,2023/01/05,11,4,12,0,23
597,2023/01/05,39,18,23,0,62
598,2023/01/05,6,0,0,0,6
1035,2023/01/05,15,6,4,0,19
1084,2023/01/05,21,15,24,0,45
1111,2023/01/05,13,6,1,0,14
1112,2023/01/05,6,0,1,0,7
1113,2023/01/05,11,6,1,0,12
1114,2023/01/05,24,12,3,0,27
1115,2023/01/05,13,0,1,0,14
1118,2023/01/05,11,0,0,0,11
1119,2023/01/05,1,0,0,0,1
1692,2023/01/05,7,0,3,0,10
1693,2023/01/05,5,0,1,0,6
1747,2023/01/05,30,25,39,0,69
1772,2023/01/05,3,0,0,0,3
1773,2023/01/05,4,0,1,0,5
1774,2023/01/05,9,0,0,0,9
1782,2023/01/05,30,24,25,0,55
1795,2023/01/05,20,14,14,0,34
1914,2023/01/05,14,0,2,0,16
1915,2023/01/05,2,0,0,0,2
1923,2023/01/05,10,0,1,0,11
1934,2023/01/05,4,5,0,0,4
1963,2023/01/05,7,6,3,0,10
1984,2023/01/05,14,0,5,0,19
2135,2023/01/05,10,6,1,0,11
2136,2023/01/05,2,0,0,0,2
2148,2023/01/05,5,0,0,0,5
2183,2023/01/05,11,6,0,0,11
2193,2023/01/05,19,15,14,6,33
2237,2023/01/05,12,6,2,0,14
2358,2023/01/05,15,8,10,0,25
2361,2023/01/05,19,7,4,0,23
2445,2023/01/05,23,6,2,0,25
2449,2023/01/05,1,0,0,0,1
2451,2023/01/05,26,15,9,0,35
2475,2023/01/05,7,0,0,0,7
2476,2023/01/05,9,0,1,0,10
2507,2023/01/05,40,24,29,0,69
2525,2023/01/05,14,0,2,0,16
2562,2023/01/05,1,0,1,0,2
2582,2023/01/05,14,4,0,0,14
2586,2023/01/05,24,12,15,0,39
2602,2023/01/05,6,0,0,0,6
2631,2023/01/05,7,0,4,0,11
2685,2023/01/05,5,4,4,0,9
2723,2023/01/05,15,8,2,0,17
2730,2023/01/05,15,0,1,0,16
2731,2023/01/05,12,0,1,0,13
2732,2023/01/05,8,0,1,0,9
2734,2023/01/05,6,0,0,0,6
2735,2023/01/05,8,4,5,0,13
2761,2023/01/05,25,15,22,0,47
2788,2023/01/05,42,16,13,4,55
2802,2023/01/05,8,0,0,0,8
2812,2023/01/05,10,6,2,0,12
2813,2023/01/05,10,6,0,0,10
2814,2023/01/05,7,6,0,0,7
2913,2023/01/05,5,6,2,0,7
2914,2023/01/05,5,0,0,0,5
3015,2023/01/05,12,0,2,0,14
3033,2023/01/05,6,6,0,0,6
3035,2023/01/05,8,0,1,0,9
4446,2023/01/05,31,12,21,2,52
12136,2023/01/05,41,27,40,3,81
12516,2023/01/05,5,0,1,0,6
12518,2023/01/05,4,0,2,0,6
12523,2023/01/05,9,0,3,0,12
16062,2023/01/05,12,6,1,0,13
16276,2023/01/05,6,0,3,0,9
19322,2023/01/05,9,6,0,0,9
19520,2023/01/05,10,0,2,0,12
20901,2023/01/05,6,0,2,0,8
20920,2023/01/05,11,0,1,0,12
21102,2023/01/05,19,0,2,0,21
21103,2023/01/05,10,0,0,0,10
21132,2023/01/05,21,12,11,10,32
21171,2023/01/05,5,0,3,1,8
21174,2023/01/05,24,12,12,0,36
21175,2023/01/05,10,12,15,6,25
21176,2023/01/05,16,8,2,0,18
75,2023/01/06,31,32,35,0,66
76,2023/01/06,30,32,39,0,69
99,2023/01/06,16,0,0,0,16
117,2023/01/06,6,0,2,0,8
118,2023/01/06,5,4,2,1,7
119,2023/01/06,9,0,0,1,9
120,2023/01/06,4,0,0,0,4
149,2023/01/06,6,0,0,0,6
184,2023/01/06,30,12,17,1,47
195,2023/01/06,17,21,21,0,38
218,2023/01/06,7,30,36,0,43
296,2023/01/06,16,4,1,0,17
300,2023/01/06,6,0,0,2,6
304,2023/01/06,8,4,1,0,9
317,2023/01/06,8,0,1,0,9
343,2023/01/06,2,0,0,0,2
353,2023/01/06,10,0,1,0,11
373,2023/01/06,5,6,2,0,7
374,2023/01/06,7,0,0,0,7
388,2023/01/06,36,24,18,1,54
419,2023/01/06,12,6,5,0,17
420,2023/01/06,6,0,0,0,6
462,2023/01/06,21,8,6,0,27
519,2023/01/06,13,6,5,8,18
525,2023/01/06,4,0,3,0,7
596,2023/01/06,11,12,9,0,20
597,2023/01/06,52,36,5,1,57
598,2023/01/06,6,0,0,0,6
1035,2023/01/06,11,0,8,0,19
1084,2023/01/06,22,25,11,0,33
1111,2023/01/06,12,0,3,0,15
1112,2023/01/06,5,0,1,0,6
1113,2023/01/06,10,0,2,0,12
1114,2023/01/06,21,0,7,0,28
1115,2023/01/06,12,0,2,0,14
1118,2023/01/06,11,0,0,0,11
1119,2023/01/06,1,0,0,0,1
1692,2023/01/06,4,0,0,0,4
1693,2023/01/06,4,0,0,0,4
1747,2023/01/06,16,25,19,0,35
1772,2023/01/06,11,8,1,0,12
1773,2023/01/06,9,6,0,0,9
1774,2023/01/06,9,0,0,0,9
1782,2023/01/06,29,24,24,0,53
1795,2023/01/06,20,14,17,0,37
1914,2023/01/06,12,0,2,0,14
1915,2023/01/06,8,6,2,0,10
1923,2023/01/06,9,0,2,0,11
1934,2023/01/06,9,5,0,0,9
1963,2023/01/06,4,0,1,0,5
1984,2023/01/06,15,6,3,1,18
2135,2023/01/06,9,0,1,0,10
2136,2023/01/06,2,0,1,0,3
2148,2023/01/06,9,4,1,0,10
2183,2023/01/06,17,6,3,0,20
2193,2023/01/06,13,15,20,1,33
2237,2023/01/06,16,6,1,0,17
2358,2023/01/06,5,0,5,0,10
2361,2023/01/06,15,0,7,0,22
2445,2023/01/06,21,0,7,0,28
2449,2023/01/06,7,6,3,0,10
2451,2023/01/06,27,10,8,0,35
2475,2023/01/06,7,0,0,0,7
2476,2023/01/06,8,0,1,0,9
2507,2023/01/06,29,18,10,0,39
2525,2023/01/06,12,0,2,0,14
2562,2023/01/06,0,0,0,0,0
2582,2023/01/06,14,0,3,0,17
2586,2023/01/06,21,12,14,0,35
2602,2023/01/06,6,0,0,0,6
2631,2023/01/06,9,6,5,0,14
2685,2023/01/06,9,8,7,0,16
2723,2023/01/06,13,0,0,0,13
2730,2023/01/06,14,0,0,0,14
2731,2023/01/06,11,0,2,0,13
2732,2023/01/06,7,0,1,0,8
2734,2023/01/06,10,4,1,0,11
2735,2023/01/06,7,4,1,0,8
2761,2023/01/06,18,15,15,0,33
2788,2023/01/06,41,16,15,2,56
2802,2023/01/06,8,0,0,0,8
2812,2023/01/06,8,0,0,0,8
2813,2023/01/06,10,0,4,0,14
2814,2023/01/06,7,0,2,0,9
2913,2023/01/06,3,0,2,0,5
2914,2023/01/06,11,6,1,0,12
3015,2023/01/06,10,0,0,0,10
3033,2023/01/06,6,0,0,0,6
3035,2023/01/06,7,0,0,0,7
4446,2023/01/06,20,12,7,0,27
12136,2023/01/06,24,24,20,0,44
12516,2023/01/06,4,0,2,0,6
12518,2023/01/06,2,0,0,0,2
12523,2023/01/06,6,0,2,0,8
16062,2023/01/06,11,0,0,0,11
16276,2023/01/06,3,0,0,0,3
19322,2023/01/06,9,0,0,0,9
19520,2023/01/06,8,0,1,0,9
20901,2023/01/06,4,0,0,0,4
20920,2023/01/06,10,0,1,0,11
21102,2023/01/06,17,0,0,0,17
21103,2023/01/06,10,0,0,0,10
21132,2023/01/06,15,15,15,0,30
21171,2023/01/06,5,4,2,0,7
21174,2023/01/06,24,12,8,0,32
21175,2023/01/06,-3,8,5,0,2
21176,2023/01/06,14,0,7,0,21
75,2023/01/07,25,24,28,0,53
76,2023/01/07,12,16,34,0,46
99,2023/01/07,16,0,0,0,16
117,2023/01/07,8,4,0,0,8
118,2023/01/07,2,0,2,0,4
119,2023/01/07,12,4,0,0,12
120,2023/01/07,8,4,0,0,8
184,2023/01/07,12,0,3,0,15
195,2023/01/07,11,15,25,0,36
218,2023/01/07,-5,21,20,0,15
296,2023/01/07,15,0,3,0,18
300,2023/01/07,4,0,1,0,5
304,2023/01/07,11,4,3,0,14
317,2023/01/07,13,6,3,0,16
343,2023/01/07,2,0,2,0,4
353,2023/01/07,9,0,0,0,9
373,2023/01/07,3,0,3,0,6
374,2023/01/07,11,4,1,0,12
388,2023/01/07,18,3,9,0,27
419,2023/01/07,7,0,2,0,9
420,2023/01/07,6,0,0,0,6
462,2023/01/07,23,8,6,0,29
519,2023/01/07,6,6,8,0,14
525,2023/01/07,6,5,0,0,6
596,2023/01/07,2,0,2,0,4
597,2023/01/07,46,0,21,0,67
598,2023/01/07,12,6,3,0,15
1035,2023/01/07,9,6,3,0,12
1084,2023/01/07,11,0,11,0,22
1111,2023/01/07,9,0,4,0,13
1112,2023/01/07,10,6,1,0,11
1113,2023/01/07,8,0,1,0,9
1114,2023/01/07,14,0,9,0,23
1115,2023/01/07,10,0,3,0,13
1118,2023/01/07,17,6,1,0,18
1119,2023/01/07,1,0,0,0,1
1692,2023/01/07,10,6,3,0,13
1693,2023/01/07,10,6,2,0,12
1747,2023/01/07,17,20,26,0,43
1772,2023/01/07,10,0,2,0,12
1773,2023/01/07,9,0,1,0,10
1774,2023/01/07,9,0,1,0,10
1782,2023/01/07,29,24,33,3,62
1795,2023/01/07,38,35,23,0,61
1914,2023/01/07,10,0,2,0,12
1915,2023/01/07,12,6,0,0,12
1923,2023/01/07,7,0,0,0,7
1934,2023/01/07,9,0,4,0,13
1963,2023/01/07,3,0,4,0,7
1984,2023/01/07,11,0,3,3,14
2135,2023/01/07,8,0,1,0,9
2136,2023/01/07,1,0,0,0,1
2148,2023/01/07,8,0,1,0,9
2183,2023/01/07,20,6,1,0,21
2193,2023/01/07,7,12,9,0,16
2237,2023/01/07,15,0,1,0,16
2358,2023/01/07,0,0,0,0,0
2361,2023/01/07,8,0,6,0,14
2445,2023/01/07,20,6,9,0,29
2449,2023/01/07,4,0,3,0,7
2451,2023/01/07,39,20,9,0,48
2475,2023/01/07,13,6,1,0,14
2476,2023/01/07,7,0,1,0,8
2507,2023/01/07,31,12,14,0,45
2525,2023/01/07,10,0,3,0,13
2562,2023/01/07,6,6,4,0,10
2582,2023/01/07,11,0,1,0,12
2586,2023/01/07,17,8,16,0,33
2602,2023/01/07,6,0,0,0,6
2631,2023/01/07,10,6,2,0,12
2685,2023/01/07,10,8,8,0,18
2723,2023/01/07,13,0,2,0,15
2730,2023/01/07,14,0,4,0,18
2731,2023/01/07,9,0,4,0,13
2732,2023/01/07,6,0,2,0,8
2734,2023/01/07,9,0,2,0,11
2735,2023/01/07,10,4,1,0,11
2761,2023/01/07,23,20,20,0,43
2788,2023/01/07,28,0,8,0,36
2802,2023/01/07,8,0,2,0,10
2812,2023/01/07,8,0,0,0,8
2813,2023/01/07,6,0,0,0,6
2814,2023/01/07,5,0,0,0,5
2913,2023/01/07,1,0,0,0,1
2914,2023/01/07,10,0,3,0,13
3015,2023/01/07,10,0,1,0,11
3033,2023/01/07,6,0,0,0,6
3035,2023/01/07,7,0,0,0,7
4446,2023/01/07,19,6,12,2,31
12136,2023/01/07,8,6,15,0,23
12516,2023/01/07,6,4,1,0,7
12518,2023/01/07,6,4,2,0,8
12523,2023/01/07,8,4,4,0,12
16062,2023/01/07,11,0,3,0,14
16276,2023/01/07,3,0,0,1,3
19322,2023/01/07,9,0,4,0,13
19520,2023/01/07,7,0,0,0,7
20901,2023/01/07,4,0,0,0,4
20920,2023/01/07,9,0,1,0,10
21103,2023/01/07,10,0,1,0,11
21132,2023/01/07,18,18,21,0,39
21171,2023/01/07,7,4,3,0,10
21174,2023/01/07,20,4,17,0,37
21175,2023/01/07,0,8,13,0,13
21176,2023/01/07,11,4,4,1,15
75,2023/01/08,24,32,32,0,56
76,2023/01/08,1,28,17,0,18
99,2023/01/08,16,0,0,0,16
117,2023/01/08,8,0,1,0,9
118,2023/01/08,4,4,1,0,5
119,2023/01/08,12,0,1,3,13
120,2023/01/08,8,0,2,3,10
184,2023/01/08,15,6,10,0,25
195,2023/01/08,4,18,19,0,23
218,2023/01/08,-7,21,22,0,15
296,2023/01/08,16,4,4,0,20
300,2023/01/08,7,4,2,5,9
304,2023/01/08,12,4,4,0,16
317,2023/01/08,16,6,3,1,19
343,2023/01/08,4,4,1,0,5
353,2023/01/08,9,0,0,0,9
373,2023/01/08,0,0,1,0,1
374,2023/01/08,18,8,5,0,23
388,2023/01/08,33,24,23,0,56
419,2023/01/08,11,6,6,2,17
420,2023/01/08,6,0,0,0,6
462,2023/01/08,17,0,14,0,31
519,2023/01/08,10,12,6,0,16
525,2023/01/08,6,0,1,0,7
596,2023/01/08,4,4,5,0,9
597,2023/01/08,31,6,33,4,64
598,2023/01/08,9,0,5,0,14
1035,2023/01/08,6,0,3,0,9
1084,2023/01/08,10,10,11,0,21
1111,2023/01/08,5,0,5,0,10
1112,2023/01/08,9,0,0,0,9
1113,2023/01/08,7,0,3,0,10
1114,2023/01/08,11,6,7,0,18
1115,2023/01/08,7,0,0,0,7
1117,2023/01/08,8,8,1,0,9
1118,2023/01/08,16,0,8,0,24
1119,2023/01/08,1,0,0,0,1
1692,2023/01/08,7,0,2,0,9
1693,2023/01/08,8,0,0,0,8
1747,2023/01/08,1,10,15,0,16
1772,2023/01/08,8,0,3,0,11
1773,2023/01/08,8,0,1,0,9
1774,2023/01/08,8,0,0,0,8
1782,2023/01/08,2,9,9,0,11
1795,2023/01/08,15,0,12,0,27
1914,2023/01/08,14,6,0,0,14
1915,2023/01/08,12,0,5,0,17
1923,2023/01/08,7,0,0,0,7
1934,2023/01/08,10,5,0,7,10
1963,2023/01/08,5,6,6,0,11
1984,2023/01/08,5,0,5,0,10
2135,2023/01/08,13,6,4,0,17
2136,2023/01/08,7,6,0,0,7
2148,2023/01/08,11,4,3,0,14
2183,2023/01/08,19,0,6,0,25
2193,2023/01/08,7,12,27,0,34
2237,2023/01/08,14,0,2,0,16
2358,2023/01/08,8,8,2,0,10
2361,2023/01/08,9,7,1,0,10
2445,2023/01/08,11,0,2,1,13
2449,2023/01/08,7,6,2,0,9
2451,2023/01/08,70,40,19,0,89
2475,2023/01/08,12,0,1,0,13
2476,2023/01/08,12,6,2,0,14
2507,2023/01/08,17,0,10,2,27
2525,2023/01/08,7,0,0,0,7
2562,2023/01/08,2,0,2,0,4
2582,2023/01/08,10,0,4,0,14
2586,2023/01/08,11,12,4,0,15
2602,2023/01/08,6,0,0,0,6
2631,2023/01/08,8,0,2,0,10
2685,2023/01/08,10,8,10,0,20
2723,2023/01/08,11,0,3,0,14
2730,2023/01/08,10,0,7,0,17
2731,2023/01/08,11,6,1,0,12
2732,2023/01/08,12,8,9,0,21
2734,2023/01/08,15,8,2,0,17
2735,2023/01/08,9,0,6,1,15
2761,2023/01/08,18,15,16,0,34
2788,2023/01/08,32,16,20,0,52
2802,2023/01/08,6,0,1,0,7
2812,2023/01/08,8,0,0,0,8
2813,2023/01/08,6,0,1,0,7
2814,2023/01/08,5,0,0,0,5
2913,2023/01/08,7,6,1,0,8
2914,2023/01/08,7,0,0,0,7
3015,2023/01/08,9,0,0,0,9
3033,2023/01/08,6,0,1,0,7
3035,2023/01/08,7,0,0,0,7
4446,2023/01/08,11,6,7,0,18
12136,2023/01/08,11,18,8,0,19
12516,2023/01/08,9,4,0,0,9
12518,2023/01/08,8,4,4,0,12
12523,2023/01/08,12,8,1,0,13
16062,2023/01/08,8,0,0,0,8
16276,2023/01/08,2,0,0,0,2
19322,2023/01/08,5,0,0,0,5
19520,2023/01/08,7,0,2,0,9
20901,2023/01/08,10,6,2,0,12
20920,2023/01/08,8,0,0,0,8
21103,2023/01/08,9,0,0,0,9
21132,2023/01/08,9,12,13,0,22
21171,2023/01/08,8,4,5,0,13
21174,2023/01/08,19,16,13,0,32
21175,2023/01/08,-5,8,6,0,1
21176,2023/01/08,10,4,6,0,16
75,2023/01/09,24,32,26,0,50
76,2023/01/09,28,44,43,0,71
99,2023/01/09,16,0,1,0,17
117,2023/01/09,7,0,2,0,9
118,2023/01/09,7,4,1,0,8
119,2023/01/09,8,0,1,0,9
120,2023/01/09,3,0,3,0,6
184,2023/01/09,17,12,8,0,25
195,2023/01/09,16,30,29,0,45
218,2023/01/09,4,33,30,0,34
296,2023/01/09,12,0,4,0,16
300,2023/01/09,4,4,1,0,5
304,2023/01/09,12,4,2,0,14
317,2023/01/09,18,6,6,0,24
343,2023/01/09,7,4,0,0,7
353,2023/01/09,9,0,0,0,9
373,2023/01/09,5,6,2,1,7
374,2023/01/09,13,0,6,0,19
388,2023/01/09,37,27,23,0,60
419,2023/01/09,9,6,3,0,12
420,2023/01/09,12,6,1,0,13
462,2023/01/09,19,16,12,0,31
519,2023/01/09,10,6,3,0,13
525,2023/01/09,5,0,0,1,5
596,2023/01/09,11,12,4,0,15
597,2023/01/09,12,18,8,0,20
598,2023/01/09,4,0,0,0,4
1035,2023/01/09,9,6,4,0,13
1084,2023/01/09,14,15,14,0,28
1111,2023/01/09,0,0,0,0,0
1112,2023/01/09,15,6,0,0,15
1113,2023/01/09,4,0,2,0,6
1114,2023/01/09,10,6,5,0,15
1115,2023/01/09,13,6,3,0,16
1117,2023/01/09,7,0,1,0,8
1118,2023/01/09,14,6,3,0,17
1119,2023/01/09,7,6,0,0,7
1692,2023/01/09,11,6,4,0,15
1693,2023/01/09,8,0,0,0,8
1747,2023/01/09,16,30,15,0,31
1772,2023/01/09,5,0,1,0,6
1773,2023/01/09,13,6,1,0,14
1774,2023/01/09,8,0,2,0,10
1782,2023/01/09,11,18,16,0,27
1795,2023/01/09,4,0,5,0,9
1914,2023/01/09,14,0,0,0,14
1915,2023/01/09,13,6,1,0,14
1923,2023/01/09,13,6,1,0,14
1934,2023/01/09,3,0,1,0,4
1963,2023/01/09,-1,0,0,0,-1
1984,2023/01/09,6,6,1,0,7
2135,2023/01/09,9,0,2,0,11
2136,2023/01/09,7,0,0,0,7
2148,2023/01/09,8,0,2,0,10
2183,2023/01/09,13,0,0,9,13
2193,2023/01/09,-2,18,12,0,10
2237,2023/01/09,12,0,5,0,17
2358,2023/01/09,6,0,4,0,10
2361,2023/01/09,8,0,4,0,12
2445,2023/01/09,14,6,2,3,16
2449,2023/01/09,5,0,3,0,8
2451,2023/01/09,51,0,13,0,64
2475,2023/01/09,17,6,0,0,17
2476,2023/01/09,10,0,4,0,14
2507,2023/01/09,24,18,7,5,31
2525,2023/01/09,7,0,0,0,7
2562,2023/01/09,6,6,1,0,7
2582,2023/01/09,6,0,0,0,6
2586,2023/01/09,27,20,15,0,42
2602,2023/01/09,6,0,2,0,8
2631,2023/01/09,12,6,1,0,13
2685,2023/01/09,8,8,1,0,9
2723,2023/01/09,8,0,1,0,9
2730,2023/01/09,3,0,0,0,3
2731,2023/01/09,10,0,1,0,11
2732,2023/01/09,3,0,1,0,4
2734,2023/01/09,13,0,3,0,16
2735,2023/01/09,10,8,2,0,12
2761,2023/01/09,22,20,14,0,36
2788,2023/01/09,32,20,12,0,44
2802,2023/01/09,5,0,0,0,5
2812,2023/01/09,8,0,0,0,8
2813,2023/01/09,5,0,0,0,5
2814,2023/01/09,11,6,0,0,11
2913,2023/01/09,6,0,0,0,6
2914,2023/01/09,7,0,2,0,9
3015,2023/01/09,17,8,2,0,19
3033,2023/01/09,5,0,0,0,5
3035,2023/01/09,7,0,0,0,7
4446,2023/01/09,19,15,13,0,32
12136,2023/01/09,35,30,27,0,62
12516,2023/01/09,9,0,2,0,11
12518,2023/01/09,8,4,2,0,10
12523,2023/01/09,11,0,3,0,14
16062,2023/01/09,8,0,0,0,8
16276,2023/01/09,6,4,0,0,6
19322,2023/01/09,5,0,0,0,5
19520,2023/01/09,5,0,0,0,5
20901,2023/01/09,8,0,0,0,8
20920,2023/01/09,8,0,1,0,9
21102,2023/01/09,17,0,0,0,17
21103,2023/01/09,9,0,0,0,9
21132,2023/01/09,14,18,15,0,29
21171,2023/01/09,3,0,2,0,5
21174,2023/01/09,14,8,5,0,19
21175,2023/01/09,5,16,10,0,15
21176,2023/01/09,8,4,3,0,11
75,2023/01/10,30,32,27,0,57
76,2023/01/10,29,44,41,0,70
99,2023/01/10,15,0,2,0,17
117,2023/01/10,5,0,1,1,6
118,2023/01/10,6,0,1,0,7
119,2023/01/10,11,4,2,0,13
120,2023/01/10,0,0,0,0,0
184,2023/01/10,24,15,4,0,28
195,2023/01/10,13,27,27,0,40
218,2023/01/10,4,30,32,0,36
296,2023/01/10,12,4,4,0,16
300,2023/01/10,7,4,1,0,8
304,2023/01/10,10,0,1,0,11
317,2023/01/10,14,0,7,0,21
343,2023/01/10,7,0,2,0,9
353,2023/01/10,9,0,0,0,9
373,2023/01/10,9,6,3,0,12
374,2023/01/10,11,4,0,0,11
388,2023/01/10,44,30,31,1,75
419,2023/01/10,16,6,5,0,21
420,2023/01/10,4,0,1,0,5
462,2023/01/10,15,8,6,0,21
519,2023/01/10,20,12,8,0,28
525,2023/01/10,4,0,0,0,4
596,2023/01/10,15,8,8,0,23
597,2023/01/10,16,12,6,0,22
598,2023/01/10,4,0,0,0,4
1035,2023/01/10,11,6,0,0,11
1084,2023/01/10,15,15,6,0,21
1111,2023/01/10,6,6,2,0,8
1112,2023/01/10,15,0,2,0,17
1113,2023/01/10,8,6,2,0,10
1114,2023/01/10,11,6,4,0,15
1115,2023/01/10,16,6,0,0,16
1117,2023/01/10,6,0,0,0,6
1118,2023/01/10,11,0,3,0,14
1119,2023/01/10,7,0,2,0,9
1692,2023/01/10,5,0,2,0,7
1693,2023/01/10,11,6,1,0,12
1747,2023/01/10,26,25,21,0,47
1772,2023/01/10,12,8,2,0,14
1773,2023/01/10,12,0,0,0,12
1774,2023/01/10,6,0,0,0,6
1782,2023/01/10,19,24,22,0,41
1795,2023/01/10,12,14,14,0,26
1914,2023/01/10,14,0,2,0,16
1915,2023/01/10,12,0,0,0,12
1923,2023/01/10,12,0,0,0,12
1934,2023/01/10,2,0,2,1,4
1963,2023/01/10,6,6,5,0,11
1984,2023/01/10,5,0,1,0,6
2135,2023/01/10,13,6,1,0,14
2136,2023/01/10,7,0,1,0,8
2148,2023/01/10,6,0,2,0,8
2183,2023/01/10,10,6,2,2,12
2193,2023/01/10,4,18,8,0,12
2237,2023/01/10,7,0,0,0,7
2358,2023/01/10,10,8,2,0,12
2361,2023/01/10,11,7,3,0,14
2445,2023/01/10,6,0,0,0,6
2449,2023/01/10,9,6,3,0,12
2451,2023/01/10,38,0,13,0,51
2475,2023/01/10,17,0,0,0,17
2476,2023/01/10,6,0,1,0,7
2507,2023/01/10,23,12,11,0,34
2525,2023/01/10,13,6,1,0,14
2562,2023/01/10,12,6,1,0,13
2582,2023/01/10,6,0,1,0,7
2586,2023/01/10,24,12,18,0,42
2602,2023/01/10,4,0,2,0,6
2631,2023/01/10,16,6,1,2,17
2685,2023/01/10,15,8,4,0,19
2723,2023/01/10,15,8,1,0,16
2730,2023/01/10,9,6,1,0,10
2731,2023/01/10,15,6,1,0,16
2732,2023/01/10,2,0,0,0,2
2734,2023/01/10,10,0,1,0,11
2735,2023/01/10,8,0,0,0,8
2761,2023/01/10,28,20,18,0,46
2788,2023/01/10,32,12,15,0,47
2802,2023/01/10,11,6,0,0,11
2812,2023/01/10,8,0,1,0,9
2813,2023/01/10,11,6,2,0,13
2814,2023/01/10,11,0,0,0,11
2913,2023/01/10,7,6,1,1,8
2914,2023/01/10,5,0,0,0,5
3015,2023/01/10,15,0,2,0,17
3033,2023/01/10,5,0,1,0,6
3035,2023/01/10,7,0,0,0,7
4446,2023/01/10,12,6,4,0,16
12136,2023/01/10,36,30,32,0,68
12516,2023/01/10,7,0,2,0,9
12518,2023/01/10,6,0,2,0,8
12523,2023/01/10,8,0,1,0,9
16062,2023/01/10,14,6,0,0,14
16276,2023/01/10,6,0,1,0,7
19322,2023/01/10,11,6,0,0,11
19520,2023/01/10,5,0,1,0,6
20901,2023/01/10,8,0,1,0,9
20920,2023/01/10,7,0,1,0,8
21102,2023/01/10,17,0,0,0,17
21103,2023/01/10,9,0,2,0,11
21132,2023/01/10,21,21,17,0,38
21171,2023/01/10,5,4,2,0,7
21174,2023/01/10,17,8,4,0,21
21175,2023/01/10,3,8,7,0,10
21176,2023/01/10,9,4,4,0,13
75,2023/01/11,39,36,39,2,78
76,2023/01/11,28,40,39,0,67
99,2023/01/11,13,0,1,0,14
117,2023/01/11,3,0,1,0,4
118,2023/01/11,9,4,1,0,10
119,2023/01/11,9,0,3,1,12
120,2023/01/11,4,4,2,0,6
184,2023/01/11,29,9,11,0,40
195,2023/01/11,16,30,28,0,44
218,2023/01/11,2,30,29,0,31
296,2023/01/11,12,4,5,0,17
300,2023/01/11,10,4,5,1,15
304,2023/01/11,13,4,2,0,15
317,2023/01/11,13,6,6,0,19
343,2023/01/11,9,4,1,0,10
353,2023/01/11,9,0,1,0,10
373,2023/01/11,12,6,5,1,17
374,2023/01/11,11,0,6,0,17
388,2023/01/11,27,15,17,0,44
419,2023/01/11,17,6,5,1,22
420,2023/01/11,3,0,3,0,6
462,2023/01/11,9,0,7,0,16
519,2023/01/11,18,6,3,0,21
525,2023/01/11,9,5,0,0,9
596,2023/01/11,15,8,2,0,17
597,2023/01/11,22,12,11,0,33
598,2023/01/11,4,0,4,0,8
1035,2023/01/11,11,0,2,0,13
1084,2023/01/11,24,15,7,0,31
1111,2023/01/11,10,6,2,0,12
1112,2023/01/11,13,0,1,0,14
1113,2023/01/11,6,0,0,0,6
1114,2023/01/11,13,6,1,0,14
1115,2023/01/11,16,0,0,0,16
1117,2023/01/11,6,0,1,0,7
1118,2023/01/11,8,0,3,0,11
1119,2023/01/11,5,0,0,0,5
1692,2023/01/11,3,0,3,0,6
1693,2023/01/11,10,0,3,0,13
1747,2023/01/11,25,20,30,0,55
1772,2023/01/11,10,0,1,0,11
1773,2023/01/11,12,0,1,0,13
1774,2023/01/11,6,0,1,0,7
1782,2023/01/11,24,27,26,0,50
1795,2023/01/11,12,14,13,0,25
1914,2023/01/11,12,0,0,0,12
1915,2023/01/11,12,0,1,0,13
1923,2023/01/11,12,0,4,0,16
1934,2023/01/11,4,5,2,0,6
1963,2023/01/11,7,6,3,1,10
1984,2023/01/11,10,6,0,0,10
2135,2023/01/11,12,0,3,0,15
2136,2023/01/11,6,0,1,0,7
2148,2023/01/11,4,0,1,0,5
2183,2023/01/11,6,0,1,0,7
2193,2023/01/11,14,18,14,0,28
2237,2023/01/11,7,0,0,0,7
2358,2023/01/11,8,0,6,0,14
2361,2023/01/11,15,7,2,0,17
2445,2023/01/11,12,6,3,0,15
2449,2023/01/11,12,6,5,0,17
2451,2023/01/11,25,0,13,0,38
2475,2023/01/11,17,0,0,0,17
2476,2023/01/11,5,0,0,0,5
2507,2023/01/11,30,18,11,0,41
2525,2023/01/11,12,0,0,0,12
2562,2023/01/11,17,6,2,0,19
2582,2023/01/11,9,4,2,0,11
2586,2023/01/11,26,20,15,0,41
2602,2023/01/11,2,0,1,0,3
2631,2023/01/11,13,0,3,0,16
2685,2023/01/11,19,8,2,0,21
2723,2023/01/11,14,0,1,0,15
2730,2023/01/11,8,0,1,0,9
2731,2023/01/11,14,0,1,0,15
2732,2023/01/11,10,8,1,0,11
2734,2023/01/11,9,0,1,0,10
2735,2023/01/11,8,0,3,0,11
2761,2023/01/11,30,20,22,0,52
2788,2023/01/11,29,12,11,0,40
2802,2023/01/11,11,0,0,0,11
2812,2023/01/11,7,0,0,0,7
2813,2023/01/11,9,0,0,0,9
2814,2023/01/11,11,0,1,0,12
2913,2023/01/11,5,0,4,0,9
2914,2023/01/11,5,0,0,0,5
3015,2023/01/11,13,0,2,0,15
3033,2023/01/11,4,0,1,0,5
3035,2023/01/11,7,0,0,0,7
4446,2023/01/11,23,15,11,0,34
12136,2023/01/11,34,30,29,1,63
12516,2023/01/11,9,4,3,0,12
12518,2023/01/11,8,4,4,0,12
12523,2023/01/11,7,0,1,0,8
16062,2023/01/11,14,0,2,0,16
16276,2023/01/11,5,0,0,0,5
19322,2023/01/11,11,0,0,0,11
19520,2023/01/11,4,0,0,0,4
20901,2023/01/11,7,0,0,0,7
20920,2023/01/11,6,0,0,0,6
21102,2023/01/11,17,0,0,0,17
21103,2023/01/11,7,0,4,0,11
21132,2023/01/11,24,21,15,1,39
21171,2023/01/11,7,4,3,0,10
21174,2023/01/11,29,16,7,3,36
21175,2023/01/11,4,8,9,5,13
21176,2023/01/11,13,8,5,0,18
75,2023/01/12,35,36,41,0,76
76,2023/01/12,29,40,44,0,73
99,2023/01/12,12,0,0,0,12
117,2023/01/12,2,0,1,0,3
118,2023/01/12,8,0,2,0,10
119,2023/01/12,5,0,0,3,5
120,2023/01/12,2,0,1,0,3
184,2023/01/12,39,21,14,0,53
195,2023/01/12,21,30,34,0,55
218,2023/01/12,3,30,32,0,35
296,2023/01/12,11,4,3,0,14
300,2023/01/12,8,4,4,0,12
304,2023/01/12,11,0,3,0,14
317,2023/01/12,7,0,5,0,12
343,2023/01/12,8,0,2,0,10
353,2023/01/12,9,0,0,0,9
373,2023/01/12,6,0,2,1,8
374,2023/01/12,5,0,1,0,6
388,2023/01/12,40,30,13,0,53
419,2023/01/12,17,6,6,0,23
420,2023/01/12,0,0,0,0,0
462,2023/01/12,10,8,4,0,14
519,2023/01/12,21,6,7,0,28
525,2023/01/12,9,0,0,4,9
596,2023/01/12,21,8,7,0,28
597,2023/01/12,35,24,18,0,53
598,2023/01/12,6,6,1,0,7
1035,2023/01/12,15,6,7,0,22
1084,2023/01/12,32,15,9,0,41
1111,2023/01/12,8,0,0,0,8
1112,2023/01/12,12,0,0,0,12
1113,2023/01/12,6,0,2,0,8
1114,2023/01/12,18,6,5,0,23
1115,2023/01/12,16,0,3,0,19
1117,2023/01/12,5,0,0,0,5
1118,2023/01/12,11,6,3,0,14
1119,2023/01/12,5,0,1,0,6
1692,2023/01/12,6,6,3,0,9
1693,2023/01/12,7,0,2,0,9
1747,2023/01/12,25,30,17,0,42
1772,2023/01/12,9,0,1,0,10
1773,2023/01/12,11,0,0,0,11
1774,2023/01/12,13,8,2,0,15
1782,2023/01/12,22,24,21,0,43
1795,2023/01/12,13,14,14,0,27
1914,2023/01/12,12,0,0,0,12
1915,2023/01/12,11,0,0,0,11
1923,2023/01/12,8,0,1,0,9
1934,2023/01/12,7,5,3,0,10
1963,2023/01/12,9,6,3,0,12
1984,2023/01/12,10,0,0,0,10
2135,2023/01/12,9,0,0,0,9
2136,2023/01/12,5,0,0,0,5
2148,2023/01/12,7,4,0,0,7
2183,2023/01/12,5,0,2,0,7
2193,2023/01/12,24,24,17,0,41
2237,2023/01/12,13,6,1,0,14
2358,2023/01/12,6,4,4,0,10
2361,2023/01/12,20,7,5,0,25
2445,2023/01/12,9,0,6,0,15
2449,2023/01/12,7,0,3,0,10
2451,2023/01/12,32,20,13,0,45
2475,2023/01/12,17,0,0,0,17
2476,2023/01/12,11,6,0,0,11
2507,2023/01/12,37,18,10,0,47
2525,2023/01/12,12,0,3,0,15
2562,2023/01/12,21,6,6,0,27
2582,2023/01/12,7,0,0,0,7
2586,2023/01/12,27,16,8,0,35
2602,2023/01/12,1,0,1,0,2
2631,2023/01/12,10,0,2,0,12
2685,2023/01/12,29,12,4,3,33
2723,2023/01/12,13,0,2,0,15
2730,2023/01/12,7,0,3,0,10
2731,2023/01/12,13,0,0,0,13
2732,2023/01/12,9,0,3,0,12
2734,2023/01/12,8,0,2,0,10
2735,2023/01/12,9,4,1,0,10
2761,2023/01/12,28,20,14,0,42
2788,2023/01/12,42,24,20,0,62
2802,2023/01/12,11,0,1,0,12
2812,2023/01/12,7,0,1,0,8
2813,2023/01/12,9,0,2,0,11
2814,2023/01/12,10,0,0,0,10
2913,2023/01/12,1,0,0,0,1
2914,2023/01/12,11,6,0,0,11
3015,2023/01/12,11,0,2,0,13
3033,2023/01/12,3,0,0,0,3
3035,2023/01/12,7,0,0,0,7
4446,2023/01/12,24,12,9,0,33
12136,2023/01/12,34,30,30,0,64
12516,2023/01/12,6,0,1,0,7
12518,2023/01/12,8,4,2,0,10
12523,2023/01/12,6,0,2,0,8
16062,2023/01/12,12,0,0,0,12
16276,2023/01/12,5,0,0,0,5
19322,2023/01/12,11,0,0,0,11
19520,2023/01/12,12,8,2,0,14
20901,2023/01/12,7,0,1,0,8
20920,2023/01/12,6,0,2,0,8
21102,2023/01/12,17,0,0,0,17
21103,2023/01/12,3,0,2,0,5
21132,2023/01/12,23,15,23,0,46
21171,2023/01/12,8,4,4,0,12
21174,2023/01/12,35,16,10,0,45
21175,2023/01/12,2,12,8,0,10
21176,2023/01/12,16,8,1,0,17
75,2023/01/13,28,36,37,0,65
76,2023/01/13,37,48,42,0,79
99,2023/01/13,12,0,0,0,12
117,2023/01/13,5,4,2,1,7
118,2023/01/13,10,4,3,0,13
119,2023/01/13,2,0,0,0,2
120,2023/01/13,5,4,4,0,9
184,2023/01/13,25,9,12,3,37
195,2023/01/13,25,30,28,0,53
218,2023/01/13,26,30,25,0,51
296,2023/01/13,8,0,2,6,10
300,2023/01/13,4,0,4,0,8
304,2023/01/13,12,4,2,0,14
317,2023/01/13,8,6,1,0,9
343,2023/01/13,6,0,1,0,7
353,2023/01/13,8,0,0,0,8
373,2023/01/13,9,6,2,0,11
374,2023/01/13,8,4,3,0,11
388,2023/01/13,32,15,28,4,60
419,2023/01/13,17,6,3,0,20
420,2023/01/13,6,6,1,0,7
462,2023/01/13,14,8,7,0,21
519,2023/01/13,26,12,14,0,40
525,2023/01/13,5,0,2,0,7
596,2023/01/13,22,8,8,3,30
597,2023/01/13,60,36,6,0,66
598,2023/01/13,5,0,0,0,5
1035,2023/01/13,14,6,1,1,15
1084,2023/01/13,39,15,14,0,53
1111,2023/01/13,8,0,1,0,9
1112,2023/01/13,12,0,1,0,13
1113,2023/01/13,10,6,2,0,12
1114,2023/01/13,13,0,3,0,16
1115,2023/01/13,13,0,4,0,17
1117,2023/01/13,5,0,0,0,5
1118,2023/01/13,8,0,2,0,10
1119,2023/01/13,4,0,1,0,5
1692,2023/01/13,9,6,0,0,9
1693,2023/01/13,5,0,2,0,7
1747,2023/01/13,47,25,31,5,78
1772,2023/01/13,8,0,3,0,11
1773,2023/01/13,11,0,2,0,13
1774,2023/01/13,11,0,2,0,13
1782,2023/01/13,33,27,30,2,63
1795,2023/01/13,21,21,12,0,33
1914,2023/01/13,12,0,1,0,13
1915,2023/01/13,11,0,1,0,12
1923,2023/01/13,7,0,1,0,8
1934,2023/01/13,10,0,2,1,12
1963,2023/01/13,12,6,3,0,15
1984,2023/01/13,16,6,3,2,19
2135,2023/01/13,9,0,4,0,13
2136,2023/01/13,5,0,0,0,5
2148,2023/01/13,11,4,6,0,17
2183,2023/01/13,9,6,3,0,12
2193,2023/01/13,37,24,27,7,64
2237,2023/01/13,12,0,5,0,17
2358,2023/01/13,2,0,1,0,3
2361,2023/01/13,15,0,8,0,23
2445,2023/01/13,15,12,4,0,19
2449,2023/01/13,4,0,0,0,4
2451,2023/01/13,7,0,7,0,14
2475,2023/01/13,17,0,1,0,18
2476,2023/01/13,11,0,5,0,16
2507,2023/01/13,33,0,7,2,40
2525,2023/01/13,9,0,0,0,9
2562,2023/01/13,15,0,3,0,18
2582,2023/01/13,7,0,0,0,7
2586,2023/01/13,29,20,16,0,45
2602,2023/01/13,8,8,0,0,8
2631,2023/01/13,8,0,4,2,12
2685,2023/01/13,30,8,6,5,36
2723,2023/01/13,11,0,3,0,14
2730,2023/01/13,10,6,3,0,13
2731,2023/01/13,13,0,2,0,15
2732,2023/01/13,6,0,5,0,11
2734,2023/01/13,6,0,0,0,6
2735,2023/01/13,12,4,4,0,16
2761,2023/01/13,21,10,18,0,39
2788,2023/01/13,14,12,17,1,31
2802,2023/01/13,10,0,2,0,12
2812,2023/01/13,6,0,0,0,6
2813,2023/01/13,7,0,2,0,9
2814,2023/01/13,10,0,2,0,12
2913,2023/01/13,1,0,1,0,2
2914,2023/01/13,11,0,1,0,12
3015,2023/01/13,9,0,0,0,9
3033,2023/01/13,9,6,2,0,11
3035,2023/01/13,7,0,1,0,8
4446,2023/01/13,21,12,13,2,34
12136,2023/01/13,16,15,16,0,32
12516,2023/01/13,5,0,2,0,7
12518,2023/01/13,10,4,2,0,12
12523,2023/01/13,4,0,1,0,5
16062,2023/01/13,12,0,3,0,15
16276,2023/01/13,5,0,0,0,5
19322,2023/01/13,11,0,1,0,12
19520,2023/01/13,10,0,1,0,11
20901,2023/01/13,6,0,0,0,6
20920,2023/01/13,16,12,1,0,17
21102,2023/01/13,17,0,0,0,17
21103,2023/01/13,1,0,0,0,1
21132,2023/01/13,18,18,18,0,36
21171,2023/01/13,7,4,2,0,9
21174,2023/01/13,31,12,13,8,44
21175,2023/01/13,18,12,16,2,34
21176,2023/01/13,18,8,15,2,33
75,2023/01/14,23,32,26,0,49
76,2023/01/14,29,36,26,1,55
99,2023/01/14,12,0,0,0,12
117,2023/01/14,2,0,1,0,3
118,2023/01/14,7,0,3,0,10
119,2023/01/14,2,0,2,0,4
120,2023/01/14,1,0,1,0,2
184,2023/01/14,19,9,11,3,30
195,2023/01/14,23,27,25,0,48
218,2023/01/14,22,21,23,0,45
296,2023/01/14,0,0,1,0,1
300,2023/01/14,0,0,4,0,4
304,2023/01/14,10,0,6,0,16
317,2023/01/14,13,6,5,0,18
343,2023/01/14,5,0,1,0,6
353,2023/01/14,8,0,0,0,8
373,2023/01/14,7,0,0,0,7
374,2023/01/14,9,4,6,0,15
388,2023/01/14,15,15,13,0,28
419,2023/01/14,14,0,2,0,16
420,2023/01/14,5,0,0,0,5
462,2023/01/14,15,8,7,0,22
519,2023/01/14,18,6,6,0,24
525,2023/01/14,3,0,2,0,5
596,2023/01/14,11,0,6,0,17
597,2023/01/14,54,0,14,1,68
598,2023/01/14,5,0,2,0,7
1035,2023/01/14,12,0,1,2,13
1084,2023/01/14,25,0,11,1,36
1111,2023/01/14,13,6,3,0,16
1112,2023/01/14,11,0,0,0,11
1113,2023/01/14,8,0,1,0,9
1114,2023/01/14,16,6,11,0,27
1115,2023/01/14,9,0,2,0,11
1117,2023/01/14,5,0,4,0,9
1118,2023/01/14,6,0,1,0,7
1119,2023/01/14,3,0,0,0,3
1692,2023/01/14,9,0,4,0,13
1693,2023/01/14,3,0,0,1,3
1747,2023/01/14,31,20,22,0,53
1772,2023/01/14,5,0,2,0,7
1773,2023/01/14,9,0,0,0,9
1774,2023/01/14,9,0,1,0,10
1782,2023/01/14,25,24,23,0,48
1795,2023/01/14,37,28,30,0,67
1914,2023/01/14,11,0,0,0,11
1915,2023/01/14,10,0,2,0,12
1923,2023/01/14,6,0,0,0,6
1934,2023/01/14,12,5,2,0,14
1963,2023/01/14,15,6,6,0,21
1984,2023/01/14,11,0,1,0,12
2135,2023/01/14,11,6,8,0,19
2136,2023/01/14,5,0,0,0,5
2148,2023/01/14,5,0,1,0,6
2183,2023/01/14,12,6,1,0,13
2193,2023/01/14,17,15,13,0,30
2237,2023/01/14,7,0,4,0,11
2358,2023/01/14,5,4,5,0,10
2361,2023/01/14,14,7,7,0,21
2445,2023/01/14,17,6,4,1,21
2449,2023/01/14,10,6,6,0,16
2451,2023/01/14,10,10,9,0,19
2475,2023/01/14,16,0,3,0,19
2476,2023/01/14,6,0,3,0,9
2507,2023/01/14,36,12,15,3,51
2525,2023/01/14,9,0,2,0,11
2562,2023/01/14,12,0,0,0,12
2582,2023/01/14,7,0,1,0,8
2586,2023/01/14,29,16,27,0,56
2602,2023/01/14,8,0,0,0,8
2631,2023/01/14,8,6,6,0,14
2685,2023/01/14,23,4,9,1,32
2723,2023/01/14,8,0,0,0,8
2730,2023/01/14,7,0,2,0,9
2731,2023/01/14,11,0,3,0,14
2732,2023/01/14,1,0,0,0,1
2734,2023/01/14,6,0,0,0,6
2735,2023/01/14,8,0,4,0,12
2761,2023/01/14,18,15,18,0,36
2788,2023/01/14,12,16,11,0,23
2802,2023/01/14,8,0,0,0,8
2812,2023/01/14,6,0,3,0,9
2813,2023/01/14,5,0,0,0,5
2814,2023/01/14,8,0,0,0,8
2913,2023/01/14,6,6,1,0,7
2914,2023/01/14,10,0,1,0,11
3033,2023/01/14,7,0,1,0,8
3035,2023/01/14,6,0,0,0,6
4446,2023/01/14,9,3,7,1,16
12136,2023/01/14,14,15,16,0,30
12516,2023/01/14,7,4,8,0,15
12518,2023/01/14,8,0,2,0,10
12523,2023/01/14,3,0,0,0,3
16062,2023/01/14,9,0,3,0,12
16276,2023/01/14,9,4,1,0,10
19322,2023/01/14,10,0,1,0,11
19520,2023/01/14,9,0,1,0,10
20901,2023/01/14,6,0,1,0,7
20920,2023/01/14,15,0,1,0,16
21097,2023/01/14,9,0,1,0,10
21103,2023/01/14,11,10,2,0,13
21132,2023/01/14,18,18,19,0,37
21171,2023/01/14,9,4,4,0,13
21174,2023/01/14,18,8,7,0,25
21175,2023/01/14,10,12,9,0,19
21176,2023/01/14,5,4,5,0,10
75,2023/01/15,33,36,36,2,69
76,2023/01/15,35,32,41,0,76
99,2023/01/15,12,0,1,0,13
117,2023/01/15,1,0,1,0,2
118,2023/01/15,4,0,1,1,5
119,2023/01/15,4,4,3,0,7
120,2023/01/15,0,0,0,0,0
184,2023/01/15,14,9,7,1,21
195,2023/01/15,22,24,26,0,48
218,2023/01/15,23,24,36,1,59
296,2023/01/15,7,8,1,0,8
300,2023/01/15,0,4,4,0,4
304,2023/01/15,8,4,6,0,14
317,2023/01/15,14,6,2,0,16
343,2023/01/15,4,0,2,1,6
353,2023/01/15,8,0,0,0,8
373,2023/01/15,7,0,2,0,9
374,2023/01/15,15,12,10,0,25
388,2023/01/15,26,24,21,0,47
419,2023/01/15,12,0,2,0,14
420,2023/01/15,5,0,0,0,5
462,2023/01/15,24,16,8,0,32
519,2023/01/15,12,0,4,0,16
525,2023/01/15,1,0,1,0,2
596,2023/01/15,13,8,4,2,17
597,2023/01/15,63,24,20,2,83
598,2023/01/15,9,6,3,0,12
1035,2023/01/15,15,6,7,0,22
1084,2023/01/15,23,10,9,2,32
1111,2023/01/15,10,0,3,0,13
1112,2023/01/15,11,0,1,0,12
1113,2023/01/15,7,0,2,0,9
1114,2023/01/15,11,6,1,0,12
1115,2023/01/15,13,6,1,0,14
1117,2023/01/15,1,0,0,0,1
1118,2023/01/15,11,6,7,0,18
1119,2023/01/15,3,0,1,0,4
1692,2023/01/15,11,6,6,0,17
1693,2023/01/15,8,6,0,0,8
1747,2023/01/15,29,20,23,0,52
1772,2023/01/15,3,0,0,0,3
1773,2023/01/15,9,0,3,0,12
1774,2023/01/15,8,0,1,0,9
1782,2023/01/15,17,15,19,0,36
1795,2023/01/15,7,0,8,0,15
1914,2023/01/15,11,0,0,0,11
1915,2023/01/15,8,0,1,0,9
1923,2023/01/15,6,0,1,0,7
1934,2023/01/15,10,0,1,3,11
1963,2023/01/15,15,6,4,0,19
1984,2023/01/15,16,6,2,3,18
2135,2023/01/15,3,0,1,0,4
2136,2023/01/15,5,0,0,0,5
2148,2023/01/15,8,4,4,0,12
2183,2023/01/15,17,6,4,0,21
2193,2023/01/15,22,18,20,0,42
2237,2023/01/15,3,0,2,0,5
2358,2023/01/15,12,12,5,0,17
2361,2023/01/15,7,0,4,0,11
2445,2023/01/15,18,6,4,0,22
2449,2023/01/15,4,0,1,0,5
2451,2023/01/15,46,45,16,0,62
2475,2023/01/15,13,0,2,0,15
2476,2023/01/15,3,0,0,0,3
2507,2023/01/15,30,12,12,1,42
2525,2023/01/15,7,0,2,0,9
2562,2023/01/15,12,0,1,0,13
2582,2023/01/15,14,8,1,0,15
2586,2023/01/15,14,12,27,0,41
2602,2023/01/15,8,0,0,0,8
2631,2023/01/15,2,0,0,0,2
2685,2023/01/15,13,0,4,6,17
2723,2023/01/15,8,0,2,0,10
2730,2023/01/15,11,6,2,0,13
2731,2023/01/15,8,0,4,0,12
2732,2023/01/15,1,0,0,0,1
2734,2023/01/15,14,8,1,0,15
2735,2023/01/15,8,4,6,0,14
2761,2023/01/15,20,20,20,0,40
2788,2023/01/15,13,12,16,0,29
2802,2023/01/15,8,0,2,0,10
2812,2023/01/15,3,0,2,0,5
2813,2023/01/15,5,0,1,0,6
2814,2023/01/15,8,0,1,0,9
2913,2023/01/15,5,0,1,0,6
2914,2023/01/15,9,0,2,0,11
3033,2023/01/15,6,0,1,0,7
3035,2023/01/15,6,0,1,0,7
4446,2023/01/15,10,9,10,0,20
12136,2023/01/15,13,15,17,0,30
12516,2023/01/15,-1,0,1,0,0
12518,2023/01/15,10,4,0,0,10
16062,2023/01/15,6,0,0,0,6
16276,2023/01/15,8,0,4,0,12
19322,2023/01/15,9,0,1,0,10
19329,2023/01/15,1,0,1,0,2
19520,2023/01/15,8,0,2,0,10
20901,2023/01/15,5,0,0,0,5
20920,2023/01/15,14,0,1,0,15
21097,2023/01/15,8,0,0,0,8
21103,2023/01/15,9,0,0,0,9
21132,2023/01/15,14,15,19,0,33
21171,2023/01/15,9,4,1,0,10
21174,2023/01/15,19,8,10,4,29
21175,2023/01/15,9,8,12,0,21
21176,2023/01/15,4,4,8,0,12
75,2023/01/16,13,16,12,0,25
76,2023/01/16,42,44,41,0,83
99,2023/01/16,11,0,0,0,11
117,2023/01/16,8,8,0,0,8
118,2023/01/16,2,0,0,0,2
119,2023/01/16,1,0,1,0,2
120,2023/01/16,4,4,2,0,6
184,2023/01/16,15,9,15,0,30
195,2023/01/16,31,33,31,0,62
218,2023/01/16,20,33,24,0,44
296,2023/01/16,10,4,3,0,13
300,2023/01/16,0,4,4,0,4
304,2023/01/16,2,0,2,0,4
317,2023/01/16,16,6,6,0,22
343,2023/01/16,1,0,1,0,2
353,2023/01/16,8,0,0,0,8
373,2023/01/16,13,6,4,0,17
374,2023/01/16,5,0,2,0,7
388,2023/01/16,32,27,27,1,59
419,2023/01/16,17,6,1,0,18
420,2023/01/16,5,0,1,0,6
462,2023/01/16,24,8,12,0,36
519,2023/01/16,6,0,4,0,10
525,2023/01/16,6,5,2,0,8
596,2023/01/16,7,0,6,0,13
597,2023/01/16,41,0,16,4,57
598,2023/01/16,6,0,5,0,11
1035,2023/01/16,8,0,5,0,13
1084,2023/01/16,12,0,9,0,21
1111,2023/01/16,7,0,2,0,9
1112,2023/01/16,10,0,1,0,11
1113,2023/01/16,11,6,1,0,12
1114,2023/01/16,10,0,2,0,12
1115,2023/01/16,12,0,2,0,14
1117,2023/01/16,1,0,0,0,1
1118,2023/01/16,4,0,0,0,4
1119,2023/01/16,2,0,1,0,3
1692,2023/01/16,4,0,1,1,5
1693,2023/01/16,8,0,2,1,10
1747,2023/01/16,11,5,11,0,22
1772,2023/01/16,11,8,4,0,15
1773,2023/01/16,6,0,1,0,7
1774,2023/01/16,7,0,2,0,9
1782,2023/01/16,19,21,17,0,36
1795,2023/01/16,13,14,5,0,18
1914,2023/01/16,11,0,1,0,12
1915,2023/01/16,7,0,1,0,8
1923,2023/01/16,5,0,0,0,5
1934,2023/01/16,6,0,2,3,8
1963,2023/01/16,16,6,3,0,19
1984,2023/01/16,11,0,1,0,12
2135,2023/01/16,2,0,1,0,3
2136,2023/01/16,5,0,0,0,5
2148,2023/01/16,4,0,0,0,4
2183,2023/01/16,13,0,0,0,13
2193,2023/01/16,17,15,19,0,36
2237,2023/01/16,7,6,2,0,9
2358,2023/01/16,7,0,6,0,13
2361,2023/01/16,3,0,3,0,6
2445,2023/01/16,15,0,3,0,18
2449,2023/01/16,7,6,1,0,8
2451,2023/01/16,30,0,17,0,47
2475,2023/01/16,11,0,1,0,12
2476,2023/01/16,9,6,1,0,10
2507,2023/01/16,17,0,10,5,27
2525,2023/01/16,5,0,1,0,6
2562,2023/01/16,10,0,2,1,12
2582,2023/01/16,13,0,7,0,20
2586,2023/01/16,0,12,2,0,2
2602,2023/01/16,8,0,1,0,9
2631,2023/01/16,2,0,1,0,3
2685,2023/01/16,3,0,3,0,6
2723,2023/01/16,14,8,3,0,17
2730,2023/01/16,9,0,1,0,10
2731,2023/01/16,4,0,2,0,6
2732,2023/01/16,9,8,3,0,12
2734,2023/01/16,13,0,1,0,14
2735,2023/01/16,2,0,3,0,5
2761,2023/01/16,15,15,13,0,28
2788,2023/01/16,17,20,15,0,32
2802,2023/01/16,6,0,1,0,7
2812,2023/01/16,1,0,0,0,1
2813,2023/01/16,4,0,0,0,4
2814,2023/01/16,7,0,0,0,7
2913,2023/01/16,5,0,3,0,8
2914,2023/01/16,7,0,0,0,7
3033,2023/01/16,5,0,0,0,5
3035,2023/01/16,5,0,1,0,6
4446,2023/01/16,15,15,17,0,32
12136,2023/01/16,26,30,28,0,54
12516,2023/01/16,-2,0,0,0,-2
12518,2023/01/16,10,0,4,0,14
16062,2023/01/16,12,6,1,0,13
16276,2023/01/16,4,0,0,0,4
19322,2023/01/16,8,0,0,0,8
19329,2023/01/16,6,6,1,0,7
19520,2023/01/16,6,0,1,0,7
20901,2023/01/16,5,0,1,0,6
20920,2023/01/16,13,0,0,0,13
21097,2023/01/16,8,0,0,0,8
21102,2023/01/16,17,0,2,0,19
21103,2023/01/16,9,0,2,0,11
21132,2023/01/16,16,21,18,0,34
21171,2023/01/16,12,4,4,1,16
21174,2023/01/16,13,8,12,0,25
21175,2023/01/16,5,8,5,0,10
21176,2023/01/16,0,4,0,0,0
75,2023/01/17,39,40,35,0,74
76,2023/01/17,45,48,41,0,86
99,2023/01/17,11,0,1,0,12
117,2023/01/17,8,0,1,0,9
118,2023/01/17,10,8,3,0,13
119,2023/01/17,4,4,1,0,5
120,2023/01/17,6,4,0,0,6
184,2023/01/17,12,12,10,0,22
195,2023/01/17,34,36,33,0,67
218,2023/01/17,28,33,30,0,58
296,2023/01/17,11,4,3,0,14
300,2023/01/17,0,4,4,0,4
304,2023/01/17,4,4,4,0,8
317,2023/01/17,10,0,2,0,12
343,2023/01/17,8,8,0,0,8
353,2023/01/17,8,0,1,0,9
373,2023/01/17,9,0,2,0,11
374,2023/01/17,7,4,3,0,10
388,2023/01/17,37,33,19,0,56
419,2023/01/17,22,6,2,0,24
420,2023/01/17,10,6,0,0,10
462,2023/01/17,20,8,9,0,29
519,2023/01/17,14,12,0,0,14
525,2023/01/17,4,0,0,0,4
596,2023/01/17,9,8,6,0,15
597,2023/01/17,21,0,11,4,32
598,2023/01/17,7,6,5,0,12
1035,2023/01/17,3,0,3,0,6
1084,2023/01/17,13,10,8,0,21
1111,2023/01/17,5,0,1,0,6
1112,2023/01/17,9,0,1,0,10
1113,2023/01/17,10,0,2,0,12
1114,2023/01/17,14,6,5,0,19
1115,2023/01/17,10,0,1,0,11
1117,2023/01/17,1,0,0,0,1
1118,2023/01/17,10,6,2,0,12
1119,2023/01/17,1,0,0,0,1
1692,2023/01/17,2,0,0,0,2
1693,2023/01/17,5,0,1,0,6
1747,2023/01/17,30,30,24,0,54
1772,2023/01/17,7,0,3,0,10
1773,2023/01/17,5,0,1,0,6
1774,2023/01/17,5,0,0,0,5
1782,2023/01/17,26,24,24,0,50
1795,2023/01/17,22,14,11,0,33
1914,2023/01/17,10,0,1,0,11
1915,2023/01/17,12,6,2,0,14
1923,2023/01/17,5,0,0,0,5
1934,2023/01/17,1,0,1,0,2
1963,2023/01/17,19,6,3,0,22
1984,2023/01/17,10,0,0,4,10
2135,2023/01/17,7,6,2,0,9
2136,2023/01/17,5,0,0,0,5
2148,2023/01/17,4,0,0,0,4
2183,2023/01/17,13,0,2,0,15
2193,2023/01/17,19,21,15,0,34
2237,2023/01/17,11,6,3,0,14
2358,2023/01/17,5,4,8,0,13
2361,2023/01/17,7,7,3,0,10
2445,2023/01/17,12,0,10,1,22
2449,2023/01/17,6,0,3,0,9
2451,2023/01/17,13,0,4,0,17
2475,2023/01/17,10,0,2,0,12
2476,2023/01/17,14,6,2,0,16
2507,2023/01/17,15,12,12,0,27
2525,2023/01/17,4,0,1,0,5
2562,2023/01/17,13,6,2,0,15
2582,2023/01/17,6,0,5,0,11
2586,2023/01/17,13,16,13,0,26
2602,2023/01/17,7,0,0,0,7
2631,2023/01/17,7,6,3,0,10
2685,2023/01/17,8,8,5,0,13
2723,2023/01/17,11,0,4,0,15
2730,2023/01/17,8,0,1,0,9
2731,2023/01/17,8,6,2,0,10
2732,2023/01/17,6,0,5,0,11
2734,2023/01/17,12,0,3,0,15
2735,2023/01/17,3,4,4,0,7
2761,2023/01/17,22,20,19,0,41
2788,2023/01/17,22,20,16,0,38
2802,2023/01/17,5,0,1,0,6
2812,2023/01/17,7,6,0,0,7
2813,2023/01/17,4,0,0,0,4
2814,2023/01/17,7,0,2,0,9
2913,2023/01/17,2,0,1,0,3
2914,2023/01/17,7,0,1,0,8
3033,2023/01/17,5,0,0,0,5
3035,2023/01/17,4,0,0,0,4
4446,2023/01/17,10,12,11,0,21
12136,2023/01/17,34,36,30,0,64
12516,2023/01/17,2,4,2,0,4
12518,2023/01/17,6,0,0,0,6
16062,2023/01/17,11,0,1,0,12
16276,2023/01/17,4,0,1,0,5
19322,2023/01/17,8,0,1,0,9
19329,2023/01/17,5,0,0,0,5
19520,2023/01/17,5,0,0,0,5
20901,2023/01/17,4,0,0,0,4
20920,2023/01/17,13,0,0,0,13
21097,2023/01/17,8,0,0,0,8
21102,2023/01/17,15,0,0,0,15
21103,2023/01/17,7,0,2,0,9
21132,2023/01/17,16,18,13,0,29
21171,2023/01/17,7,0,1,0,8
21174,2023/01/17,17,16,9,0,26
21175,2023/01/17,12,12,14,0,26
21176,2023/01/17,8,8,1,0,9
75,2023/01/18,34,36,38,2,72
76,2023/01/18,37,40,38,0,75
99,2023/01/18,10,0,1,0,11
117,2023/01/18,7,0,1,0,8
118,2023/01/18,7,0,2,0,9
119,2023/01/18,7,4,2,0,9
120,2023/01/18,6,0,4,0,10
184,2023/01/18,12,12,8,0,20
195,2023/01/18,26,30,31,0,57
218,2023/01/18,29,30,30,1,59
296,2023/01/18,16,8,8,0,24
300,2023/01/18,0,4,4,0,4
304,2023/01/18,4,4,4,0,8
317,2023/01/18,20,12,7,0,27
343,2023/01/18,8,0,1,0,9
353,2023/01/18,7,0,0,0,7
373,2023/01/18,13,6,5,0,18
374,2023/01/18,8,4,5,0,13
388,2023/01/18,44,27,23,9,67
419,2023/01/18,26,6,6,3,32
420,2023/01/18,10,0,3,0,13
462,2023/01/18,11,0,6,1,17
519,2023/01/18,20,6,2,0,22
525,2023/01/18,4,0,2,0,6
596,2023/01/18,12,8,4,0,16
597,2023/01/18,16,12,12,0,28
598,2023/01/18,2,0,0,0,2
1035,2023/01/18,0,0,0,0,0
1084,2023/01/18,11,10,9,0,20
1111,2023/01/18,4,0,2,0,6
1112,2023/01/18,8,0,0,0,8
1113,2023/01/18,8,0,1,0,9
1114,2023/01/18,9,0,2,0,11
1115,2023/01/18,9,0,2,0,11
1117,2023/01/18,1,0,0,0,1
1118,2023/01/18,8,0,2,0,10
1119,2023/01/18,1,0,1,0,2
1692,2023/01/18,8,6,4,1,12
1693,2023/01/18,4,0,0,0,4
1747,2023/01/18,32,30,24,0,56
1772,2023/01/18,4,0,1,0,5
1773,2023/01/18,10,6,1,0,11
1774,2023/01/18,5,0,1,0,6
1782,2023/01/18,27,27,26,0,53
1795,2023/01/18,24,14,24,0,48
1914,2023/01/18,9,0,1,0,10
1915,2023/01/18,10,0,3,0,13
1923,2023/01/18,5,0,0,0,5
1934,2023/01/18,0,0,0,0,0
1963,2023/01/18,22,6,7,0,29
1984,2023/01/18,6,0,3,0,9
2135,2023/01/18,5,0,1,0,6
2136,2023/01/18,5,0,0,0,5
2148,2023/01/18,8,4,4,0,12
2183,2023/01/18,11,0,3,5,14
2193,2023/01/18,24,21,22,0,46
2237,2023/01/18,8,0,1,0,9
2358,2023/01/18,5,8,3,0,8
2361,2023/01/18,11,7,5,0,16
2445,2023/01/18,7,6,4,0,11
2449,2023/01/18,9,6,2,0,11
2451,2023/01/18,8,0,10,0,18
2475,2023/01/18,8,0,0,0,8
2476,2023/01/18,12,0,1,0,13
2507,2023/01/18,14,12,3,0,17
2525,2023/01/18,9,6,0,0,9
2562,2023/01/18,11,0,4,0,15
2582,2023/01/18,1,0,1,0,2
2586,2023/01/18,25,24,14,0,39
2602,2023/01/18,7,0,0,0,7
2631,2023/01/18,4,0,4,0,8
2685,2023/01/18,11,8,6,0,17
2723,2023/01/18,7,0,5,0,12
2730,2023/01/18,7,0,2,0,9
2731,2023/01/18,6,0,0,0,6
2732,2023/01/18,1,0,0,0,1
2734,2023/01/18,9,0,3,0,12
2735,2023/01/18,3,4,3,0,6
2761,2023/01/18,22,20,21,0,43
2788,2023/01/18,20,16,20,1,40
2802,2023/01/18,4,0,0,0,4
2812,2023/01/18,7,0,1,0,8
2813,2023/01/18,10,6,0,0,10
2814,2023/01/18,5,0,1,0,6
2913,2023/01/18,7,6,3,0,10
2914,2023/01/18,6,0,2,0,8
3033,2023/01/18,11,6,2,0,13
3035,2023/01/18,4,0,0,0,4
4446,2023/01/18,11,12,10,0,21
12136,2023/01/18,36,30,34,0,70
12516,2023/01/18,4,4,4,0,8
12518,2023/01/18,10,4,3,0,13
16062,2023/01/18,10,0,1,0,11
16276,2023/01/18,3,0,0,0,3
19322,2023/01/18,7,0,1,0,8
19329,2023/01/18,5,0,0,0,5
19520,2023/01/18,5,0,2,0,7
20901,2023/01/18,4,0,0,0,4
20920,2023/01/18,13,0,0,0,13
21097,2023/01/18,8,0,0,0,8
21103,2023/01/18,5,0,1,0,6
21132,2023/01/18,22,18,20,0,42
21171,2023/01/18,10,4,5,3,15
21174,2023/01/18,15,8,10,0,25
21175,2023/01/18,6,8,6,0,12
21176,2023/01/18,16,8,9,0,25
75,2023/01/19,34,40,44,1,78
76,2023/01/19,43,44,56,1,99
99,2023/01/19,9,0,0,0,9
117,2023/01/19,6,0,1,0,7
118,2023/01/19,13,8,2,0,15
119,2023/01/19,5,0,2,0,7
120,2023/01/19,6,4,4,0,10
184,2023/01/19,16,12,9,0,25
195,2023/01/19,31,36,28,0,59
218,2023/01/19,31,33,38,0,69
296,2023/01/19,8,0,1,0,9
300,2023/01/19,4,8,2,0,6
304,2023/01/19,4,4,3,0,7
317,2023/01/19,13,0,2,0,15
343,2023/01/19,15,8,0,0,15
353,2023/01/19,7,0,2,0,9
373,2023/01/19,8,0,2,0,10
374,2023/01/19,7,4,3,0,10
388,2023/01/19,31,18,23,7,54
419,2023/01/19,23,6,3,0,26
420,2023/01/19,7,0,2,0,9
462,2023/01/19,12,8,7,0,19
519,2023/01/19,24,6,3,1,27
525,2023/01/19,2,0,0,0,2
596,2023/01/19,12,4,4,0,16
597,2023/01/19,4,0,6,0,10
598,2023/01/19,2,0,2,0,4
1035,2023/01/19,6,6,1,0,7
1084,2023/01/19,17,15,12,0,29
1111,2023/01/19,8,6,0,0,8
1112,2023/01/19,8,0,0,0,8
1113,2023/01/19,7,0,0,0,7
1114,2023/01/19,7,0,1,0,8
1115,2023/01/19,7,0,3,0,10
1117,2023/01/19,1,0,0,0,1
1118,2023/01/19,12,6,2,0,14
1119,2023/01/19,0,0,1,0,1
1692,2023/01/19,9,6,5,0,14
1693,2023/01/19,4,0,0,0,4
1747,2023/01/19,33,25,20,0,53
1772,2023/01/19,11,8,3,0,14
1773,2023/01/19,9,0,2,0,11
1774,2023/01/19,12,8,1,0,13
1782,2023/01/19,22,21,27,0,49
1795,2023/01/19,21,21,15,0,36
1914,2023/01/19,8,0,1,0,9
1915,2023/01/19,7,0,0,0,7
1923,2023/01/19,11,6,0,0,11
1934,2023/01/19,5,5,5,0,10
1963,2023/01/19,15,0,3,0,18
1984,2023/01/19,3,0,0,3,3
2135,2023/01/19,4,0,2,0,6
2136,2023/01/19,5,0,1,0,6
2148,2023/01/19,4,0,0,0,4
2183,2023/01/19,3,0,3,0,6
2193,2023/01/19,17,15,18,0,35
2237,2023/01/19,7,0,3,0,10
2358,2023/01/19,6,4,1,0,7
2361,2023/01/19,6,0,4,0,10
2445,2023/01/19,3,0,3,0,6
2449,2023/01/19,7,0,2,0,9
2451,2023/01/19,18,20,16,0,34
2475,2023/01/19,8,0,0,0,8
2476,2023/01/19,11,0,2,0,13
2507,2023/01/19,17,6,11,0,28
2525,2023/01/19,9,0,2,0,11
2562,2023/01/19,7,0,2,0,9
2582,2023/01/19,0,0,0,0,0
2586,2023/01/19,27,16,14,0,41
2602,2023/01/19,7,0,0,0,7
2631,2023/01/19,6,6,1,0,7
2685,2023/01/19,9,4,4,0,13
2723,2023/01/19,2,0,2,0,4
2730,2023/01/19,5,0,0,0,5
2731,2023/01/19,6,0,2,0,8
2732,2023/01/19,9,8,1,0,10
2734,2023/01/19,6,0,0,0,6
2735,2023/01/19,4,4,2,0,6
2761,2023/01/19,16,15,10,0,26
2788,2023/01/19,23,24,12,0,35
2802,2023/01/19,4,0,0,0,4
2812,2023/01/19,6,0,4,0,10
2813,2023/01/19,10,0,2,0,12
2814,2023/01/19,4,0,1,0,5
2913,2023/01/19,4,0,0,0,4
2914,2023/01/19,4,0,0,0,4
3033,2023/01/19,9,0,2,0,11
3035,2023/01/19,10,6,0,0,10
4446,2023/01/19,13,12,12,0,25
12136,2023/01/19,30,27,21,4,51
12516,2023/01/19,4,4,2,0,6
12518,2023/01/19,7,0,2,0,9
16062,2023/01/19,9,0,1,0,10
16276,2023/01/19,7,4,0,0,7
19322,2023/01/19,6,0,0,0,6
19329,2023/01/19,5,0,1,0,6
19520,2023/01/19,11,8,3,0,14
20901,2023/01/19,10,6,0,0,10
20920,2023/01/19,13,0,1,0,14
21097,2023/01/19,8,0,0,0,8
21103,2023/01/19,14,10,0,0,14
21132,2023/01/19,23,21,13,2,36
21171,2023/01/19,6,4,2,0,8
21174,2023/01/19,13,8,4,3,17
21175,2023/01/19,12,12,9,0,21
21176,2023/01/19,11,4,9,1,20
75,2023/01/20,29,40,36,0,65
76,2023/01/20,30,44,44,0,74
99,2023/01/20,9,0,0,0,9
117,2023/01/20,5,0,0,0,5
118,2023/01/20,11,0,1,0,12
119,2023/01/20,7,4,1,0,8
120,2023/01/20,2,0,1,0,3
184,2023/01/20,25,18,16,1,41
195,2023/01/20,30,27,36,1,66
218,2023/01/20,23,30,26,0,49
296,2023/01/20,7,0,5,0,12
300,2023/01/20,6,4,7,0,13
304,2023/01/20,5,4,3,0,8
317,2023/01/20,17,6,1,0,18
343,2023/01/20,15,0,1,0,16
353,2023/01/20,5,0,0,0,5
373,2023/01/20,6,0,1,0,7
374,2023/01/20,8,4,3,0,11
388,2023/01/20,27,27,21,1,48
419,2023/01/20,20,0,3,0,23
420,2023/01/20,5,0,1,3,6
462,2023/01/20,13,8,6,0,19
519,2023/01/20,32,12,11,0,43
525,2023/01/20,7,5,1,0,8
596,2023/01/20,20,12,5,0,25
597,2023/01/20,22,24,11,0,33
598,2023/01/20,6,6,3,2,9
1035,2023/01/20,11,6,10,0,21
1084,2023/01/20,25,20,12,0,37
1111,2023/01/20,8,0,3,0,11
1112,2023/01/20,8,0,1,0,9
1113,2023/01/20,7,0,1,0,8
1114,2023/01/20,12,6,6,0,18
1115,2023/01/20,10,6,3,0,13
1117,2023/01/20,1,0,0,0,1
1118,2023/01/20,10,0,4,0,14
1119,2023/01/20,-1,0,1,0,0
1692,2023/01/20,4,0,1,0,5
1693,2023/01/20,10,6,2,0,12
1747,2023/01/20,33,20,22,1,55
1772,2023/01/20,8,0,4,0,12
1773,2023/01/20,7,0,0,0,7
1774,2023/01/20,11,0,0,0,11
1782,2023/01/20,25,30,24,0,49
1795,2023/01/20,20,14,16,0,36
1914,2023/01/20,7,0,1,0,8
1915,2023/01/20,7,0,0,0,7
1923,2023/01/20,11,0,4,0,15
1934,2023/01/20,5,5,2,0,7
1963,2023/01/20,12,0,6,0,18
1984,2023/01/20,0,0,1,0,1
2135,2023/01/20,8,6,4,0,12
2136,2023/01/20,4,0,2,0,6
2148,2023/01/20,8,4,1,0,9
2183,2023/01/20,0,0,0,0,0
2193,2023/01/20,21,21,17,0,38
2237,2023/01/20,10,6,1,0,11
2358,2023/01/20,9,4,5,0,14
2361,2023/01/20,9,7,8,0,17
2445,2023/01/20,6,6,6,0,12
2449,2023/01/20,11,6,3,0,14
2451,2023/01/20,17,15,13,0,30
2475,2023/01/20,8,0,0,0,8
2476,2023/01/20,9,0,1,0,10
2507,2023/01/20,18,12,10,0,28
2525,2023/01/20,7,0,2,0,9
2562,2023/01/20,5,0,1,3,6
2582,2023/01/20,4,4,2,0,6
2586,2023/01/20,33,20,26,1,59
2602,2023/01/20,7,0,1,0,8
2631,2023/01/20,5,0,5,0,10
2685,2023/01/20,13,8,13,0,26
2723,2023/01/20,8,8,1,0,9
2730,2023/01/20,11,6,0,0,11
2731,2023/01/20,10,6,3,0,13
2732,2023/01/20,8,0,3,0,11
2734,2023/01/20,6,0,0,0,6
2735,2023/01/20,6,4,2,0,8
2761,2023/01/20,26,20,22,0,48
2788,2023/01/20,27,16,22,7,49
2802,2023/01/20,10,6,0,0,10
2812,2023/01/20,2,0,0,0,2
2813,2023/01/20,8,0,4,0,12
2814,2023/01/20,3,0,0,0,3
2913,2023/01/20,4,0,1,0,5
2914,2023/01/20,4,0,0,0,4
3033,2023/01/20,7,0,0,0,7
3035,2023/01/20,10,0,0,0,10
4446,2023/01/20,16,15,16,0,32
12136,2023/01/20,28,24,30,0,58
12516,2023/01/20,6,4,3,0,9
12518,2023/01/20,9,4,1,0,10
16062,2023/01/20,8,0,1,0,9
16276,2023/01/20,7,0,0,0,7
19322,2023/01/20,6,0,0,0,6
19329,2023/01/20,10,6,1,0,11
19520,2023/01/20,8,0,2,0,10
20901,2023/01/20,10,0,1,0,11
20920,2023/01/20,12,0,2,0,14
21097,2023/01/20,8,0,1,0,9
21103,2023/01/20,14,0,0,0,14
21132,2023/01/20,29,21,26,3,55
21171,2023/01/20,4,0,1,0,5
21174,2023/01/20,22,16,10,0,32
21175,2023/01/20,15,12,11,0,26
21176,2023/01/20,9,8,8,0,17
75,2023/01/21,29,36,35,0,64
76,2023/01/21,27,40,37,0,64
99,2023/01/21,9,0,0,0,9
117,2023/01/21,5,0,2,0,7
118,2023/01/21,10,0,1,0,11
119,2023/01/21,6,0,3,0,9
120,2023/01/21,1,0,2,0,3
184,2023/01/21,20,12,14,0,34
195,2023/01/21,26,33,30,0,56
218,2023/01/21,22,24,23,0,45
296,2023/01/21,2,0,3,0,5
300,2023/01/21,3,4,1,0,4
304,2023/01/21,6,4,3,0,9
317,2023/01/21,16,0,6,0,22
343,2023/01/21,14,0,0,0,14
353,2023/01/21,5,0,0,0,5
373,2023/01/21,11,6,1,0,12
374,2023/01/21,9,4,5,0,14
388,2023/01/21,14,9,14,1,28
419,2023/01/21,17,0,3,0,20
420,2023/01/21,1,0,1,0,2
462,2023/01/21,15,8,6,0,21
519,2023/01/21,21,0,11,0,32
525,2023/01/21,6,0,2,0,8
596,2023/01/21,15,0,6,0,21
597,2023/01/21,11,0,8,1,19
598,2023/01/21,1,0,1,0,2
1035,2023/01/21,1,0,3,0,4
1084,2023/01/21,13,0,12,0,25
1111,2023/01/21,11,6,4,0,15
1112,2023/01/21,7,0,0,0,7
1113,2023/01/21,12,6,4,0,16
1114,2023/01/21,12,6,2,0,14
1115,2023/01/21,7,0,3,0,10
1117,2023/01/21,1,0,0,0,1
1118,2023/01/21,6,0,3,0,9
1119,2023/01/21,-2,0,0,0,-2
1692,2023/01/21,3,0,3,0,6
1693,2023/01/21,8,0,0,0,8
1747,2023/01/21,30,20,24,1,54
1772,2023/01/21,4,0,1,0,5
1773,2023/01/21,7,0,1,0,8
1774,2023/01/21,11,0,1,0,12
1782,2023/01/21,25,24,24,0,49
1795,2023/01/21,39,35,24,0,63
1914,2023/01/21,6,0,0,0,6
1915,2023/01/21,13,6,6,0,19
1923,2023/01/21,7,0,1,0,8
1934,2023/01/21,3,0,1,0,4
1963,2023/01/21,12,6,1,0,13
1984,2023/01/21,5,6,4,0,9
2135,2023/01/21,10,6,3,0,13
2136,2023/01/21,2,0,0,0,2
2148,2023/01/21,7,0,1,0,8
2183,2023/01/21,0,0,0,0,0
2193,2023/01/21,12,9,12,0,24
2237,2023/01/21,9,0,3,0,12
2358,2023/01/21,8,4,4,0,12
2361,2023/01/21,1,0,1,0,2
2445,2023/01/21,6,6,2,0,8
2449,2023/01/21,8,0,2,0,10
2451,2023/01/21,19,15,8,0,27
2475,2023/01/21,14,6,0,0,14
2476,2023/01/21,14,6,1,0,15
2507,2023/01/21,26,18,13,0,39
2525,2023/01/21,5,0,1,0,6
2562,2023/01/21,7,6,1,0,8
2582,2023/01/21,6,4,3,0,9
2586,2023/01/21,23,16,23,0,46
2602,2023/01/21,6,0,1,0,7
2631,2023/01/21,6,6,5,0,11
2685,2023/01/21,8,8,5,0,13
2723,2023/01/21,7,0,4,0,11
2730,2023/01/21,11,0,3,0,14
2731,2023/01/21,13,6,3,0,16
2732,2023/01/21,13,8,3,0,16
2734,2023/01/21,6,0,0,0,6
2735,2023/01/21,12,8,1,0,13
2761,2023/01/21,24,20,29,0,53
2788,2023/01/21,18,20,18,0,36
2802,2023/01/21,10,0,0,0,10
2812,2023/01/21,8,6,0,0,8
2813,2023/01/21,4,0,1,0,5
2814,2023/01/21,9,6,3,0,12
2913,2023/01/21,9,6,1,0,10
2914,2023/01/21,10,6,1,0,11
3033,2023/01/21,7,0,0,0,7
3035,2023/01/21,10,0,0,0,10
4446,2023/01/21,12,12,12,0,24
12136,2023/01/21,10,12,11,0,21
12516,2023/01/21,3,0,1,0,4
12518,2023/01/21,8,0,0,0,8
16062,2023/01/21,7,0,1,0,8
16276,2023/01/21,7,0,0,0,7
19322,2023/01/21,6,0,1,0,7
19329,2023/01/21,9,0,6,0,15
19520,2023/01/21,6,0,2,0,8
20901,2023/01/21,9,0,2,0,11
20920,2023/01/21,10,0,0,0,10
21097,2023/01/21,7,0,0,0,7
21103,2023/01/21,14,0,1,0,15
21132,2023/01/21,18,18,17,0,35
21171,2023/01/21,7,4,3,0,10
21174,2023/01/21,24,12,17,5,41
21175,2023/01/21,16,12,13,2,29
21176,2023/01/21,9,8,3,0,12
75,2023/01/22,30,36,41,0,71
76,2023/01/22,33,44,34,0,67
99,2023/01/22,9,0,0,0,9
117,2023/01/22,11,8,1,2,12
118,2023/01/22,9,0,2,0,11
119,2023/01/22,4,0,2,0,6
120,2023/01/22,4,4,2,0,6
149,2023/01/22,6,0,1,0,7
184,2023/01/22,12,6,3,0,15
195,2023/01/22,23,27,28,0,51
218,2023/01/22,31,33,37,0,68
296,2023/01/22,8,8,5,0,13
300,2023/01/22,14,8,2,0,16
304,2023/01/22,11,8,2,0,13
317,2023/01/22,10,0,6,0,16
343,2023/01/22,14,0,3,0,17
353,2023/01/22,5,0,1,0,6
373,2023/01/22,10,0,3,0,13
374,2023/01/22,15,12,2,0,17
388,2023/01/22,23,24,21,0,44
419,2023/01/22,14,0,5,4,19
420,2023/01/22,0,0,0,0,0
462,2023/01/22,24,8,13,0,37
519,2023/01/22,10,0,9,0,19
525,2023/01/22,4,0,1,0,5
596,2023/01/22,13,4,6,3,19
597,2023/01/22,26,24,12,0,38
598,2023/01/22,6,6,1,0,7
1035,2023/01/22,4,6,3,0,7
1084,2023/01/22,11,10,8,0,19
1111,2023/01/22,7,0,0,0,7
1112,2023/01/22,7,0,0,0,7
1113,2023/01/22,8,0,0,0,8
1114,2023/01/22,10,0,2,0,12
1115,2023/01/22,10,6,2,0,12
1117,2023/01/22,1,0,0,0,1
1118,2023/01/22,9,6,5,0,14
1692,2023/01/22,6,6,4,0,10
1693,2023/01/22,8,0,3,0,11
1747,2023/01/22,25,20,17,1,42
1772,2023/01/22,3,0,0,0,3
1773,2023/01/22,6,0,3,0,9
1774,2023/01/22,10,0,1,0,11
1782,2023/01/22,22,21,13,0,35
1795,2023/01/22,15,0,9,0,24
1914,2023/01/22,12,6,6,0,18
1915,2023/01/22,7,0,0,0,7
1923,2023/01/22,6,0,1,0,7
1934,2023/01/22,7,5,4,0,11
1963,2023/01/22,11,0,8,0,19
1984,2023/01/22,1,0,0,0,1
2135,2023/01/22,13,6,5,0,18
2136,2023/01/22,2,0,0,0,2
2148,2023/01/22,8,8,4,0,12
2183,2023/01/22,6,6,5,0,11
2193,2023/01/22,24,24,11,0,35
2237,2023/01/22,12,6,7,0,19
2358,2023/01/22,16,12,6,0,22
2361,2023/01/22,7,7,6,0,13
2445,2023/01/22,10,6,8,0,18
2449,2023/01/22,6,0,1,2,7
2451,2023/01/22,61,50,15,0,76
2475,2023/01/22,14,0,0,0,14
2476,2023/01/22,13,0,1,0,14
2507,2023/01/22,25,12,9,0,34
2525,2023/01/22,10,6,1,0,11
2562,2023/01/22,6,0,2,0,8
2582,2023/01/22,4,0,2,0,6
2586,2023/01/22,19,20,15,0,34
2602,2023/01/22,5,0,0,0,5
2631,2023/01/22,7,6,1,0,8
2685,2023/01/22,7,4,2,0,9
2723,2023/01/22,11,8,1,0,12
2730,2023/01/22,14,6,4,0,18
2731,2023/01/22,10,0,1,0,11
2732,2023/01/22,10,0,1,0,11
2734,2023/01/22,4,4,0,0,4
2735,2023/01/22,16,4,2,0,18
2761,2023/01/22,15,20,11,0,26
2788,2023/01/22,20,20,13,0,33
2802,2023/01/22,10,0,0,0,10
2812,2023/01/22,8,0,1,0,9
2813,2023/01/22,3,0,1,0,4
2814,2023/01/22,6,0,1,0,7
2913,2023/01/22,8,0,2,0,10
2914,2023/01/22,9,0,2,0,11
3033,2023/01/22,13,6,2,0,15
3035,2023/01/22,10,0,1,0,11
4446,2023/01/22,12,12,7,0,19
12136,2023/01/22,20,21,21,0,41
12516,2023/01/22,8,4,3,0,11
12518,2023/01/22,10,4,5,0,15
16062,2023/01/22,6,0,0,0,6
16276,2023/01/22,5,0,1,0,6
19322,2023/01/22,11,6,0,0,11
19329,2023/01/22,3,0,2,0,5
19520,2023/01/22,12,8,4,0,16
20901,2023/01/22,7,0,1,0,8
20920,2023/01/22,10,0,0,0,10
21097,2023/01/22,7,0,0,0,7
21103,2023/01/22,13,0,1,0,14
21132,2023/01/22,19,18,7,2,26
21171,2023/01/22,8,4,1,0,9
21174,2023/01/22,14,12,11,3,25
21175,2023/01/22,13,12,11,0,24
21176,2023/01/22,14,8,3,0,17
75,2023/01/23,29,40,32,0,61
76,2023/01/23,43,44,48,0,91
99,2023/01/23,9,0,1,0,10
117,2023/01/23,8,0,0,0,8
118,2023/01/23,7,0,2,2,9
119,2023/01/23,6,4,1,0,7
120,2023/01/23,2,0,0,0,2
149,2023/01/23,5,0,0,0,5
184,2023/01/23,18,9,9,4,27
195,2023/01/23,25,30,26,0,51
218,2023/01/23,27,33,24,0,51
296,2023/01/23,7,4,7,0,14
300,2023/01/23,16,4,7,0,23
304,2023/01/23,13,4,8,0,21
317,2023/01/23,10,6,6,0,16
343,2023/01/23,11,0,2,3,13
353,2023/01/23,4,0,0,0,4
373,2023/01/23,7,0,3,0,10
374,2023/01/23,13,0,11,0,24
388,2023/01/23,29,27,28,0,57
419,2023/01/23,5,0,3,1,8
420,2023/01/23,6,6,1,0,7
462,2023/01/23,27,16,10,0,37
519,2023/01/23,7,6,3,0,10
525,2023/01/23,8,5,1,1,9
596,2023/01/23,12,8,6,0,18
597,2023/01/23,32,18,12,0,44
598,2023/01/23,5,0,2,0,7
1035,2023/01/23,1,0,1,0,2
1084,2023/01/23,18,15,13,0,31
1111,2023/01/23,7,0,0,0,7
1112,2023/01/23,7,0,0,0,7
1113,2023/01/23,8,0,0,0,8
1114,2023/01/23,14,6,3,0,17
1115,2023/01/23,8,0,3,0,11
1117,2023/01/23,1,0,1,0,2
1118,2023/01/23,11,6,1,0,12
1692,2023/01/23,2,0,2,0,4
1693,2023/01/23,5,0,1,0,6
1747,2023/01/23,32,25,32,0,64
1772,2023/01/23,3,0,0,0,3
1773,2023/01/23,3,0,1,0,4
1774,2023/01/23,9,0,0,0,9
1782,2023/01/23,30,21,25,0,55
1795,2023/01/23,13,7,13,0,26
1914,2023/01/23,6,0,0,0,6
1915,2023/01/23,7,0,1,0,8
1923,2023/01/23,11,6,2,0,13
1934,2023/01/23,3,0,1,0,4
1963,2023/01/23,9,6,7,0,16
1984,2023/01/23,1,0,0,0,1
2135,2023/01/23,8,0,2,0,10
2136,2023/01/23,2,0,0,0,2
2148,2023/01/23,4,0,1,0,5
2183,2023/01/23,1,0,0,0,1
2193,2023/01/23,34,21,19,6,53
2237,2023/01/23,11,6,2,0,13
2358,2023/01/23,10,0,7,0,17
2361,2023/01/23,8,7,4,0,12
2445,2023/01/23,8,6,2,0,10
2449,2023/01/23,3,0,3,0,6
2451,2023/01/23,46,0,19,0,65
2475,2023/01/23,14,0,1,0,15
2476,2023/01/23,12,0,0,0,12
2507,2023/01/23,28,12,8,0,36
2525,2023/01/23,9,0,1,0,10
2562,2023/01/23,4,0,2,0,6
2582,2023/01/23,2,0,0,0,2
2586,2023/01/23,16,12,15,0,31
2602,2023/01/23,5,0,0,0,5
2631,2023/01/23,6,0,3,0,9
2685,2023/01/23,13,8,4,0,17
2723,2023/01/23,10,0,3,0,13
2730,2023/01/23,10,0,0,0,10
2731,2023/01/23,9,0,0,0,9
2732,2023/01/23,9,0,1,0,10
2734,2023/01/23,4,0,1,0,5
2735,2023/01/23,18,4,5,0,23
2761,2023/01/23,19,15,18,0,37
2788,2023/01/23,19,12,19,0,38
2802,2023/01/23,10,0,0,0,10
2812,2023/01/23,7,0,2,0,9
2813,2023/01/23,9,6,2,0,11
2814,2023/01/23,5,0,2,0,7
2913,2023/01/23,6,0,0,0,6
2914,2023/01/23,7,0,2,0,9
3033,2023/01/23,11,0,1,0,12
3035,2023/01/23,9,0,0,0,9
4446,2023/01/23,23,18,12,0,35
12136,2023/01/23,29,30,28,0,57
12516,2023/01/23,5,0,1,0,6
12518,2023/01/23,9,4,3,0,12
16062,2023/01/23,12,6,0,0,12
16276,2023/01/23,4,0,1,0,5
19322,2023/01/23,11,0,0,0,11
19329,2023/01/23,1,0,0,0,1
19520,2023/01/23,8,0,5,0,13
20901,2023/01/23,6,0,0,0,6
20920,2023/01/23,10,0,1,0,11
21097,2023/01/23,7,0,0,0,7
21102,2023/01/23,15,0,0,0,15
21103,2023/01/23,12,0,0,0,12
21132,2023/01/23,28,18,20,4,48
21171,2023/01/23,11,4,3,0,14
21174,2023/01/23,12,12,5,0,17
21175,2023/01/23,14,12,13,0,27
21176,2023/01/23,19,8,2,3,21
75,2023/01/24,33,36,34,0,67
76,2023/01/24,39,44,44,0,83
99,2023/01/24,8,0,0,0,8
117,2023/01/24,8,0,2,0,10
118,2023/01/24,3,0,2,0,5
119,2023/01/24,5,0,3,0,8
120,2023/01/24,6,4,3,0,9
149,2023/01/24,5,0,0,0,5
184,2023/01/24,17,12,13,0,30
195,2023/01/24,35,36,44,0,79
218,2023/01/24,36,33,37,0,73
296,2023/01/24,4,4,4,0,8
300,2023/01/24,13,4,8,0,21
304,2023/01/24,9,4,8,0,17
317,2023/01/24,4,0,4,0,8
343,2023/01/24,6,0,1,0,7
353,2023/01/24,4,0,0,0,4
373,2023/01/24,10,6,4,0,14
374,2023/01/24,6,4,4,0,10
388,2023/01/24,25,24,13,0,38
419,2023/01/24,1,0,0,0,1
420,2023/01/24,5,0,5,0,10
462,2023/01/24,25,8,6,0,31
519,2023/01/24,10,6,6,0,16
525,2023/01/24,6,0,1,0,7
596,2023/01/24,6,0,5,0,11
597,2023/01/24,20,0,11,0,31
598,2023/01/24,9,6,1,0,10
1035,2023/01/24,6,6,0,0,6
1084,2023/01/24,15,10,11,0,26
1111,2023/01/24,13,6,0,0,13
1112,2023/01/24,7,0,0,0,7
1113,2023/01/24,14,6,1,0,15
1114,2023/01/24,11,0,1,0,12
1115,2023/01/24,11,6,1,0,12
1117,2023/01/24,0,0,0,0,0
1118,2023/01/24,9,0,1,0,10
1119,2023/01/24,0,0,0,0,0
1692,2023/01/24,6,6,6,0,12
1693,2023/01/24,4,0,3,0,7
1747,2023/01/24,25,25,21,0,46
1772,2023/01/24,3,0,0,0,3
1773,2023/01/24,2,0,0,0,2
1774,2023/01/24,9,0,1,0,10
1782,2023/01/24,29,24,19,0,48
1795,2023/01/24,14,14,13,0,27
1914,2023/01/24,6,0,0,0,6
1915,2023/01/24,12,6,1,0,13
1923,2023/01/24,9,0,0,0,9
1934,2023/01/24,7,5,7,0,14
1963,2023/01/24,8,6,7,0,15
1984,2023/01/24,7,6,0,0,7
2135,2023/01/24,6,0,2,0,8
2136,2023/01/24,2,0,0,0,2
2148,2023/01/24,3,0,3,0,6
2183,2023/01/24,7,6,1,0,8
2193,2023/01/24,24,15,19,2,43
2237,2023/01/24,9,0,1,0,10
2358,2023/01/24,11,8,5,0,16
2361,2023/01/24,4,0,3,0,7
2445,2023/01/24,18,12,5,0,23
2449,2023/01/24,6,6,4,0,10
2451,2023/01/24,27,0,21,0,48
2475,2023/01/24,13,0,0,0,13
2476,2023/01/24,12,0,0,0,12
2507,2023/01/24,32,12,8,0,40
2525,2023/01/24,8,0,0,0,8
2562,2023/01/24,8,6,4,0,12
2582,2023/01/24,6,4,4,0,10
2586,2023/01/24,25,24,13,0,38
2602,2023/01/24,5,0,3,0,8
2631,2023/01/24,9,6,2,0,11
2685,2023/01/24,17,8,8,0,25
2723,2023/01/24,7,0,3,0,10
2730,2023/01/24,10,0,1,0,11
2731,2023/01/24,9,0,1,0,10
2732,2023/01/24,8,0,2,0,10
2734,2023/01/24,7,4,3,0,10
2735,2023/01/24,13,0,9,0,22
2761,2023/01/24,21,20,16,0,37
2788,2023/01/24,20,20,17,0,37
2802,2023/01/24,10,0,0,0,10
2812,2023/01/24,5,0,2,0,7
2813,2023/01/24,6,0,2,0,8
2814,2023/01/24,9,6,1,0,10
2913,2023/01/24,12,6,4,0,16
2914,2023/01/24,5,0,0,0,5
3033,2023/01/24,10,0,0,0,10
3035,2023/01/24,9,0,0,0,9
4446,2023/01/24,20,9,10,0,30
12136,2023/01/24,31,30,31,0,62
12516,2023/01/24,8,4,5,0,13
12518,2023/01/24,10,4,0,0,10
16062,2023/01/24,12,0,4,0,16
16276,2023/01/24,7,4,2,0,9
19322,2023/01/24,11,0,0,0,11
19329,2023/01/24,7,6,1,0,8
19520,2023/01/24,3,0,1,0,4
20901,2023/01/24,6,0,0,0,6
20920,2023/01/24,9,0,0,0,9
21097,2023/01/24,7,0,0,0,7
21102,2023/01/24,15,0,0,0,15
21103,2023/01/24,12,0,0,0,12
21132,2023/01/24,26,21,11,5,37
21171,2023/01/24,8,0,2,1,10
21174,2023/01/24,7,0,5,0,12
21175,2023/01/24,13,12,9,0,22
21176,2023/01/24,22,8,7,4,29
75,2023/01/25,35,36,46,0,81
76,2023/01/25,40,44,57,1,97
99,2023/01/25,8,0,1,0,9
117,2023/01/25,6,0,1,0,7
118,2023/01/25,1,0,0,0,1
119,2023/01/25,6,4,0,0,6
120,2023/01/25,7,4,0,0,7
149,2023/01/25,5,0,0,0,5
184,2023/01/25,16,12,17,0,33
195,2023/01/25,27,36,35,0,62
218,2023/01/25,29,30,29,0,58
296,2023/01/25,8,8,0,0,8
300,2023/01/25,5,0,0,0,5
304,2023/01/25,5,4,0,0,5
317,2023/01/25,6,6,6,0,12
343,2023/01/25,5,0,0,0,5
353,2023/01/25,10,6,1,0,11
373,2023/01/25,6,0,4,0,10
374,2023/01/25,6,4,0,0,6
388,2023/01/25,36,24,32,8,68
419,2023/01/25,7,6,6,0,13
420,2023/01/25,0,0,0,0,0
462,2023/01/25,19,0,0,4,19
519,2023/01/25,10,6,5,0,15
525,2023/01/25,5,0,0,0,5
596,2023/01/25,5,4,4,0,9
597,2023/01/25,21,12,15,0,36
598,2023/01/25,8,0,1,0,9
1035,2023/01/25,12,6,4,0,16
1084,2023/01/25,14,10,12,0,26
1111,2023/01/25,13,0,0,0,13
1112,2023/01/25,7,0,1,0,8
1113,2023/01/25,13,0,2,0,15
1114,2023/01/25,10,0,2,0,12
1115,2023/01/25,10,0,0,0,10
1117,2023/01/25,0,0,0,0,0
1118,2023/01/25,8,0,0,0,8
1119,2023/01/25,0,0,0,0,0
1692,2023/01/25,0,0,0,0,0
1693,2023/01/25,1,0,0,0,1
1747,2023/01/25,29,25,36,1,65
1772,2023/01/25,3,0,0,0,3
1773,2023/01/25,2,0,0,0,2
1774,2023/01/25,8,0,0,0,8
1782,2023/01/25,34,24,34,0,68
1795,2023/01/25,29,28,11,0,40
1914,2023/01/25,12,6,0,0,12
1915,2023/01/25,11,0,0,0,11
1923,2023/01/25,9,0,3,0,12
1934,2023/01/25,0,0,0,0,0
1963,2023/01/25,7,6,8,0,15
1984,2023/01/25,7,0,0,0,7
2135,2023/01/25,10,6,3,0,13
2136,2023/01/25,2,0,0,0,2
2148,2023/01/25,4,4,0,0,4
2183,2023/01/25,6,0,4,0,10
2193,2023/01/25,24,21,16,0,40
2237,2023/01/25,14,6,4,0,18
2358,2023/01/25,6,0,1,0,7
2361,2023/01/25,8,7,5,0,13
2445,2023/01/25,13,0,5,0,18
2449,2023/01/25,2,0,2,0,4
2451,2023/01/25,6,0,3,0,9
2475,2023/01/25,13,0,0,0,13
2476,2023/01/25,12,0,1,0,13
2507,2023/01/25,24,0,16,0,40
2525,2023/01/25,8,0,3,0,11
2562,2023/01/25,4,0,4,0,8
2582,2023/01/25,6,4,0,0,6
2586,2023/01/25,32,20,18,0,50
2602,2023/01/25,2,0,0,0,2
2631,2023/01/25,7,0,3,0,10
2685,2023/01/25,17,8,11,0,28
2723,2023/01/25,12,8,1,0,13
2730,2023/01/25,9,0,1,0,10
2731,2023/01/25,8,0,2,0,10
2732,2023/01/25,14,8,2,0,16
2734,2023/01/25,8,4,0,0,8
2735,2023/01/25,4,0,0,0,4
2761,2023/01/25,30,25,19,0,49
2788,2023/01/25,23,20,15,0,38
2802,2023/01/25,10,0,1,0,11
2812,2023/01/25,3,0,1,0,4
2813,2023/01/25,4,0,1,0,5
2814,2023/01/25,8,0,1,0,9
2913,2023/01/25,8,0,1,0,9
2914,2023/01/25,5,0,0,0,5
3033,2023/01/25,10,0,1,0,11
3035,2023/01/25,9,0,0,0,9
4446,2023/01/25,22,12,15,7,37
12136,2023/01/25,33,33,31,0,64
12516,2023/01/25,7,4,0,0,7
12518,2023/01/25,10,0,0,0,10
16062,2023/01/25,8,0,1,0,9
16276,2023/01/25,5,0,0,0,5
19322,2023/01/25,11,0,0,0,11
19329,2023/01/25,6,0,1,0,7
19520,2023/01/25,10,8,2,0,12
20901,2023/01/25,12,6,0,0,12
21097,2023/01/25,7,0,0,0,7
21103,2023/01/25,12,0,0,0,12
21132,2023/01/25,30,21,15,6,45
21171,2023/01/25,9,4,2,1,11
21174,2023/01/25,18,16,14,0,32
21175,2023/01/25,12,8,14,0,26
21176,2023/01/25,19,8,10,7,29
75,2023/01/26,33,44,38,0,71
76,2023/01/26,37,56,38,0,75
99,2023/01/26,7,0,0,0,7
117,2023/01/26,5,0,0,0,5
118,2023/01/26,9,8,0,0,9
119,2023/01/26,6,0,4,0,10
120,2023/01/26,11,4,3,0,14
149,2023/01/26,11,6,4,0,15
184,2023/01/26,11,12,9,0,20
195,2023/01/26,28,36,34,0,62
218,2023/01/26,36,36,43,0,79
296,2023/01/26,8,0,7,0,15
300,2023/01/26,5,0,3,0,8
304,2023/01/26,5,0,4,0,9
317,2023/01/26,6,6,5,0,11
343,2023/01/26,5,0,1,4,6
353,2023/01/26,9,0,0,0,9
373,2023/01/26,2,0,0,0,2
374,2023/01/26,6,0,4,0,10
388,2023/01/26,20,24,23,1,43
419,2023/01/26,7,6,6,0,13
420,2023/01/26,6,6,3,0,9
462,2023/01/26,15,0,15,0,30
519,2023/01/26,11,6,9,0,20
525,2023/01/26,5,0,3,0,8
596,2023/01/26,9,8,10,0,19
597,2023/01/26,18,12,19,0,37
598,2023/01/26,7,0,4,0,11
1035,2023/01/26,8,0,4,0,12
1084,2023/01/26,12,10,12,0,24
1111,2023/01/26,13,0,3,0,16
1112,2023/01/26,6,0,0,0,6
1113,2023/01/26,11,0,1,0,12
1114,2023/01/26,14,6,6,0,20
1115,2023/01/26,10,0,0,0,10
1117,2023/01/26,0,0,0,0,0
1118,2023/01/26,14,6,3,0,17
1119,2023/01/26,0,0,0,0,0
1692,2023/01/26,6,6,2,0,8
1693,2023/01/26,1,0,0,0,1
1747,2023/01/26,7,15,7,0,14
1772,2023/01/26,3,0,0,0,3
1773,2023/01/26,8,6,0,0,8
1782,2023/01/26,24,24,24,0,48
1795,2023/01/26,32,14,14,0,46
1914,2023/01/26,12,0,0,0,12
1915,2023/01/26,11,0,2,0,13
1923,2023/01/26,6,0,0,0,6
1934,2023/01/26,5,5,3,0,8
1963,2023/01/26,-1,0,0,0,-1
1984,2023/01/26,7,0,3,1,10
2135,2023/01/26,7,0,4,0,11
2136,2023/01/26,2,0,1,0,3
2148,2023/01/26,8,4,4,0,12
2183,2023/01/26,8,6,6,0,14
2193,2023/01/26,23,15,14,2,37
2237,2023/01/26,10,0,3,0,13
2358,2023/01/26,5,0,2,0,7
2361,2023/01/26,10,7,10,0,20
2445,2023/01/26,8,0,2,0,10
2449,2023/01/26,6,6,1,0,7
2451,2023/01/26,18,15,9,0,27
2475,2023/01/26,13,0,0,0,13
2476,2023/01/26,11,0,0,0,11
2507,2023/01/26,20,12,17,0,37
2525,2023/01/26,5,0,4,0,9
2562,2023/01/26,0,0,1,0,1
2582,2023/01/26,6,0,0,0,6
2586,2023/01/26,34,20,25,0,59
2602,2023/01/26,2,0,0,0,2
2631,2023/01/26,4,0,1,0,5
2685,2023/01/26,10,4,10,0,20
2723,2023/01/26,11,0,1,0,12
2730,2023/01/26,8,0,1,0,9
2731,2023/01/26,6,0,2,0,8
2732,2023/01/26,12,0,1,0,13
2734,2023/01/26,8,0,5,0,13
2735,2023/01/26,4,0,5,0,9
2761,2023/01/26,31,20,29,0,60
2788,2023/01/26,28,20,22,2,50
2802,2023/01/26,9,0,1,0,10
2812,2023/01/26,8,6,2,0,10
2813,2023/01/26,9,6,3,0,12
2814,2023/01/26,7,0,0,0,7
2913,2023/01/26,7,0,1,0,8
2914,2023/01/26,11,6,3,0,14
3033,2023/01/26,9,0,1,0,10
3035,2023/01/26,9,0,1,0,10
4446,2023/01/26,12,12,12,0,24
12136,2023/01/26,32,30,29,0,61
12516,2023/01/26,7,0,4,0,11
12518,2023/01/26,10,0,4,0,14
16062,2023/01/26,7,0,1,0,8
16276,2023/01/26,5,0,0,1,5
19322,2023/01/26,11,0,0,0,11
19329,2023/01/26,11,6,2,0,13
19520,2023/01/26,8,0,3,0,11
20901,2023/01/26,12,0,0,0,12
21097,2023/01/26,7,0,0,0,7
21103,2023/01/26,12,0,0,0,12
21132,2023/01/26,27,18,23,0,50
21171,2023/01/26,6,0,1,1,7
21174,2023/01/26,16,12,14,0,30
21175,2023/01/26,6,8,5,0,11
21176,2023/01/26,2,0,1,0,3
75,2023/01/27,35,40,44,0,79
76,2023/01/27,47,48,45,2,92
99,2023/01/27,7,0,0,0,7
117,2023/01/27,5,0,4,0,9
118,2023/01/27,9,0,1,1,10
119,2023/01/27,2,0,1,0,3
120,2023/01/27,12,4,2,0,14
149,2023/01/27,7,0,0,0,7
184,2023/01/27,17,15,19,0,36
195,2023/01/27,24,30,26,0,50
218,2023/01/27,23,30,28,0,51
296,2023/01/27,9,8,5,0,14
300,2023/01/27,6,4,6,0,12
304,2023/01/27,5,4,4,0,9
317,2023/01/27,7,6,2,0,9
343,2023/01/27,0,0,1,0,1
353,2023/01/27,9,0,0,0,9
373,2023/01/27,8,6,5,0,13
374,2023/01/27,6,4,3,0,9
388,2023/01/27,26,30,29,0,55
419,2023/01/27,7,6,2,0,9
420,2023/01/27,3,0,2,0,5
462,2023/01/27,16,16,7,0,23
519,2023/01/27,14,12,14,0,28
525,2023/01/27,2,0,0,0,2
596,2023/01/27,11,12,2,0,13
597,2023/01/27,23,24,13,0,36
598,2023/01/27,9,6,2,0,11
1035,2023/01/27,10,6,9,0,19
1084,2023/01/27,20,20,17,0,37
1111,2023/01/27,10,0,1,0,11
1112,2023/01/27,12,6,1,0,13
1113,2023/01/27,10,0,4,0,14
1114,2023/01/27,8,0,0,0,8
1115,2023/01/27,16,6,4,0,20
1117,2023/01/27,0,0,0,0,0
1118,2023/01/27,11,0,5,0,16
1119,2023/01/27,0,0,0,0,0
1692,2023/01/27,4,0,2,0,6
1693,2023/01/27,7,6,1,0,8
1747,2023/01/27,30,30,36,0,66
1772,2023/01/27,11,8,0,0,11
1773,2023/01/27,14,6,0,0,14
1782,2023/01/27,24,24,23,0,47
1795,2023/01/27,40,21,30,0,70
1914,2023/01/27,12,0,0,0,12
1915,2023/01/27,9,0,1,0,10
1923,2023/01/27,6,0,0,0,6
1934,2023/01/27,2,0,1,0,3
1963,2023/01/27,5,6,5,0,10
1984,2023/01/27,9,6,5,0,14
2135,2023/01/27,9,6,3,0,12
2136,2023/01/27,1,0,0,0,1
2148,2023/01/27,4,0,4,0,8
2183,2023/01/27,2,0,1,0,3
2193,2023/01/27,28,21,24,0,52
2237,2023/01/27,7,0,1,0,8
2358,2023/01/27,11,8,3,0,14
2361,2023/01/27,7,7,7,0,14
2445,2023/01/27,12,6,6,0,18
2449,2023/01/27,5,0,2,0,7
2451,2023/01/27,29,20,17,0,46
2475,2023/01/27,13,0,1,0,14
2476,2023/01/27,11,0,5,0,16
2507,2023/01/27,15,12,9,0,24
2525,2023/01/27,1,0,0,0,1
2562,2023/01/27,5,6,2,0,7
2582,2023/01/27,6,0,1,0,7
2586,2023/01/27,41,32,27,0,68
2602,2023/01/27,10,8,1,0,11
2631,2023/01/27,9,6,9,0,18
2685,2023/01/27,8,8,5,0,13
2723,2023/01/27,10,0,2,0,12
2730,2023/01/27,7,0,3,0,10
2731,2023/01/27,4,0,2,0,6
2732,2023/01/27,11,0,1,0,12
2734,2023/01/27,3,0,1,0,4
2735,2023/01/27,3,4,1,0,4
2761,2023/01/27,27,25,27,0,54
2788,2023/01/27,28,24,26,0,54
2802,2023/01/27,8,0,3,0,11
2812,2023/01/27,12,6,1,0,13
2813,2023/01/27,6,0,2,0,8
2814,2023/01/27,7,0,0,0,7
2913,2023/01/27,6,0,2,0,8
2914,2023/01/27,8,0,3,0,11
3033,2023/01/27,8,0,1,0,9
3035,2023/01/27,8,0,1,0,9
4446,2023/01/27,15,15,13,0,28
12136,2023/01/27,33,30,29,0,62
12516,2023/01/27,7,4,6,0,13
12518,2023/01/27,10,4,6,0,16
16062,2023/01/27,12,6,3,0,15
16276,2023/01/27,4,0,0,0,4
19322,2023/01/27,11,0,1,0,12
19329,2023/01/27,9,0,4,0,13
19520,2023/01/27,5,0,2,0,7
20901,2023/01/27,12,0,1,0,13
21097,2023/01/27,7,0,0,0,7
21103,2023/01/27,12,0,2,0,14
21132,2023/01/27,28,24,28,2,56
21171,2023/01/27,8,4,2,2,10
21174,2023/01/27,14,12,14,0,28
21175,2023/01/27,13,12,12,0,25
21176,2023/01/27,9,8,8,0,17
75,2023/01/28,43,40,31,0,74
76,2023/01/28,48,36,30,5,78
99,2023/01/28,7,0,0,0,7
117,2023/01/28,1,0,1,0,2
118,2023/01/28,7,0,2,0,9
119,2023/01/28,5,4,1,0,6
120,2023/01/28,10,0,5,0,15
149,2023/01/28,7,0,1,0,8
184,2023/01/28,15,18,13,0,28
195,2023/01/28,40,33,28,0,68
218,2023/01/28,28,24,20,0,48
296,2023/01/28,12,8,2,0,14
300,2023/01/28,8,8,2,0,10
304,2023/01/28,9,8,0,0,9
317,2023/01/28,11,6,4,0,15
343,2023/01/28,7,8,4,0,11
353,2023/01/28,9,0,0,0,9
373,2023/01/28,3,0,1,0,4
374,2023/01/28,11,8,4,0,15
388,2023/01/28,29,18,16,0,45
419,2023/01/28,5,0,2,0,7
420,2023/01/28,7,6,3,0,10
462,2023/01/28,17,8,8,0,25
519,2023/01/28,12,12,7,0,19
525,2023/01/28,7,5,2,0,9
596,2023/01/28,8,0,8,0,16
597,2023/01/28,11,0,12,0,23
598,2023/01/28,7,0,1,0,8
1035,2023/01/28,1,0,1,0,2
1084,2023/01/28,4,0,3,0,7
1111,2023/01/28,9,0,1,0,10
1112,2023/01/28,11,0,1,0,12
1113,2023/01/28,6,0,2,0,8
1114,2023/01/28,14,6,4,0,18
1115,2023/01/28,12,0,2,0,14
1117,2023/01/28,0,0,0,0,0
1118,2023/01/28,6,0,1,0,7
1119,2023/01/28,0,0,0,0,0
1692,2023/01/28,8,6,5,0,13
1693,2023/01/28,6,0,3,0,9
1747,2023/01/28,18,20,18,0,36
1772,2023/01/28,11,0,1,0,12
1773,2023/01/28,14,0,3,0,17
1782,2023/01/28,29,24,25,0,54
1795,2023/01/28,27,21,21,0,48
1914,2023/01/28,12,0,0,0,12
1915,2023/01/28,8,0,1,0,9
1923,2023/01/28,12,6,1,0,13
1934,2023/01/28,6,5,0,0,6
1963,2023/01/28,0,0,1,0,1
1984,2023/01/28,4,0,3,0,7
2135,2023/01/28,12,6,5,0,17
2136,2023/01/28,1,0,0,0,1
2148,2023/01/28,4,4,2,0,6
2183,2023/01/28,7,6,3,0,10
2193,2023/01/28,26,15,14,1,40
2237,2023/01/28,12,6,1,0,13
2358,2023/01/28,12,4,4,0,16
2361,2023/01/28,4,7,4,0,8
2445,2023/01/28,12,6,5,3,17
2449,2023/01/28,9,6,6,0,15
2451,2023/01/28,23,15,10,0,33
2475,2023/01/28,12,0,0,0,12
2476,2023/01/28,6,0,0,0,6
2507,2023/01/28,9,6,9,0,18
2525,2023/01/28,7,6,0,0,7
2562,2023/01/28,3,0,2,0,5
2582,2023/01/28,9,4,2,0,11
2586,2023/01/28,39,24,12,0,51
2602,2023/01/28,9,0,3,0,12
2631,2023/01/28,6,6,6,0,12
2685,2023/01/28,8,4,2,0,10
2723,2023/01/28,8,0,0,0,8
2730,2023/01/28,10,6,3,0,13
2731,2023/01/28,8,6,2,0,10
2732,2023/01/28,10,0,0,0,10
2734,2023/01/28,2,0,2,0,4
2735,2023/01/28,10,8,4,0,14
2761,2023/01/28,20,20,9,0,29
2788,2023/01/28,22,20,12,3,34
2802,2023/01/28,5,0,2,0,7
2812,2023/01/28,11,0,2,0,13
2813,2023/01/28,4,0,2,0,6
2814,2023/01/28,7,0,0,0,7
2913,2023/01/28,10,6,3,0,13
2914,2023/01/28,5,0,1,0,6
3015,2023/01/28,9,0,1,0,10
3033,2023/01/28,7,0,2,0,9
3035,2023/01/28,7,0,1,0,8
4446,2023/01/28,13,9,9,0,22
12136,2023/01/28,31,24,16,0,47
12516,2023/01/28,5,4,2,0,7
12518,2023/01/28,8,4,4,0,12
16062,2023/01/28,9,0,0,0,9
16276,2023/01/28,8,4,2,0,10
19322,2023/01/28,10,0,2,0,12
19329,2023/01/28,5,0,1,0,6
19520,2023/01/28,11,8,2,0,13
20901,2023/01/28,11,0,0,0,11
21097,2023/01/28,7,0,0,0,7
21103,2023/01/28,10,0,1,0,11
21132,2023/01/28,10,12,10,0,20
21171,2023/01/28,4,0,1,1,5
21174,2023/01/28,18,16,12,0,30
21175,2023/01/28,16,12,12,0,28
21176,2023/01/28,5,4,2,0,7
75,2023/01/29,56,44,44,5,100
76,2023/01/29,53,40,44,3,97
99,2023/01/29,7,0,0,0,7
117,2023/01/29,8,8,5,0,13
118,2023/01/29,13,8,4,0,17
119,2023/01/29,4,0,1,0,5
120,2023/01/29,5,0,1,0,6
149,2023/01/29,6,0,0,0,6
184,2023/01/29,14,12,6,0,20
195,2023/01/29,39,27,25,1,64
218,2023/01/29,38,30,30,0,68
296,2023/01/29,14,4,7,0,21
300,2023/01/29,10,4,5,0,15
304,2023/01/29,17,8,3,0,20
317,2023/01/29,13,6,6,0,19
343,2023/01/29,3,0,1,0,4
353,2023/01/29,9,0,1,0,10
373,2023/01/29,2,0,0,0,2
374,2023/01/29,7,0,4,0,11
388,2023/01/29,37,24,13,4,50
419,2023/01/29,3,0,1,0,4
420,2023/01/29,4,0,2,0,6
462,2023/01/29,17,8,8,0,25
519,2023/01/29,17,12,8,0,25
525,2023/01/29,5,0,2,0,7
596,2023/01/29,8,8,4,0,12
597,2023/01/29,11,12,7,0,18
598,2023/01/29,6,0,4,0,10
1035,2023/01/29,6,6,3,0,9
1084,2023/01/29,16,15,7,0,23
1111,2023/01/29,8,0,1,0,9
1112,2023/01/29,10,0,0,0,10
1113,2023/01/29,4,0,0,0,4
1114,2023/01/29,16,6,6,0,22
1115,2023/01/29,10,0,2,0,12
1117,2023/01/29,8,8,0,0,8
1118,2023/01/29,11,6,2,0,13
1692,2023/01/29,9,6,6,0,15
1693,2023/01/29,9,6,4,0,13
1747,2023/01/29,20,20,12,0,32
1772,2023/01/29,10,0,1,0,11
1773,2023/01/29,11,0,1,0,12
1782,2023/01/29,25,21,18,0,43
1795,2023/01/29,6,0,8,0,14
1914,2023/01/29,12,0,0,0,12
1915,2023/01/29,7,0,3,0,10
1923,2023/01/29,11,0,2,0,13
1934,2023/01/29,11,5,1,0,12
1963,2023/01/29,11,12,6,0,17
1984,2023/01/29,1,0,0,0,1
2135,2023/01/29,13,6,3,0,16
2136,2023/01/29,7,6,0,0,7
2148,2023/01/29,2,0,1,0,3
2183,2023/01/29,10,6,3,0,13
2193,2023/01/29,26,15,11,0,37
2237,2023/01/29,17,6,3,0,20
2358,2023/01/29,20,12,2,0,22
2361,2023/01/29,7,7,3,0,10
2445,2023/01/29,10,6,8,0,18
2449,2023/01/29,3,0,3,0,6
2451,2023/01/29,63,50,18,0,81
2475,2023/01/29,12,0,0,0,12
2476,2023/01/29,6,0,1,0,7
2507,2023/01/29,12,12,6,0,18
2525,2023/01/29,13,6,0,0,13
2562,2023/01/29,7,6,3,0,10
2582,2023/01/29,11,4,3,0,14
2586,2023/01/29,39,12,21,0,60
2602,2023/01/29,6,0,1,0,7
2631,2023/01/29,0,0,0,0,0
2685,2023/01/29,14,8,4,0,18
2723,2023/01/29,8,0,1,0,9
2730,2023/01/29,7,0,0,0,7
2731,2023/01/29,6,0,1,0,7
2732,2023/01/29,10,0,0,0,10
2734,2023/01/29,4,4,3,0,7
2735,2023/01/29,10,4,5,0,15
2761,2023/01/29,26,15,15,0,41
2788,2023/01/29,19,12,13,3,32
2802,2023/01/29,3,0,2,0,5
2812,2023/01/29,9,0,1,0,10
2813,2023/01/29,8,6,1,0,9
2814,2023/01/29,13,6,1,0,14
2913,2023/01/29,7,0,2,0,9
2914,2023/01/29,4,0,0,0,4
3015,2023/01/29,8,0,6,0,14
3033,2023/01/29,5,0,0,0,5
3035,2023/01/29,6,0,1,0,7
4446,2023/01/29,19,15,10,0,29
12136,2023/01/29,33,18,18,0,51
12516,2023/01/29,7,4,3,0,10
12518,2023/01/29,4,0,4,0,8
16062,2023/01/29,9,0,1,0,10
16276,2023/01/29,6,0,0,0,6
19322,2023/01/29,8,0,0,0,8
19329,2023/01/29,10,6,1,0,11
19520,2023/01/29,9,0,0,0,9
20901,2023/01/29,11,0,0,0,11
21097,2023/01/29,7,0,1,0,8
21103,2023/01/29,9,0,0,0,9
21132,2023/01/29,12,12,11,0,23
21171,2023/01/29,6,4,2,0,8
21174,2023/01/29,18,12,3,0,21
21175,2023/01/29,16,12,10,0,26
21176,2023/01/29,15,12,2,0,17
75,2023/01/30,47,40,41,0,88
76,2023/01/30,55,48,41,0,96
99,2023/01/30,7,0,0,0,7
117,2023/01/30,3,0,3,0,6
118,2023/01/30,9,0,3,0,12
119,2023/01/30,7,4,2,0,9
120,2023/01/30,4,0,2,0,6
184,2023/01/30,20,12,7,0,27
195,2023/01/30,46,33,31,0,77
218,2023/01/30,41,33,41,0,82
296,2023/01/30,15,8,8,0,23
300,2023/01/30,13,8,11,0,24
304,2023/01/30,22,8,8,0,30
317,2023/01/30,13,6,7,0,20
343,2023/01/30,2,0,3,0,5
353,2023/01/30,8,0,0,0,8
373,2023/01/30,2,0,0,0,2
374,2023/01/30,3,0,0,0,3
388,2023/01/30,50,30,33,9,83
419,2023/01/30,2,0,1,0,3
420,2023/01/30,2,0,1,0,3
462,2023/01/30,25,16,11,0,36
519,2023/01/30,15,6,5,0,20
525,2023/01/30,3,0,1,0,4
596,2023/01/30,12,8,7,0,19
597,2023/01/30,22,18,18,0,40
598,2023/01/30,8,6,2,0,10
1035,2023/01/30,3,0,3,0,6
1084,2023/01/30,24,15,12,0,36
1111,2023/01/30,13,6,2,0,15
1112,2023/01/30,10,0,0,0,10
1113,2023/01/30,10,6,4,0,14
1114,2023/01/30,10,0,2,0,12
1115,2023/01/30,14,6,2,0,16
1117,2023/01/30,16,8,0,0,16
1118,2023/01/30,15,6,1,0,16
1692,2023/01/30,3,0,3,0,6
1693,2023/01/30,5,0,4,0,9
1747,2023/01/30,38,30,23,0,61
1772,2023/01/30,9,0,3,0,12
1773,2023/01/30,10,0,1,0,11
1782,2023/01/30,31,24,2,0,33
1795,2023/01/30,12,14,15,0,27
1914,2023/01/30,12,0,1,0,13
1915,2023/01/30,4,0,0,0,4
1923,2023/01/30,9,0,0,0,9
1934,2023/01/30,15,5,5,0,20
1963,2023/01/30,11,6,9,0,20
1984,2023/01/30,1,0,0,0,1
2135,2023/01/30,10,0,2,0,12
2136,2023/01/30,13,6,0,0,13
2148,2023/01/30,1,0,2,0,3
2183,2023/01/30,7,0,2,0,9
2193,2023/01/30,36,21,10,0,46
2237,2023/01/30,14,0,1,0,15
2358,2023/01/30,18,0,8,0,26
2361,2023/01/30,11,7,5,0,16
2445,2023/01/30,2,0,2,0,4
2449,2023/01/30,0,0,0,0,0
2451,2023/01/30,45,0,19,0,64
2475,2023/01/30,12,0,1,0,13
2476,2023/01/30,11,6,1,0,12
2507,2023/01/30,18,12,6,0,24
2525,2023/01/30,13,0,1,0,14
2562,2023/01/30,4,0,5,0,9
2582,2023/01/30,8,0,6,0,14
2586,2023/01/30,34,16,18,8,52
2602,2023/01/30,5,0,1,0,6
2631,2023/01/30,0,0,0,0,0
2685,2023/01/30,18,8,10,1,28
2723,2023/01/30,15,8,3,0,18
2730,2023/01/30,13,6,0,0,13
2731,2023/01/30,11,6,1,0,12
2732,2023/01/30,10,0,2,0,12
2734,2023/01/30,1,0,2,0,3
2735,2023/01/30,9,4,5,0,14
2761,2023/01/30,31,20,13,0,44
2788,2023/01/30,23,20,17,1,40
2802,2023/01/30,7,6,1,0,8
2812,2023/01/30,8,0,1,0,9
2813,2023/01/30,7,0,0,0,7
2814,2023/01/30,12,0,0,0,12
2913,2023/01/30,5,0,2,0,7
2914,2023/01/30,10,6,1,0,11
3015,2023/01/30,2,0,1,0,3
3033,2023/01/30,5,0,0,0,5
3035,2023/01/30,5,0,0,0,5
4446,2023/01/30,21,12,9,0,30
12136,2023/01/30,45,30,17,0,62
12516,2023/01/30,4,0,0,0,4
12518,2023/01/30,4,4,4,0,8
16062,2023/01/30,8,0,0,0,8
16276,2023/01/30,6,0,0,0,6
19322,2023/01/30,8,0,1,0,9
19329,2023/01/30,9,0,1,0,10
19520,2023/01/30,9,0,5,0,14
20901,2023/01/30,11,0,0,0,11
21097,2023/01/30,6,0,0,0,6
21102,2023/01/30,15,0,1,0,16
21103,2023/01/30,9,0,1,0,10
21132,2023/01/30,25,24,15,0,40
21171,2023/01/30,8,4,2,0,10
21174,2023/01/30,27,12,12,4,39
21175,2023/01/30,18,12,9,0,27
21176,2023/01/30,17,4,7,0,24
75,2023/01/31,38,32,33,0,71
76,2023/01/31,57,44,48,0,105
99,2023/01/31,7,0,0,0,7
117,2023/01/31,0,0,0,0,0
118,2023/01/31,6,0,6,0,12
119,2023/01/31,5,0,2,0,7
120,2023/01/31,2,0,0,0,2
149,2023/01/31,6,0,0,0,6
184,2023/01/31,25,12,16,1,41
195,2023/01/31,45,30,39,0,84
218,2023/01/31,30,30,28,0,58
296,2023/01/31,11,4,2,1,13
300,2023/01/31,10,8,4,0,14
304,2023/01/31,14,0,6,0,20
317,2023/01/31,6,0,1,0,7
343,2023/01/31,3,4,2,0,5
353,2023/01/31,8,0,0,0,8
373,2023/01/31,8,6,4,0,12
374,2023/01/31,3,0,0,0,3
388,2023/01/31,38,30,32,0,70
419,2023/01/31,7,6,6,0,13
420,2023/01/31,7,6,4,0,11
462,2023/01/31,22,8,11,1,33
519,2023/01/31,16,6,4,0,20
525,2023/01/31,2,0,0,0,2
596,2023/01/31,13,8,5,0,18
597,2023/01/31,16,12,14,0,30
598,2023/01/31,6,0,1,0,7
1035,2023/01/31,6,6,2,0,8
1084,2023/01/31,22,10,5,0,27
1111,2023/01/31,11,0,0,0,11
1112,2023/01/31,10,0,0,0,10
1113,2023/01/31,6,0,0,0,6
1114,2023/01/31,8,0,0,0,8
1115,2023/01/31,12,0,0,0,12
1117,2023/01/31,16,0,0,0,16
1118,2023/01/31,14,0,1,0,15
1119,2023/01/31,12,0,2,0,14
1692,2023/01/31,0,0,0,0,0
1693,2023/01/31,1,0,0,0,1
1747,2023/01/31,35,20,32,0,67
1772,2023/01/31,6,0,1,0,7
1773,2023/01/31,9,0,1,0,10
1782,2023/01/31,53,24,25,0,78
1795,2023/01/31,4,7,7,0,11
1914,2023/01/31,11,0,1,0,12
1915,2023/01/31,4,0,1,0,5
1923,2023/01/31,9,0,1,0,10
1934,2023/01/31,10,0,2,0,12
1963,2023/01/31,8,6,5,0,13
1984,2023/01/31,7,6,0,0,7
2135,2023/01/31,8,0,3,0,11
2136,2023/01/31,13,0,2,0,15
2148,2023/01/31,3,4,4,0,7
2183,2023/01/31,11,6,1,0,12
2193,2023/01/31,44,18,19,0,63
2237,2023/01/31,13,0,2,0,15
2358,2023/01/31,14,4,6,0,20
2361,2023/01/31,13,7,5,0,18
2445,2023/01/31,6,6,2,0,8
2449,2023/01/31,6,6,5,0,11
2451,2023/01/31,26,0,14,0,40
2475,2023/01/31,11,0,1,0,12
2476,2023/01/31,10,0,2,0,12
2507,2023/01/31,24,12,20,0,44
2525,2023/01/31,12,0,2,0,14
2562,2023/01/31,5,6,2,0,7
2582,2023/01/31,6,4,6,0,12
2586,2023/01/31,28,20,23,0,51
2602,2023/01/31,12,8,5,0,17
2631,2023/01/31,6,6,1,0,7
2685,2023/01/31,15,8,6,0,21
2723,2023/01/31,12,0,1,0,13
2730,2023/01/31,13,0,3,0,16
2731,2023/01/31,10,0,2,0,12
2732,2023/01/31,8,0,2,0,10
2734,2023/01/31,3,4,1,0,4
2735,2023/01/31,8,4,8,0,16
2761,2023/01/31,38,20,19,0,57
2788,2023/01/31,29,24,28,0,57
2802,2023/01/31,6,0,1,0,7
2812,2023/01/31,7,0,1,0,8
2813,2023/01/31,7,0,1,0,8
2814,2023/01/31,12,0,2,0,14
2913,2023/01/31,3,0,0,0,3
2914,2023/01/31,9,0,0,0,9
3015,2023/01/31,9,8,6,0,15
3033,2023/01/31,11,6,0,0,11
3035,2023/01/31,5,0,0,0,5
4446,2023/01/31,24,12,21,2,45
12136,2023/01/31,58,30,27,0,85
12516,2023/01/31,8,4,6,0,14
12518,2023/01/31,4,4,2,0,6
16276,2023/01/31,6,0,0,0,6
19322,2023/01/31,7,0,0,0,7
19329,2023/01/31,8,0,1,0,9
19520,2023/01/31,4,0,0,0,4
20901,2023/01/31,11,0,0,0,11
21097,2023/01/31,6,0,0,0,6
21102,2023/01/31,14,0,1,0,15
21103,2023/01/31,8,0,3,0,11
21132,2023/01/31,31,21,33,0,64
21171,2023/01/31,10,4,6,1,16
21174,2023/01/31,23,12,10,0,33
21175,2023/01/31,21,12,12,0,33
21176,2023/01/31,18,8,7,4,25
75,2023/02/01,45,40,42,0,87
76,2023/02/01,57,48,53,0,110
99,2023/02/01,7,0,0,0,7
117,2023/02/01,0,0,0,0,0
118,2023/02/01,0,0,0,0,0
119,2023/02/01,3,0,2,0,5
120,2023/02/01,6,4,0,1,6
149,2023/02/01,12,6,0,0,12
184,2023/02/01,20,12,10,4,30
195,2023/02/01,39,33,30,1,69
218,2023/02/01,32,30,30,0,62
296,2023/02/01,8,0,4,0,12
300,2023/02/01,10,4,9,0,19
304,2023/02/01,8,0,5,0,13
317,2023/02/01,11,6,2,0,13
343,2023/02/01,1,0,0,0,1
353,2023/02/01,8,0,0,0,8
373,2023/02/01,10,6,2,0,12
374,2023/02/01,3,0,0,0,3
388,2023/02/01,27,21,21,0,48
419,2023/02/01,7,6,5,0,12
420,2023/02/01,3,0,2,0,5
462,2023/02/01,18,8,11,0,29
519,2023/02/01,12,0,6,0,18
525,2023/02/01,7,5,0,0,7
596,2023/02/01,12,4,12,0,24
597,2023/02/01,20,18,16,0,36
598,2023/02/01,5,0,2,0,7
1035,2023/02/01,4,0,2,0,6
1084,2023/02/01,27,10,14,0,41
1111,2023/02/01,11,0,2,0,13
1112,2023/02/01,10,0,0,0,10
1113,2023/02/01,6,0,1,0,7
1114,2023/02/01,14,6,5,0,19
1115,2023/02/01,12,0,1,0,13
1117,2023/02/01,16,0,1,0,17
1118,2023/02/01,13,0,0,0,13
1119,2023/02/01,10,0,1,0,11
1692,2023/02/01,6,6,3,0,9
1693,2023/02/01,1,0,0,0,1
1747,2023/02/01,28,25,26,0,54
1772,2023/02/01,5,0,0,0,5
1773,2023/02/01,8,0,1,0,9
1782,2023/02/01,52,24,27,0,79
1795,2023/02/01,11,14,13,0,24
1914,2023/02/01,10,0,1,0,11
1915,2023/02/01,9,6,2,0,11
1923,2023/02/01,8,0,0,0,8
1934,2023/02/01,8,0,3,2,11
1963,2023/02/01,9,6,6,0,15
1984,2023/02/01,7,0,3,0,10
2135,2023/02/01,11,6,4,0,15
2136,2023/02/01,11,0,1,0,12
2148,2023/02/01,3,4,2,0,5
2183,2023/02/01,10,0,4,0,14
2193,2023/02/01,37,12,15,0,52
2237,2023/02/01,11,0,2,0,13
2358,2023/02/01,8,0,5,0,13
2361,2023/02/01,15,7,7,0,22
2445,2023/02/01,10,6,7,0,17
2449,2023/02/01,7,6,3,0,10
2451,2023/02/01,12,0,10,0,22
2475,2023/02/01,10,0,0,0,10
2476,2023/02/01,8,0,0,0,8
2507,2023/02/01,16,12,17,0,33
2525,2023/02/01,10,0,1,0,11
2562,2023/02/01,3,0,2,0,5
2582,2023/02/01,0,0,0,0,0
2586,2023/02/01,13,8,12,0,25
2602,2023/02/01,7,0,0,0,7
2631,2023/02/01,11,6,0,0,11
2685,2023/02/01,17,8,11,2,28
2723,2023/02/01,11,0,0,0,11
2730,2023/02/01,10,0,0,0,10
2731,2023/02/01,8,0,1,0,9
2732,2023/02/01,6,0,0,0,6
2734,2023/02/01,6,4,5,0,11
2735,2023/02/01,4,4,5,0,9
2761,2023/02/01,34,15,33,0,67
2788,2023/02/01,17,16,20,0,37
2802,2023/02/01,5,0,0,0,5
2812,2023/02/01,6,0,1,0,7
2813,2023/02/01,12,6,1,0,13
2814,2023/02/01,10,0,1,0,11
2913,2023/02/01,9,6,5,0,14
2914,2023/02/01,9,0,0,0,9
3015,2023/02/01,3,0,0,0,3
3033,2023/02/01,11,0,0,0,11
3035,2023/02/01,11,6,0,0,11
4446,2023/02/01,10,9,12,0,22
12136,2023/02/01,61,30,30,0,91
12516,2023/02/01,6,4,6,0,12
12518,2023/02/01,6,4,1,0,7
16276,2023/02/01,10,4,1,2,11
19322,2023/02/01,7,0,0,0,7
19329,2023/02/01,7,0,0,0,7
19520,2023/02/01,4,0,0,0,4
20901,2023/02/01,11,0,0,0,11
21097,2023/02/01,6,0,0,0,6
21102,2023/02/01,13,0,1,0,14
21103,2023/02/01,5,0,0,0,5
21132,2023/02/01,13,15,14,0,27
21171,2023/02/01,7,4,4,0,11
21174,2023/02/01,21,8,13,6,34
21175,2023/02/01,17,8,12,0,29
21176,2023/02/01,15,8,9,0,24
75,2023/02/02,43,44,45,0,88
76,2023/02/02,45,48,48,0,93
99,2023/02/02,7,0,0,0,7
117,2023/02/02,4,4,3,0,7
118,2023/02/02,0,0,0,0,0
119,2023/02/02,5,4,3,0,8
120,2023/02/02,9,4,3,0,12
149,2023/02/02,12,0,0,0,12
184,2023/02/02,17,12,17,0,34
195,2023/02/02,34,33,31,0,65
218,2023/02/02,36,36,35,0,71
296,2023/02/02,12,8,7,0,19
300,2023/02/02,1,0,1,0,2
304,2023/02/02,7,4,1,0,8
317,2023/02/02,9,6,6,0,15
343,2023/02/02,1,0,1,0,2
353,2023/02/02,8,0,1,0,9
373,2023/02/02,5,0,2,0,7
374,2023/02/02,11,8,6,0,17
388,2023/02/02,11,9,8,0,19
419,2023/02/02,7,12,7,0,14
420,2023/02/02,7,6,1,0,8
462,2023/02/02,7,0,5,0,12
519,2023/02/02,12,6,2,1,14
525,2023/02/02,5,0,0,0,5
596,2023/02/02,7,8,7,0,14
597,2023/02/02,21,18,21,0,42
598,2023/02/02,9,6,0,0,9
1035,2023/02/02,8,6,6,0,14
1084,2023/02/02,22,10,18,0,40
1111,2023/02/02,9,0,0,0,9
1112,2023/02/02,10,0,0,0,10
1113,2023/02/02,11,6,0,0,11
1114,2023/02/02,15,6,1,0,16
1115,2023/02/02,11,0,3,0,14
1117,2023/02/02,15,0,0,0,15
1118,2023/02/02,13,0,4,0,17
1119,2023/02/02,9,0,1,0,10
1692,2023/02/02,3,0,2,0,5
1693,2023/02/02,6,6,2,0,8
1747,2023/02/02,18,15,15,0,33
1772,2023/02/02,13,8,2,0,15
1773,2023/02/02,7,0,2,0,9
1782,2023/02/02,24,24,24,0,48
1795,2023/02/02,21,21,18,0,39
1914,2023/02/02,9,0,2,0,11
1915,2023/02/02,7,0,4,0,11
1923,2023/02/02,8,0,0,0,8
1934,2023/02/02,3,0,1,2,4
1963,2023/02/02,11,6,6,0,17
1984,2023/02/02,9,6,3,0,12
2135,2023/02/02,7,0,4,0,11
2136,2023/02/02,10,0,2,0,12
2148,2023/02/02,5,4,1,0,6
2183,2023/02/02,5,0,5,0,10
2193,2023/02/02,1,9,8,0,9
2237,2023/02/02,9,0,1,0,10
2358,2023/02/02,3,0,2,0,5
2361,2023/02/02,3,0,2,0,5
2445,2023/02/02,9,6,9,0,18
2449,2023/02/02,5,0,3,0,8
2451,2023/02/02,16,15,12,0,28
2475,2023/02/02,10,0,0,0,10
2476,2023/02/02,8,0,0,0,8
2507,2023/02/02,14,18,17,0,31
2525,2023/02/02,9,0,1,0,10
2562,2023/02/02,7,6,1,0,8
2582,2023/02/02,0,0,0,0,0
2586,2023/02/02,24,24,27,0,51
2602,2023/02/02,7,0,2,0,9
2631,2023/02/02,11,0,7,0,18
2685,2023/02/02,9,8,9,0,18
2723,2023/02/02,11,0,0,0,11
2730,2023/02/02,10,0,0,0,10
2731,2023/02/02,7,0,1,0,8
2732,2023/02/02,6,0,3,0,9
2734,2023/02/02,5,4,3,0,8
2735,2023/02/02,3,4,1,0,4
2761,2023/02/02,26,25,20,2,46
2788,2023/02/02,7,24,25,0,32
2802,2023/02/02,11,6,1,0,12
2812,2023/02/02,11,6,0,0,11
2813,2023/02/02,11,0,1,0,12
2814,2023/02/02,9,0,0,0,9
2913,2023/02/02,1,0,0,0,1
2914,2023/02/02,9,0,1,0,10
3015,2023/02/02,3,0,2,0,5
3033,2023/02/02,11,0,0,0,11
3035,2023/02/02,11,0,0,0,11
4446,2023/02/02,11,12,10,0,21
12136,2023/02/02,23,24,25,0,48
12516,2023/02/02,4,4,2,0,6
12518,2023/02/02,9,4,4,0,13
12523,2023/02/02,8,8,5,0,13
16276,2023/02/02,7,0,0,0,7
19322,2023/02/02,7,0,0,0,7
19329,2023/02/02,7,0,1,0,8
19520,2023/02/02,4,0,1,0,5
20901,2023/02/02,11,0,0,0,11
21097,2023/02/02,6,0,0,0,6
21102,2023/02/02,12,0,0,0,12
21103,2023/02/02,5,0,1,0,6
21132,2023/02/02,24,24,22,2,46
21171,2023/02/02,5,0,3,0,8
21174,2023/02/02,12,12,13,0,25
21175,2023/02/02,12,12,11,0,23
21176,2023/02/02,9,8,7,0,16
75,2023/02/03,42,44,46,0,88
76,2023/02/03,41,44,48,0,89
99,2023/02/03,7,0,1,0,8
117,2023/02/03,5,4,2,0,7
118,2023/02/03,4,4,3,0,7
119,2023/02/03,2,0,1,0,3
120,2023/02/03,6,0,2,0,8
149,2023/02/03,12,0,0,0,12
184,2023/02/03,14,12,10,0,24
195,2023/02/03,32,30,31,0,63
218,2023/02/03,34,33,33,0,67
296,2023/02/03,13,8,4,0,17
300,2023/02/03,0,0,0,0,0
304,2023/02/03,10,4,2,0,12
317,2023/02/03,9,6,4,0,13
343,2023/02/03,4,4,1,0,5
353,2023/02/03,7,0,0,0,7
373,2023/02/03,9,6,4,0,13
374,2023/02/03,9,4,5,0,14
388,2023/02/03,36,33,31,0,67
419,2023/02/03,0,0,2,0,2
420,2023/02/03,6,0,2,0,8
462,2023/02/03,10,8,9,0,19
519,2023/02/03,27,18,7,0,34
525,2023/02/03,5,0,5,0,10
596,2023/02/03,8,8,2,0,10
597,2023/02/03,30,30,7,0,37
598,2023/02/03,9,0,1,0,10
1035,2023/02/03,8,6,5,0,13
1084,2023/02/03,24,20,16,0,40
1111,2023/02/03,9,0,3,0,12
1112,2023/02/03,10,0,3,0,13
1113,2023/02/03,11,0,1,0,12
1114,2023/02/03,14,0,0,0,14
1115,2023/02/03,8,0,1,0,9
1117,2023/02/03,15,0,3,0,18
1118,2023/02/03,9,0,1,0,10
1119,2023/02/03,8,0,1,0,9
1692,2023/02/03,7,6,1,0,8
1693,2023/02/03,4,0,0,0,4
1747,2023/02/03,29,25,24,0,53
1772,2023/02/03,11,0,3,0,14
1773,2023/02/03,5,0,1,0,6
1782,2023/02/03,10,9,9,0,19
1795,2023/02/03,24,21,21,0,45
1914,2023/02/03,7,0,1,0,8
1915,2023/02/03,3,0,1,0,4
1923,2023/02/03,8,0,0,0,8
1934,2023/02/03,5,5,3,0,8
1963,2023/02/03,5,0,3,0,8
1984,2023/02/03,6,0,2,0,8
2135,2023/02/03,9,6,3,0,12
2136,2023/02/03,8,0,0,0,8
2148,2023/02/03,8,4,6,0,14
2183,2023/02/03,6,6,6,0,12
2193,2023/02/03,14,21,14,0,28
2237,2023/02/03,14,6,2,0,16
2358,2023/02/03,5,4,3,0,8
2361,2023/02/03,8,7,3,0,11
2445,2023/02/03,6,6,6,0,12
2449,2023/02/03,2,0,2,0,4
2451,2023/02/03,24,20,13,0,37
2475,2023/02/03,10,0,0,0,10
2476,2023/02/03,14,6,0,0,14
2507,2023/02/03,9,12,11,0,20
2525,2023/02/03,8,0,1,0,9
2562,2023/02/03,6,0,3,0,9
2582,2023/02/03,4,4,1,0,5
2586,2023/02/03,25,28,18,0,43
2602,2023/02/03,13,8,1,0,14
2631,2023/02/03,10,6,4,0,14
2685,2023/02/03,8,8,5,0,13
2723,2023/02/03,11,0,4,0,15
2730,2023/02/03,10,0,4,0,14
2731,2023/02/03,12,6,4,0,16
2732,2023/02/03,11,8,3,0,14
2734,2023/02/03,6,4,4,0,10
2735,2023/02/03,6,4,5,0,11
2761,2023/02/03,29,25,15,0,44
2788,2023/02/03,6,24,22,0,28
2802,2023/02/03,10,0,0,0,10
2812,2023/02/03,11,0,0,0,11
2813,2023/02/03,10,0,1,0,11
2814,2023/02/03,9,0,1,0,10
2913,2023/02/03,1,0,0,0,1
2914,2023/02/03,8,0,0,0,8
3015,2023/02/03,9,8,2,0,11
3033,2023/02/03,11,0,0,0,11
3035,2023/02/03,11,0,1,0,12
4446,2023/02/03,7,6,8,0,15
12136,2023/02/03,23,24,21,1,44
12516,2023/02/03,6,4,1,0,7
12518,2023/02/03,9,4,5,0,14
12523,2023/02/03,11,8,7,0,18
16276,2023/02/03,7,0,0,0,7
19322,2023/02/03,7,0,1,0,8
19329,2023/02/03,12,6,2,0,14
19520,2023/02/03,11,8,5,0,16
20901,2023/02/03,11,0,2,0,13
21097,2023/02/03,6,0,0,0,6
21102,2023/02/03,12,0,1,0,13
21103,2023/02/03,14,10,2,0,16
21132,2023/02/03,24,24,19,0,43
21171,2023/02/03,6,4,3,0,9
21174,2023/02/03,12,12,12,0,24
21175,2023/02/03,9,8,10,0,19
21176,2023/02/03,6,4,4,0,10
75,2023/02/04,24,28,19,0,43
76,2023/02/04,37,44,34,0,71
99,2023/02/04,6,0,2,0,8
117,2023/02/04,3,0,3,0,6
118,2023/02/04,5,4,4,0,9
119,2023/02/04,5,4,0,0,5
120,2023/02/04,4,0,2,0,6
149,2023/02/04,12,0,0,0,12
184,2023/02/04,14,12,8,0,22
195,2023/02/04,31,30,28,0,59
218,2023/02/04,22,21,18,0,40
296,2023/02/04,17,8,5,0,22
300,2023/02/04,0,0,0,0,0
304,2023/02/04,16,8,4,0,20
317,2023/02/04,11,6,9,0,20
343,2023/02/04,3,0,1,0,4
353,2023/02/04,7,0,1,0,8
373,2023/02/04,5,0,4,0,9
374,2023/02/04,8,4,4,0,12
388,2023/02/04,26,21,24,0,50
419,2023/02/04,-2,0,2,0,0
420,2023/02/04,4,0,0,0,4
462,2023/02/04,9,8,6,0,15
519,2023/02/04,26,6,11,0,37
525,2023/02/04,0,0,0,0,0
596,2023/02/04,6,0,7,0,13
597,2023/02/04,23,0,20,0,43
598,2023/02/04,14,6,2,0,16
1035,2023/02/04,9,6,9,0,18
1084,2023/02/04,8,0,8,0,16
1111,2023/02/04,6,0,3,0,9
1112,2023/02/04,7,0,1,0,8
1113,2023/02/04,10,0,1,0,11
1114,2023/02/04,20,6,6,0,26
1115,2023/02/04,13,6,4,0,17
1117,2023/02/04,12,0,1,0,13
1118,2023/02/04,8,0,3,0,11
1119,2023/02/04,7,0,2,0,9
1692,2023/02/04,6,0,3,0,9
1693,2023/02/04,4,0,0,0,4
1747,2023/02/04,29,25,29,0,58
1772,2023/02/04,8,0,2,0,10
1773,2023/02/04,4,0,3,0,7
1782,2023/02/04,18,18,16,0,34
1795,2023/02/04,31,28,28,0,59
1914,2023/02/04,6,0,1,0,7
1915,2023/02/04,8,6,2,0,10
1923,2023/02/04,8,0,0,0,8
1934,2023/02/04,2,0,2,0,4
1963,2023/02/04,8,6,4,0,12
1984,2023/02/04,4,0,4,0,8
2135,2023/02/04,12,6,8,0,20
2136,2023/02/04,8,0,1,0,9
2148,2023/02/04,6,4,5,0,11
2183,2023/02/04,0,0,0,0,0
2193,2023/02/04,12,12,14,0,26
2237,2023/02/04,12,0,2,0,14
2358,2023/02/04,6,4,1,0,7
2361,2023/02/04,12,7,3,0,15
2445,2023/02/04,6,6,6,0,12
2449,2023/02/04,6,6,1,0,7
2451,2023/02/04,26,15,12,1,38
2475,2023/02/04,10,0,1,0,11
2476,2023/02/04,14,0,3,0,17
2507,2023/02/04,10,12,12,0,22
2525,2023/02/04,7,0,4,0,11
2562,2023/02/04,9,6,2,0,11
2582,2023/02/04,11,8,4,0,15
2586,2023/02/04,27,20,13,0,40
2602,2023/02/04,12,0,2,0,14
2631,2023/02/04,6,0,6,0,12
2685,2023/02/04,11,8,12,0,23
2723,2023/02/04,7,0,5,0,12
2730,2023/02/04,6,0,1,0,7
2731,2023/02/04,8,0,5,0,13
2732,2023/02/04,8,0,1,0,9
2734,2023/02/04,2,0,0,0,2
2735,2023/02/04,5,4,1,0,6
2761,2023/02/04,24,10,19,0,43
2788,2023/02/04,4,20,18,0,22
2802,2023/02/04,10,0,3,0,13
2812,2023/02/04,11,0,2,0,13
2813,2023/02/04,9,0,2,0,11
2814,2023/02/04,8,0,0,0,8
2913,2023/02/04,1,0,1,0,2
2914,2023/02/04,8,0,2,0,10
3015,2023/02/04,7,0,5,0,12
3033,2023/02/04,11,0,0,0,11
3035,2023/02/04,10,0,0,0,10
4446,2023/02/04,11,12,12,0,23
12136,2023/02/04,6,6,6,0,12
12516,2023/02/04,9,4,5,0,14
12518,2023/02/04,8,4,4,0,12
12523,2023/02/04,12,8,8,0,20
16276,2023/02/04,7,0,0,0,7
19322,2023/02/04,6,0,0,0,6
19329,2023/02/04,10,0,2,0,12
19520,2023/02/04,6,0,1,0,7
20901,2023/02/04,9,0,3,0,12
21097,2023/02/04,6,0,1,0,7
21102,2023/02/04,11,0,0,0,11
21103,2023/02/04,12,0,0,0,12
21132,2023/02/04,17,12,15,0,32
21171,2023/02/04,3,0,1,0,4
21174,2023/02/04,7,8,7,0,14
21175,2023/02/04,11,12,11,0,22
21176,2023/02/04,10,8,6,0,16
75,2023/02/05,49,44,35,0,84
76,2023/02/05,55,52,34,0,89
99,2023/02/05,4,0,0,0,4
117,2023/02/05,4,4,0,0,4
118,2023/02/05,5,4,0,0,5
119,2023/02/05,4,0,1,0,5
120,2023/02/05,5,4,5,0,10
149,2023/02/05,12,0,0,0,12
184,2023/02/05,15,9,3,0,18
195,2023/02/05,36,33,17,0,53
218,2023/02/05,34,30,30,1,64
296,2023/02/05,12,0,9,0,21
300,2023/02/05,8,8,3,0,11
304,2023/02/05,16,4,8,0,24
317,2023/02/05,2,0,0,0,2
343,2023/02/05,6,4,0,0,6
353,2023/02/05,6,0,0,0,6
373,2023/02/05,1,0,1,0,2
374,2023/02/05,12,8,3,0,15
388,2023/02/05,23,21,11,0,34
419,2023/02/05,2,6,2,0,4
420,2023/02/05,10,6,4,1,14
462,2023/02/05,19,16,2,0,21
519,2023/02/05,27,12,16,0,43
525,2023/02/05,5,5,2,0,7
596,2023/02/05,7,8,6,0,13
597,2023/02/05,15,12,12,0,27
598,2023/02/05,12,0,2,0,14
1035,2023/02/05,0,0,0,0,0
1084,2023/02/05,10,10,5,0,15
1111,2023/02/05,3,0,2,0,5
1112,2023/02/05,6,0,3,0,9
1113,2023/02/05,9,0,2,0,11
1114,2023/02/05,14,0,0,0,14
1115,2023/02/05,9,0,2,0,11
1117,2023/02/05,11,0,0,0,11
1118,2023/02/05,11,6,1,0,12
1119,2023/02/05,5,0,0,0,5
1692,2023/02/05,9,6,7,0,16
1693,2023/02/05,10,6,4,0,14
1747,2023/02/05,20,20,13,0,33
1772,2023/02/05,6,0,0,0,6
1773,2023/02/05,1,0,0,0,1
1782,2023/02/05,26,24,19,0,45
1795,2023/02/05,3,0,4,0,7
1914,2023/02/05,11,6,1,0,12
1915,2023/02/05,6,0,1,0,7
1923,2023/02/05,14,6,1,0,15
1934,2023/02/05,5,5,3,0,8
1963,2023/02/05,10,6,8,0,18
1984,2023/02/05,6,6,3,0,9
2135,2023/02/05,10,6,3,0,13
2136,2023/02/05,13,6,3,0,16
2148,2023/02/05,5,4,5,0,10
2183,2023/02/05,6,6,6,0,12
2193,2023/02/05,19,21,12,0,31
2237,2023/02/05,10,0,1,0,11
2358,2023/02/05,17,12,5,0,22
2361,2023/02/05,16,7,6,0,22
2445,2023/02/05,6,6,5,0,11
2449,2023/02/05,11,6,8,0,19
2451,2023/02/05,63,50,15,0,78
2475,2023/02/05,9,0,1,0,10
2476,2023/02/05,11,0,0,0,11
2507,2023/02/05,16,18,9,0,25
2525,2023/02/05,3,0,2,0,5
2562,2023/02/05,7,0,5,0,12
2582,2023/02/05,11,4,4,0,15
2586,2023/02/05,34,20,15,0,49
2602,2023/02/05,10,0,0,0,10
2631,2023/02/05,0,0,0,0,0
2685,2023/02/05,7,8,4,0,11
2723,2023/02/05,2,0,0,0,2
2730,2023/02/05,11,6,6,0,17
2731,2023/02/05,3,0,3,0,6
2732,2023/02/05,7,0,2,0,9
2734,2023/02/05,6,4,3,0,9
2735,2023/02/05,8,4,3,0,11
2761,2023/02/05,25,20,17,0,42
2788,2023/02/05,6,20,12,0,18
2802,2023/02/05,13,6,3,0,16
2812,2023/02/05,9,0,0,0,9
2813,2023/02/05,7,0,3,0,10
2814,2023/02/05,8,0,1,0,9
2913,2023/02/05,6,6,2,0,8
2914,2023/02/05,12,6,1,0,13
3015,2023/02/05,10,8,6,0,16
3033,2023/02/05,11,0,1,0,12
3035,2023/02/05,10,0,0,0,10
4446,2023/02/05,11,12,11,0,22
12136,2023/02/05,24,24,28,0,52
12516,2023/02/05,8,4,0,0,8
12518,2023/02/05,8,4,6,0,14
12523,2023/02/05,8,4,8,0,16
16276,2023/02/05,7,0,3,0,10
19322,2023/02/05,6,0,1,0,7
19329,2023/02/05,8,0,1,0,9
19520,2023/02/05,5,0,2,0,7
20901,2023/02/05,6,0,0,0,6
21097,2023/02/05,5,0,0,0,5
21102,2023/02/05,11,0,0,0,11
21103,2023/02/05,12,0,1,0,13
21132,2023/02/05,14,12,4,0,18
21171,2023/02/05,6,4,3,0,9
21174,2023/02/05,16,16,3,0,19
21175,2023/02/05,8,8,7,0,15
21176,2023/02/05,12,8,4,0,16
75,2023/02/06,58,48,62,0,120
76,2023/02/06,62,48,54,1,116
99,2023/02/06,4,0,0,0,4
117,2023/02/06,7,4,2,0,9
118,2023/02/06,9,4,2,0,11
119,2023/02/06,7,4,2,0,9
120,2023/02/06,0,0,0,0,0
184,2023/02/06,27,15,13,0,40
195,2023/02/06,52,33,44,0,96
218,2023/02/06,41,39,42,0,83
296,2023/02/06,11,8,5,0,16
300,2023/02/06,13,8,5,0,18
304,2023/02/06,16,8,4,0,20
317,2023/02/06,8,6,4,0,12
343,2023/02/06,10,4,0,0,10
353,2023/02/06,6,0,0,0,6
373,2023/02/06,0,0,0,0,0
374,2023/02/06,9,0,3,0,12
388,2023/02/06,45,33,31,8,76
419,2023/02/06,6,6,4,0,10
420,2023/02/06,5,0,2,0,7
462,2023/02/06,33,16,7,0,40
519,2023/02/06,11,0,7,0,18
525,2023/02/06,3,0,1,0,4
596,2023/02/06,9,8,3,0,12
597,2023/02/06,21,18,16,0,37
598,2023/02/06,10,0,0,0,10
1035,2023/02/06,6,6,4,0,10
1084,2023/02/06,20,15,7,0,27
1111,2023/02/06,7,6,4,0,11
1112,2023/02/06,9,6,0,0,9
1113,2023/02/06,13,6,3,0,16
1114,2023/02/06,14,0,0,0,14
1115,2023/02/06,7,0,0,0,7
1117,2023/02/06,11,0,0,0,11
1118,2023/02/06,10,0,2,0,12
1119,2023/02/06,5,0,0,0,5
1692,2023/02/06,8,6,4,0,12
1693,2023/02/06,6,0,1,0,7
1747,2023/02/06,26,20,17,0,43
1772,2023/02/06,14,8,0,0,14
1782,2023/02/06,31,24,25,0,56
1795,2023/02/06,13,14,10,0,23
1914,2023/02/06,10,0,3,0,13
1915,2023/02/06,5,0,0,0,5
1923,2023/02/06,13,0,1,0,14
1934,2023/02/06,1,0,1,0,2
1963,2023/02/06,14,12,8,0,22
1984,2023/02/06,3,0,3,0,6
2135,2023/02/06,7,0,2,0,9
2136,2023/02/06,10,0,0,0,10
2148,2023/02/06,0,0,1,0,1
2183,2023/02/06,6,6,2,0,8
2193,2023/02/06,22,15,22,0,44
2237,2023/02/06,9,0,1,0,10
2358,2023/02/06,12,0,5,0,17
2361,2023/02/06,15,7,1,0,16
2445,2023/02/06,13,12,4,0,17
2449,2023/02/06,9,6,8,0,17
2451,2023/02/06,48,0,18,0,66
2475,2023/02/06,8,0,0,0,8
2476,2023/02/06,10,0,1,0,11
2507,2023/02/06,19,12,8,0,27
2525,2023/02/06,1,0,0,0,1
2562,2023/02/06,2,0,2,0,4
2582,2023/02/06,7,0,3,0,10
2586,2023/02/06,41,24,13,0,54
2631,2023/02/06,6,6,4,0,10
2685,2023/02/06,11,8,4,0,15
2723,2023/02/06,10,8,3,0,13
2730,2023/02/06,11,6,2,0,13
2731,2023/02/06,6,6,1,0,7
2732,2023/02/06,13,8,3,0,16
2734,2023/02/06,3,0,7,0,10
2735,2023/02/06,9,4,6,0,15
2761,2023/02/06,27,20,8,0,35
2788,2023/02/06,21,28,23,0,44
2802,2023/02/06,10,0,0,0,10
2812,2023/02/06,9,0,0,0,9
2813,2023/02/06,3,0,1,0,4
2814,2023/02/06,7,0,1,0,8
2913,2023/02/06,4,0,1,0,5
2914,2023/02/06,11,0,0,0,11
3015,2023/02/06,4,0,4,0,8
3033,2023/02/06,10,0,0,0,10
3035,2023/02/06,10,0,1,0,11
4446,2023/02/06,21,21,8,0,29
12136,2023/02/06,23,30,23,0,46
12516,2023/02/06,8,0,4,0,12
12518,2023/02/06,6,4,1,0,7
12523,2023/02/06,0,0,0,0,0
16276,2023/02/06,4,0,1,0,5
19322,2023/02/06,5,0,0,0,5
19329,2023/02/06,6,0,2,0,8
19520,2023/02/06,11,8,1,0,12
20901,2023/02/06,6,0,1,0,7
21102,2023/02/06,11,0,1,0,12
21103,2023/02/06,11,0,0,0,11
21132,2023/02/06,33,24,31,0,64
21171,2023/02/06,7,4,1,0,8
21174,2023/02/06,25,12,7,0,32
21175,2023/02/06,17,16,13,0,30
21176,2023/02/06,16,8,10,0,26
75,2023/02/07,36,40,38,0,74
76,2023/02/07,55,48,53,0,108
99,2023/02/07,16,12,0,0,16
117,2023/02/07,9,4,0,0,9
118,2023/02/07,11,4,6,0,17
119,2023/02/07,5,0,2,0,7
120,2023/02/07,4,4,2,0,6
149,2023/02/07,12,0,1,0,13
184,2023/02/07,26,12,11,0,37
195,2023/02/07,41,33,38,3,79
218,2023/02/07,32,33,30,0,62
296,2023/02/07,10,4,5,0,15
300,2023/02/07,16,8,6,0,22
304,2023/02/07,16,4,7,0,23
317,2023/02/07,10,6,12,0,22
343,2023/02/07,14,4,2,0,16
353,2023/02/07,6,0,0,0,6
373,2023/02/07,0,0,0,0,0
374,2023/02/07,14,8,6,0,20
388,2023/02/07,39,33,27,2,66
419,2023/02/07,2,0,2,0,4
420,2023/02/07,9,6,4,0,13
462,2023/02/07,34,8,7,0,41
519,2023/02/07,4,0,3,1,7
525,2023/02/07,2,0,2,0,4
596,2023/02/07,14,8,4,0,18
597,2023/02/07,23,18,10,0,33
598,2023/02/07,10,0,2,0,12
1035,2023/02/07,2,0,2,0,4
1084,2023/02/07,28,15,12,1,40
1111,2023/02/07,9,6,0,0,9
1112,2023/02/07,9,0,1,0,10
1113,2023/02/07,10,0,1,0,11
1114,2023/02/07,20,6,3,0,23
1115,2023/02/07,7,0,1,0,8
1117,2023/02/07,11,0,0,0,11
1118,2023/02/07,8,0,1,0,9
1119,2023/02/07,11,6,1,0,12
1692,2023/02/07,4,0,4,0,8
1693,2023/02/07,5,0,4,0,9
1747,2023/02/07,39,30,37,0,76
1772,2023/02/07,14,0,1,0,15
1782,2023/02/07,18,12,16,0,34
1795,2023/02/07,17,14,15,0,32
1914,2023/02/07,7,0,1,0,8
1915,2023/02/07,11,6,0,0,11
1923,2023/02/07,12,0,0,0,12
1934,2023/02/07,5,5,1,0,6
1963,2023/02/07,6,0,5,0,11
1984,2023/02/07,0,0,0,0,0
2135,2023/02/07,11,6,1,0,12
2136,2023/02/07,10,0,3,0,13
2148,2023/02/07,3,4,2,0,5
2183,2023/02/07,4,0,2,0,6
2193,2023/02/07,21,21,29,0,50
2237,2023/02/07,8,0,1,0,9
2358,2023/02/07,15,8,3,0,18
2361,2023/02/07,14,0,6,0,20
2445,2023/02/07,9,0,6,0,15
2449,2023/02/07,1,0,1,0,2
2451,2023/02/07,30,0,12,0,42
2475,2023/02/07,8,0,1,0,9
2476,2023/02/07,9,0,1,0,10
2507,2023/02/07,23,12,7,0,30
2525,2023/02/07,7,6,1,0,8
2562,2023/02/07,6,6,7,0,13
2582,2023/02/07,8,4,5,0,13
2586,2023/02/07,52,24,16,3,68
2631,2023/02/07,2,0,2,0,4
2685,2023/02/07,15,8,9,0,24
2723,2023/02/07,7,0,0,0,7
2730,2023/02/07,9,0,3,0,12
2731,2023/02/07,11,6,1,0,12
2732,2023/02/07,10,0,1,0,11
2734,2023/02/07,0,4,1,0,1
2735,2023/02/07,11,8,3,0,14
2761,2023/02/07,39,20,21,0,60
2788,2023/02/07,26,28,41,1,67
2802,2023/02/07,10,0,1,0,11
2812,2023/02/07,9,0,0,0,9
2813,2023/02/07,8,6,0,0,8
2814,2023/02/07,6,0,2,0,8
2913,2023/02/07,9,6,4,0,13
2914,2023/02/07,11,0,1,0,12
3015,2023/02/07,8,8,4,0,12
3033,2023/02/07,10,0,3,0,13
3035,2023/02/07,9,0,0,0,9
4446,2023/02/07,34,21,15,0,49
12136,2023/02/07,30,30,31,0,61
12516,2023/02/07,8,4,0,0,8
12518,2023/02/07,9,4,1,0,10
12523,2023/02/07,8,8,3,0,11
16276,2023/02/07,3,0,0,0,3
19322,2023/02/07,5,0,0,0,5
19329,2023/02/07,4,0,0,0,4
19520,2023/02/07,10,0,4,0,14
20901,2023/02/07,11,6,1,0,12
21102,2023/02/07,10,0,0,0,10
21103,2023/02/07,11,0,1,0,12
21132,2023/02/07,26,24,18,0,44
21171,2023/02/07,6,0,1,0,7
21174,2023/02/07,30,12,20,3,50
21175,2023/02/07,16,12,14,0,30
21176,2023/02/07,14,8,9,0,23
75,2023/02/08,30,32,32,0,62
76,2023/02/08,38,36,41,0,79
99,2023/02/08,16,0,1,0,17
117,2023/02/08,13,4,3,0,16
118,2023/02/08,9,4,3,0,12
119,2023/02/08,7,4,2,0,9
120,2023/02/08,2,0,2,0,4
149,2023/02/08,11,0,0,0,11
184,2023/02/08,21,6,7,5,28
195,2023/02/08,30,30,28,1,58
218,2023/02/08,32,30,31,0,63
296,2023/02/08,9,4,5,0,14
300,2023/02/08,18,8,6,0,24
304,2023/02/08,9,0,1,0,10
317,2023/02/08,3,6,8,0,11
343,2023/02/08,12,0,1,1,13
353,2023/02/08,6,0,0,0,6
373,2023/02/08,6,6,0,0,6
374,2023/02/08,8,0,5,0,13
388,2023/02/08,40,30,30,6,70
419,2023/02/08,5,0,0,0,5
420,2023/02/08,4,0,2,0,6
462,2023/02/08,35,8,13,0,48
519,2023/02/08,6,6,2,0,8
525,2023/02/08,5,5,1,0,6
596,2023/02/08,18,8,6,0,24
597,2023/02/08,31,18,22,0,53
598,2023/02/08,8,0,4,0,12
1035,2023/02/08,6,6,1,0,7
1084,2023/02/08,30,15,14,0,44
1111,2023/02/08,9,0,0,0,9
1112,2023/02/08,14,6,1,0,15
1113,2023/02/08,9,0,1,0,10
1114,2023/02/08,17,0,3,0,20
1115,2023/02/08,12,6,1,0,13
1117,2023/02/08,11,0,0,0,11
1118,2023/02/08,7,0,0,0,7
1119,2023/02/08,10,0,1,0,11
1692,2023/02/08,6,6,6,0,12
1693,2023/02/08,7,6,6,0,13
1747,2023/02/08,32,30,25,0,57
1772,2023/02/08,13,0,0,0,13
1782,2023/02/08,32,30,20,0,52
1795,2023/02/08,30,28,8,0,38
1914,2023/02/08,6,0,1,0,7
1915,2023/02/08,11,0,2,0,13
1923,2023/02/08,12,0,0,0,12
1934,2023/02/08,4,0,4,0,8
1963,2023/02/08,6,6,3,0,9
1984,2023/02/08,6,6,3,0,9
2135,2023/02/08,16,6,4,0,20
2136,2023/02/08,7,0,0,0,7
2148,2023/02/08,5,4,0,0,5
2183,2023/02/08,8,6,2,0,10
2193,2023/02/08,13,21,16,0,29
2237,2023/02/08,13,6,3,0,16
2358,2023/02/08,12,0,0,0,12
2361,2023/02/08,8,0,1,0,9
2445,2023/02/08,9,6,4,0,13
2449,2023/02/08,0,0,0,0,0
2451,2023/02/08,18,0,13,0,31
2475,2023/02/08,7,0,1,0,8
2476,2023/02/08,8,0,1,0,9
2507,2023/02/08,34,18,15,0,49
2525,2023/02/08,6,0,1,0,7
2562,2023/02/08,6,6,3,0,9
2582,2023/02/08,7,4,0,0,7
2586,2023/02/08,45,12,20,3,65
2631,2023/02/08,6,6,3,0,9
2685,2023/02/08,18,12,4,0,22
2723,2023/02/08,15,8,3,0,18
2730,2023/02/08,6,0,3,0,9
2731,2023/02/08,10,0,1,0,11
2732,2023/02/08,9,0,2,0,11
2734,2023/02/08,3,4,3,0,6
2735,2023/02/08,12,4,3,0,15
2761,2023/02/08,43,25,17,0,60
2788,2023/02/08,9,24,20,0,29
2802,2023/02/08,9,0,1,0,10
2812,2023/02/08,9,0,0,0,9
2813,2023/02/08,8,0,1,0,9
2814,2023/02/08,10,6,3,0,13
2913,2023/02/08,5,0,0,0,5
2914,2023/02/08,10,0,0,0,10
3015,2023/02/08,4,0,3,0,7
3033,2023/02/08,7,0,0,0,7
3035,2023/02/08,9,0,0,0,9
4446,2023/02/08,31,12,13,0,44
12136,2023/02/08,32,33,36,0,68
12516,2023/02/08,12,4,3,0,15
12518,2023/02/08,12,4,1,0,13
12523,2023/02/08,13,8,6,0,19
16276,2023/02/08,3,0,1,0,4
19322,2023/02/08,5,0,0,0,5
19329,2023/02/08,10,6,1,0,11
19520,2023/02/08,6,0,0,0,6
20901,2023/02/08,10,0,0,0,10
21102,2023/02/08,10,0,0,0,10
21103,2023/02/08,10,0,1,0,11
21132,2023/02/08,26,18,24,0,50
21171,2023/02/08,9,4,2,0,11
21174,2023/02/08,19,12,14,0,33
21175,2023/02/08,14,12,9,2,23
21176,2023/02/08,13,8,9,1,22
75,2023/02/09,42,44,37,0,79
76,2023/02/09,37,40,37,0,74
99,2023/02/09,15,0,1,0,16
117,2023/02/09,10,0,0,0,10
118,2023/02/09,6,0,2,0,8
119,2023/02/09,9,4,3,0,12
120,2023/02/09,4,4,1,0,5
149,2023/02/09,11,0,1,0,12
184,2023/02/09,21,12,14,0,35
195,2023/02/09,22,21,24,0,46
218,2023/02/09,37,36,35,0,72
296,2023/02/09,12,8,3,0,15
300,2023/02/09,12,0,3,0,15
304,2023/02/09,16,8,5,0,21
317,2023/02/09,1,6,4,0,5
343,2023/02/09,10,0,1,0,11
353,2023/02/09,6,0,1,0,7
373,2023/02/09,6,0,2,0,8
374,2023/02/09,7,4,0,0,7
388,2023/02/09,28,24,21,1,49
419,2023/02/09,11,6,7,0,18
420,2023/02/09,2,0,1,0,3
462,2023/02/09,22,0,5,0,27
519,2023/02/09,10,6,4,0,14
525,2023/02/09,4,0,1,0,5
596,2023/02/09,20,8,1,0,21
597,2023/02/09,33,24,6,0,39
598,2023/02/09,4,0,3,0,7
1035,2023/02/09,11,6,2,0,13
1084,2023/02/09,31,15,10,0,41
1111,2023/02/09,15,6,1,0,16
1112,2023/02/09,13,0,1,0,14
1113,2023/02/09,14,6,0,0,14
1114,2023/02/09,14,0,0,0,14
1115,2023/02/09,17,6,3,0,20
1117,2023/02/09,11,0,4,0,15
1118,2023/02/09,7,0,1,0,8
1119,2023/02/09,9,0,0,0,9
1692,2023/02/09,0,0,0,0,0
1693,2023/02/09,1,0,0,0,1
1747,2023/02/09,32,25,18,0,50
1782,2023/02/09,42,30,18,0,60
1795,2023/02/09,43,21,11,0,54
1914,2023/02/09,11,6,2,0,13
1915,2023/02/09,9,0,3,0,12
1923,2023/02/09,12,0,1,0,13
1934,2023/02/09,5,5,3,0,8
1963,2023/02/09,9,6,6,0,15
1984,2023/02/09,3,0,3,0,6
2135,2023/02/09,18,6,2,0,20
2136,2023/02/09,7,0,1,0,8
2148,2023/02/09,9,4,2,0,11
2183,2023/02/09,12,6,7,0,19
2193,2023/02/09,12,15,8,0,20
2237,2023/02/09,10,0,1,0,11
2358,2023/02/09,12,0,3,0,15
2361,2023/02/09,21,14,5,0,26
2445,2023/02/09,11,6,6,0,17
2449,2023/02/09,6,6,0,0,6
2451,2023/02/09,25,20,7,0,32
2475,2023/02/09,6,0,0,0,6
2476,2023/02/09,7,0,2,0,9
2507,2023/02/09,37,18,17,0,54
2525,2023/02/09,11,6,2,0,13
2562,2023/02/09,3,0,3,0,6
2582,2023/02/09,11,4,1,0,12
2586,2023/02/09,46,24,19,0,65
2631,2023/02/09,9,6,3,0,12
2685,2023/02/09,26,12,8,2,34
2723,2023/02/09,12,0,4,0,16
2730,2023/02/09,3,0,1,0,4
2731,2023/02/09,9,0,3,0,12
2732,2023/02/09,7,0,1,0,8
2734,2023/02/09,4,4,1,0,5
2735,2023/02/09,9,0,9,0,18
2761,2023/02/09,46,20,14,0,60
2788,2023/02/09,12,24,19,0,31
2802,2023/02/09,8,0,1,0,9
2812,2023/02/09,9,0,2,0,11
2813,2023/02/09,7,0,1,0,8
2814,2023/02/09,7,0,1,0,8
2913,2023/02/09,5,0,0,0,5
2914,2023/02/09,10,0,0,0,10
3015,2023/02/09,9,8,2,0,11
3033,2023/02/09,7,0,0,0,7
3035,2023/02/09,9,0,1,0,10
4446,2023/02/09,30,12,9,7,39
12136,2023/02/09,29,33,33,0,62
12516,2023/02/09,13,4,2,0,15
12518,2023/02/09,15,4,3,0,18
12523,2023/02/09,15,8,5,0,20
16276,2023/02/09,6,4,0,0,6
19322,2023/02/09,5,0,0,0,5
19329,2023/02/09,9,0,2,0,11
19520,2023/02/09,6,0,1,0,7
20901,2023/02/09,10,0,0,0,10
21099,2023/02/09,8,0,1,0,9
21102,2023/02/09,10,0,0,0,10
21103,2023/02/09,9,0,1,0,10
21132,2023/02/09,20,18,14,0,34
21171,2023/02/09,11,4,4,0,15
21174,2023/02/09,17,12,8,0,25
21175,2023/02/09,15,12,12,0,27
21176,2023/02/09,11,8,7,0,18
75,2023/02/10,53,48,49,0,102
76,2023/02/10,52,52,52,0,104
99,2023/02/10,14,0,0,0,14
117,2023/02/10,10,0,2,0,12
118,2023/02/10,4,0,4,0,8
119,2023/02/10,6,0,1,0,7
120,2023/02/10,3,0,2,0,5
149,2023/02/10,10,0,0,0,10
184,2023/02/10,22,15,17,0,39
195,2023/02/10,34,36,30,0,64
218,2023/02/10,38,36,47,1,85
296,2023/02/10,17,8,6,0,23
300,2023/02/10,9,0,1,0,10
304,2023/02/10,11,0,5,0,16
317,2023/02/10,3,6,2,0,5
343,2023/02/10,9,0,2,1,11
353,2023/02/10,5,0,0,0,5
373,2023/02/10,10,6,1,0,11
374,2023/02/10,11,4,3,0,14
388,2023/02/10,36,30,35,0,71
419,2023/02/10,10,6,4,0,14
420,2023/02/10,7,6,1,0,8
462,2023/02/10,17,0,8,0,25
519,2023/02/10,18,12,12,0,30
525,2023/02/10,8,5,0,0,8
596,2023/02/10,31,12,7,1,38
597,2023/02/10,57,30,17,0,74
598,2023/02/10,1,0,1,0,2
1035,2023/02/10,15,6,15,0,30
1084,2023/02/10,36,15,11,1,47
1111,2023/02/10,14,0,2,0,16
1112,2023/02/10,12,0,3,0,15
1113,2023/02/10,14,0,1,0,15
1114,2023/02/10,14,0,0,0,14
1115,2023/02/10,14,0,2,0,16
1117,2023/02/10,7,0,3,0,10
1118,2023/02/10,12,6,1,0,13
1119,2023/02/10,9,0,2,0,11
1692,2023/02/10,6,6,5,0,11
1693,2023/02/10,1,0,1,0,2
1747,2023/02/10,39,25,19,0,58
1772,2023/02/10,13,0,0,0,13
1782,2023/02/10,48,24,26,8,74
1795,2023/02/10,53,21,23,0,76
1914,2023/02/10,9,0,1,0,10
1915,2023/02/10,6,0,1,0,7
1923,2023/02/10,11,0,0,0,11
1934,2023/02/10,7,5,0,0,7
1963,2023/02/10,3,0,3,0,6
1984,2023/02/10,6,6,5,0,11
2135,2023/02/10,16,0,9,0,25
2136,2023/02/10,6,0,3,0,9
2148,2023/02/10,11,4,3,0,14
2183,2023/02/10,11,6,8,0,19
2193,2023/02/10,25,21,18,3,43
2237,2023/02/10,9,0,0,0,9
2358,2023/02/10,13,4,3,0,16
2361,2023/02/10,16,0,9,0,25
2445,2023/02/10,17,12,16,0,33
2449,2023/02/10,12,6,0,0,12
2451,2023/02/10,38,20,17,0,55
2475,2023/02/10,6,0,1,0,7
2476,2023/02/10,5,0,2,0,7
2507,2023/02/10,32,12,25,2,57
2525,2023/02/10,9,0,6,0,15
2562,2023/02/10,0,0,0,0,0
2582,2023/02/10,14,4,2,0,16
2586,2023/02/10,35,8,18,6,53
2631,2023/02/10,12,6,6,0,18
2685,2023/02/10,24,8,8,1,32
2723,2023/02/10,8,0,2,0,10
2730,2023/02/10,8,6,2,0,10
2731,2023/02/10,6,0,5,0,11
2732,2023/02/10,6,0,4,0,10
2734,2023/02/10,11,8,1,0,12
2735,2023/02/10,8,8,0,0,8
2761,2023/02/10,47,15,23,3,70
2788,2023/02/10,17,24,24,4,41
2802,2023/02/10,7,0,2,0,9
2812,2023/02/10,7,0,0,0,7
2813,2023/02/10,6,0,2,0,8
2814,2023/02/10,6,0,0,0,6
2913,2023/02/10,5,0,5,0,10
2914,2023/02/10,10,0,2,0,12
3015,2023/02/10,7,0,6,0,13
3033,2023/02/10,7,0,1,0,8
3035,2023/02/10,8,0,0,0,8
4446,2023/02/10,23,9,14,1,37
12136,2023/02/10,26,30,24,0,50
12516,2023/02/10,15,4,4,0,19
12518,2023/02/10,16,4,2,0,18
12523,2023/02/10,18,8,7,0,25
16276,2023/02/10,6,0,0,2,6
19322,2023/02/10,5,0,0,0,5
19329,2023/02/10,7,0,3,0,10
19520,2023/02/10,5,0,1,0,6
20901,2023/02/10,10,0,0,0,10
21099,2023/02/10,7,0,0,0,7
21102,2023/02/10,10,0,1,0,11
21103,2023/02/10,8,0,0,0,8
21132,2023/02/10,30,24,31,2,61
21171,2023/02/10,11,4,4,1,15
21174,2023/02/10,17,8,15,1,32
21175,2023/02/10,11,8,10,0,21
21176,2023/02/10,12,8,6,0,18
75,2023/02/11,44,40,47,0,91
76,2023/02/11,40,40,38,0,78
99,2023/02/11,14,0,0,0,14
117,2023/02/11,8,0,1,0,9
118,2023/02/11,0,0,0,0,0
119,2023/02/11,5,0,1,0,6
120,2023/02/11,5,4,0,0,5
149,2023/02/11,10,0,1,0,11
184,2023/02/11,17,12,9,0,26
195,2023/02/11,37,33,36,0,73
218,2023/02/11,14,24,20,0,34
296,2023/02/11,19,8,4,0,23
300,2023/02/11,12,4,2,0,14
304,2023/02/11,14,8,2,0,16
317,2023/02/11,13,12,6,0,19
343,2023/02/11,6,0,0,2,6
353,2023/02/11,5,0,0,0,5
373,2023/02/11,9,0,2,0,11
374,2023/02/11,12,4,1,0,13
388,2023/02/11,25,24,26,0,51
419,2023/02/11,6,0,1,0,7
420,2023/02/11,6,0,3,0,9
462,2023/02/11,17,8,4,0,21
519,2023/02/11,18,12,13,0,31
525,2023/02/11,8,0,5,0,13
596,2023/02/11,23,0,5,3,28
597,2023/02/11,40,0,12,0,52
598,2023/02/11,0,0,0,0,0
1035,2023/02/11,6,6,3,0,9
1084,2023/02/11,24,0,8,2,32
1111,2023/02/11,12,0,1,0,13
1112,2023/02/11,9,0,2,0,11
1113,2023/02/11,13,0,2,0,15
1114,2023/02/11,14,0,0,0,14
1115,2023/02/11,12,0,2,0,14
1117,2023/02/11,4,0,1,0,5
1118,2023/02/11,11,0,5,0,16
1119,2023/02/11,7,0,3,0,10
1692,2023/02/11,1,0,1,0,2
1693,2023/02/11,6,6,0,0,6
1747,2023/02/11,50,30,40,0,90
1772,2023/02/11,13,0,0,0,13
1782,2023/02/11,32,18,28,1,60
1795,2023/02/11,58,28,21,0,79
1914,2023/02/11,8,0,5,0,13
1915,2023/02/11,5,0,3,0,8
1923,2023/02/11,11,0,2,0,13
1934,2023/02/11,7,0,1,0,8
1963,2023/02/11,12,12,2,0,14
1984,2023/02/11,1,0,1,0,2
2135,2023/02/11,7,0,8,0,15
2136,2023/02/11,3,0,2,0,5
2148,2023/02/11,12,4,0,0,12
2183,2023/02/11,9,6,4,0,13
2193,2023/02/11,28,24,27,0,55
2237,2023/02/11,9,0,3,0,12
2358,2023/02/11,10,0,2,0,12
2361,2023/02/11,14,7,0,0,14
2445,2023/02/11,7,6,6,0,13
2449,2023/02/11,18,6,1,0,19
2451,2023/02/11,36,15,12,0,48
2475,2023/02/11,5,0,0,0,5
2476,2023/02/11,3,0,1,0,4
2507,2023/02/11,5,0,9,0,14
2525,2023/02/11,3,0,2,0,5
2562,2023/02/11,6,6,2,0,8
2582,2023/02/11,12,0,2,0,14
2586,2023/02/11,23,12,20,0,43
2602,2023/02/11,10,0,0,0,10
2631,2023/02/11,12,6,7,0,19
2685,2023/02/11,27,12,6,6,33
2723,2023/02/11,6,0,5,0,11
2730,2023/02/11,12,6,8,0,20
2731,2023/02/11,7,6,4,0,11
2732,2023/02/11,10,8,8,0,18
2734,2023/02/11,14,4,1,0,15
2735,2023/02/11,8,0,0,0,8
2761,2023/02/11,41,20,20,0,61
2788,2023/02/11,17,28,30,0,47
2802,2023/02/11,5,0,4,0,9
2812,2023/02/11,7,0,0,0,7
2813,2023/02/11,4,0,0,0,4
2814,2023/02/11,12,6,4,0,16
2913,2023/02/11,6,6,3,0,9
2914,2023/02/11,8,0,3,0,11
3015,2023/02/11,9,8,8,0,17
3033,2023/02/11,6,0,1,0,7
3035,2023/02/11,8,0,0,0,8
4446,2023/02/11,14,6,14,0,28
12136,2023/02/11,23,21,27,0,50
12516,2023/02/11,11,0,2,0,13
12518,2023/02/11,14,0,4,0,18
12523,2023/02/11,19,8,8,0,27
16276,2023/02/11,4,0,0,0,4
19322,2023/02/11,5,0,3,0,8
19329,2023/02/11,4,0,1,0,5
19520,2023/02/11,12,8,1,0,13
20901,2023/02/11,10,0,1,0,11
21099,2023/02/11,7,0,0,0,7
21102,2023/02/11,9,0,1,0,10
21103,2023/02/11,8,0,0,0,8
21132,2023/02/11,18,21,16,0,34
21171,2023/02/11,10,4,6,0,16
21174,2023/02/11,17,16,16,0,33
21175,2023/02/11,13,12,13,0,26
21176,2023/02/11,14,8,11,0,25
75,2023/02/12,37,40,33,0,70
76,2023/02/12,42,40,30,0,72
99,2023/02/12,14,0,2,0,16
117,2023/02/12,7,0,1,2,8
118,2023/02/12,4,4,1,0,5
119,2023/02/12,4,0,2,0,6
120,2023/02/12,9,4,6,0,15
149,2023/02/12,9,0,0,0,9
184,2023/02/12,17,9,9,0,26
195,2023/02/12,25,24,25,0,50
218,2023/02/12,23,27,17,0,40
296,2023/02/12,23,8,5,0,28
300,2023/02/12,14,4,3,0,17
304,2023/02/12,16,4,6,0,22
317,2023/02/12,13,6,5,0,18
343,2023/02/12,4,0,3,0,7
353,2023/02/12,5,0,0,0,5
373,2023/02/12,13,6,6,0,19
374,2023/02/12,23,12,3,0,26
388,2023/02/12,21,21,9,0,30
419,2023/02/12,11,6,2,0,13
420,2023/02/12,9,6,1,0,10
462,2023/02/12,21,8,7,0,28
519,2023/02/12,17,12,8,0,25
525,2023/02/12,8,5,0,0,8
596,2023/02/12,23,8,7,3,30
597,2023/02/12,40,12,8,8,48
598,2023/02/12,6,6,3,0,9
1035,2023/02/12,9,6,3,0,12
1084,2023/02/12,24,10,5,6,29
1111,2023/02/12,11,0,3,0,14
1112,2023/02/12,7,0,0,0,7
1113,2023/02/12,11,0,4,0,15
1114,2023/02/12,20,6,6,0,26
1115,2023/02/12,10,0,7,1,17
1117,2023/02/12,11,8,1,0,12
1118,2023/02/12,6,0,0,0,6
1119,2023/02/12,4,0,1,0,5
1692,2023/02/12,6,6,4,0,10
1693,2023/02/12,6,0,1,0,7
1747,2023/02/12,25,15,12,1,37
1772,2023/02/12,13,0,0,0,13
1782,2023/02/12,24,21,15,0,39
1795,2023/02/12,37,0,8,0,45
1914,2023/02/12,3,0,1,0,4
1915,2023/02/12,2,0,2,0,4
1923,2023/02/12,9,0,2,0,11
1934,2023/02/12,11,5,2,0,13
1963,2023/02/12,16,6,7,0,23
1984,2023/02/12,6,6,2,0,8
2135,2023/02/12,-1,0,2,0,1
2136,2023/02/12,7,6,2,0,9
2148,2023/02/12,16,4,1,0,17
2183,2023/02/12,5,0,1,0,6
2193,2023/02/12,16,15,6,0,22
2237,2023/02/12,12,6,2,0,14
2358,2023/02/12,16,8,5,0,21
2361,2023/02/12,21,7,6,0,27
2445,2023/02/12,7,6,6,0,13
2449,2023/02/12,23,6,4,0,27
2451,2023/02/12,74,50,16,0,90
2475,2023/02/12,5,0,0,0,5
2476,2023/02/12,8,6,1,0,9
2507,2023/02/12,8,12,9,0,17
2525,2023/02/12,7,6,4,0,11
2562,2023/02/12,10,6,3,0,13
2582,2023/02/12,10,0,0,0,10
2586,2023/02/12,19,16,12,0,31
2602,2023/02/12,10,0,0,0,10
2631,2023/02/12,11,6,2,0,13
2685,2023/02/12,19,4,9,3,28
2723,2023/02/12,9,8,6,0,15
2730,2023/02/12,4,0,2,0,6
2731,2023/02/12,9,6,6,0,15
2732,2023/02/12,2,0,0,0,2
2734,2023/02/12,17,4,5,0,22
2735,2023/02/12,12,4,7,1,19
2761,2023/02/12,36,15,26,3,62
2788,2023/02/12,7,20,9,0,16
2802,2023/02/12,7,6,2,0,9
2812,2023/02/12,7,0,2,0,9
2813,2023/02/12,10,6,6,0,16
2814,2023/02/12,8,0,1,0,9
2913,2023/02/12,3,0,1,0,4
2914,2023/02/12,5,0,0,0,5
3015,2023/02/12,1,0,1,0,2
3033,2023/02/12,5,0,1,0,6
3035,2023/02/12,8,0,1,0,9
4446,2023/02/12,9,9,8,0,17
12136,2023/02/12,26,30,23,0,49
12516,2023/02/12,9,0,1,0,10
12518,2023/02/12,10,0,3,0,13
12523,2023/02/12,19,8,4,0,23
16276,2023/02/12,8,4,2,0,10
19322,2023/02/12,2,0,0,0,2
19329,2023/02/12,9,6,1,0,10
19520,2023/02/12,11,0,5,0,16
20901,2023/02/12,9,0,2,0,11
21099,2023/02/12,7,0,0,0,7
21102,2023/02/12,8,0,0,0,8
21103,2023/02/12,8,0,2,0,10
21132,2023/02/12,20,18,12,0,32
21171,2023/02/12,4,0,2,0,6
21174,2023/02/12,13,12,8,0,21
21175,2023/02/12,12,12,7,0,19
21176,2023/02/12,11,8,6,0,17
75,2023/02/13,52,48,28,3,80
76,2023/02/13,67,56,50,1,117
99,2023/02/13,12,0,0,0,12
117,2023/02/13,4,0,2,2,6
118,2023/02/13,11,8,5,0,16
119,2023/02/13,6,4,0,0,6
120,2023/02/13,3,0,2,0,5
149,2023/02/13,9,0,3,0,12
184,2023/02/13,23,15,6,0,29
195,2023/02/13,39,39,34,0,73
218,2023/02/13,43,39,32,4,75
296,2023/02/13,18,0,5,0,23
300,2023/02/13,15,4,4,0,19
304,2023/02/13,14,4,4,0,18
317,2023/02/13,14,6,4,0,18
343,2023/02/13,1,0,0,0,1
353,2023/02/13,5,0,1,0,6
373,2023/02/13,7,0,1,0,8
374,2023/02/13,20,0,2,0,22
388,2023/02/13,41,30,14,7,55
419,2023/02/13,9,0,2,0,11
420,2023/02/13,8,0,1,0,9
462,2023/02/13,22,8,9,0,31
519,2023/02/13,15,6,7,1,22
525,2023/02/13,8,0,0,3,8
596,2023/02/13,13,0,3,0,16
597,2023/02/13,24,0,7,2,31
598,2023/02/13,3,0,3,0,6
1035,2023/02/13,6,0,3,0,9
1084,2023/02/13,23,10,8,3,31
1111,2023/02/13,8,0,2,0,10
1112,2023/02/13,7,0,0,0,7
1113,2023/02/13,7,0,2,0,9
1114,2023/02/13,20,6,2,0,22
1115,2023/02/13,2,0,1,0,3
1117,2023/02/13,10,0,1,0,11
1118,2023/02/13,12,6,1,0,13
1119,2023/02/13,3,0,0,0,3
1692,2023/02/13,2,0,2,0,4
1693,2023/02/13,11,6,3,0,14
1747,2023/02/13,32,20,24,0,56
1772,2023/02/13,13,0,0,0,13
1782,2023/02/13,30,21,26,0,56
1795,2023/02/13,43,14,10,4,53
1914,2023/02/13,8,6,1,0,9
1915,2023/02/13,0,0,0,0,0
1923,2023/02/13,7,0,0,0,7
1934,2023/02/13,9,0,3,0,12
1963,2023/02/13,21,12,7,0,28
1984,2023/02/13,4,0,1,0,5
2135,2023/02/13,3,6,3,0,6
2136,2023/02/13,11,6,3,0,14
2148,2023/02/13,15,0,5,0,20
2183,2023/02/13,10,6,3,0,13
2193,2023/02/13,31,21,18,6,49
2237,2023/02/13,10,0,3,0,13
2358,2023/02/13,11,0,4,0,15
2361,2023/02/13,22,7,4,0,26
2445,2023/02/13,1,0,0,0,1
2449,2023/02/13,19,0,3,0,22
2451,2023/02/13,58,0,10,0,68
2475,2023/02/13,11,6,0,0,11
2476,2023/02/13,13,6,1,0,14
2507,2023/02/13,11,12,2,0,13
2525,2023/02/13,9,6,1,0,10
2562,2023/02/13,7,0,1,0,8
2582,2023/02/13,10,0,3,0,13
2586,2023/02/13,23,16,14,0,37
2631,2023/02/13,9,0,2,0,11
2685,2023/02/13,15,8,7,0,22
2723,2023/02/13,3,0,2,0,5
2730,2023/02/13,8,6,3,0,11
2731,2023/02/13,9,6,0,0,9
2732,2023/02/13,2,0,0,0,2
2734,2023/02/13,12,0,4,0,16
2735,2023/02/13,12,8,1,0,13
2761,2023/02/13,22,15,18,0,40
2788,2023/02/13,22,24,19,2,41
2802,2023/02/13,5,0,1,0,6
2812,2023/02/13,5,0,0,0,5
2813,2023/02/13,4,0,1,0,5
2814,2023/02/13,7,0,1,0,8
2913,2023/02/13,2,0,1,0,3
2914,2023/02/13,5,0,0,0,5
3015,2023/02/13,8,8,5,0,13
3033,2023/02/13,4,0,0,0,4
3035,2023/02/13,7,0,0,0,7
4446,2023/02/13,13,12,2,0,15
12136,2023/02/13,33,30,30,0,63
12516,2023/02/13,8,0,0,0,8
12518,2023/02/13,11,4,3,0,14
12523,2023/02/13,15,0,8,1,23
16276,2023/02/13,6,0,1,0,7
19322,2023/02/13,2,0,0,0,2
19329,2023/02/13,8,0,1,0,9
19520,2023/02/13,6,0,3,0,9
20901,2023/02/13,7,0,0,0,7
21099,2023/02/13,7,0,0,0,7
21102,2023/02/13,8,0,1,0,9
21103,2023/02/13,6,0,1,0,7
21132,2023/02/13,35,27,13,4,48
21171,2023/02/13,2,0,0,0,2
21174,2023/02/13,21,16,12,0,33
21175,2023/02/13,17,12,9,0,26
21176,2023/02/13,13,8,4,0,17
75,2023/02/14,69,48,44,4,113
76,2023/02/14,69,52,55,0,124
99,2023/02/14,12,0,0,0,12
117,2023/02/14,8,8,0,0,8
118,2023/02/14,6,0,1,0,7
119,2023/02/14,6,0,0,2,6
120,2023/02/14,5,4,2,0,7
149,2023/02/14,6,0,1,0,7
184,2023/02/14,29,12,9,1,38
195,2023/02/14,44,39,36,1,80
218,2023/02/14,41,33,37,2,78
296,2023/02/14,17,4,4,0,21
300,2023/02/14,15,4,5,0,20
304,2023/02/14,18,8,2,0,20
317,2023/02/14,16,6,2,0,18
343,2023/02/14,9,8,0,0,9
353,2023/02/14,4,0,0,0,4
373,2023/02/14,6,0,1,4,7
374,2023/02/14,22,4,5,0,27
388,2023/02/14,53,33,23,8,76
419,2023/02/14,13,6,6,1,19
420,2023/02/14,7,0,2,0,9
462,2023/02/14,21,8,9,0,30
519,2023/02/14,13,6,3,0,16
525,2023/02/14,5,0,1,0,6
596,2023/02/14,14,4,1,0,15
597,2023/02/14,27,12,12,0,39
598,2023/02/14,6,6,1,0,7
1035,2023/02/14,9,6,1,0,10
1084,2023/02/14,12,0,11,0,23
1111,2023/02/14,6,0,0,0,6
1112,2023/02/14,13,6,0,0,13
1113,2023/02/14,5,0,1,0,6
1114,2023/02/14,18,0,3,0,21
1115,2023/02/14,7,6,2,0,9
1117,2023/02/14,9,0,3,0,12
1118,2023/02/14,11,0,2,0,13
1119,2023/02/14,3,0,1,0,4
1692,2023/02/14,6,6,6,0,12
1693,2023/02/14,8,0,1,0,9
1747,2023/02/14,28,20,26,0,54
1772,2023/02/14,13,0,0,0,13
1782,2023/02/14,22,18,13,1,35
1795,2023/02/14,43,14,26,1,69
1914,2023/02/14,13,6,0,0,13
1923,2023/02/14,7,0,0,0,7
1934,2023/02/14,6,0,2,2,8
1963,2023/02/14,21,6,3,0,24
1984,2023/02/14,9,6,2,0,11
2135,2023/02/14,6,6,2,0,8
2136,2023/02/14,8,0,0,0,8
2148,2023/02/14,14,4,1,0,15
2183,2023/02/14,13,6,3,0,16
2193,2023/02/14,34,27,27,1,61
2237,2023/02/14,7,0,3,0,10
2358,2023/02/14,11,4,1,0,12
2361,2023/02/14,25,7,7,0,32
2445,2023/02/14,7,6,4,0,11
2449,2023/02/14,16,0,3,0,19
2451,2023/02/14,48,0,16,0,64
2475,2023/02/14,11,0,0,0,11
2476,2023/02/14,12,0,1,0,13
2507,2023/02/14,27,18,15,0,42
2525,2023/02/14,8,0,1,0,9
2562,2023/02/14,12,6,1,0,13
2582,2023/02/14,11,4,2,0,13
2586,2023/02/14,29,20,28,0,57
2631,2023/02/14,7,0,2,1,9
2685,2023/02/14,8,0,5,3,13
2723,2023/02/14,9,8,3,0,12
2730,2023/02/14,11,6,1,0,12
2731,2023/02/14,9,0,1,0,10
2732,2023/02/14,10,8,1,0,11
2734,2023/02/14,8,0,6,0,14
2735,2023/02/14,15,4,6,0,21
2761,2023/02/14,24,20,12,1,36
2788,2023/02/14,39,36,24,12,63
2802,2023/02/14,4,0,1,0,5
2812,2023/02/14,5,0,0,0,5
2813,2023/02/14,3,0,2,0,5
2814,2023/02/14,6,0,0,0,6
2913,2023/02/14,7,6,1,0,8
2914,2023/02/14,11,6,1,0,12
3015,2023/02/14,11,8,6,0,17
3033,2023/02/14,4,0,0,0,4
3035,2023/02/14,7,0,0,0,7
4446,2023/02/14,26,15,7,1,33
12136,2023/02/14,38,33,33,4,71
12516,2023/02/14,12,4,3,0,15
12518,2023/02/14,12,4,5,0,17
12523,2023/02/14,10,4,3,0,13
16276,2023/02/14,5,0,0,0,5
19322,2023/02/14,8,6,0,0,8
19329,2023/02/14,7,0,4,0,11
19520,2023/02/14,3,0,0,0,3
20901,2023/02/14,7,0,1,0,8
21099,2023/02/14,7,0,0,0,7
21102,2023/02/14,7,0,0,0,7
21103,2023/02/14,5,0,2,0,7
21132,2023/02/14,45,27,13,10,58
21171,2023/02/14,6,4,2,0,8
21174,2023/02/14,22,12,15,2,37
21175,2023/02/14,20,12,10,4,30
21176,2023/02/14,17,8,5,0,22
75,2023/02/15,65,44,59,3,124
76,2023/02/15,49,44,42,7,91
99,2023/02/15,12,0,0,0,12
117,2023/02/15,8,0,0,0,8
118,2023/02/15,13,8,4,0,17
119,2023/02/15,8,4,1,0,9
120,2023/02/15,3,0,1,0,4
149,2023/02/15,5,0,0,0,5
184,2023/02/15,29,12,6,2,35
195,2023/02/15,35,30,37,1,72
218,2023/02/15,33,30,34,0,67
296,2023/02/15,17,4,7,0,24
300,2023/02/15,10,0,4,0,14
304,2023/02/15,16,0,1,0,17
317,2023/02/15,20,6,5,0,25
343,2023/02/15,9,0,3,0,12
353,2023/02/15,10,6,0,0,10
373,2023/02/15,1,0,0,0,1
374,2023/02/15,17,0,3,0,20
388,2023/02/15,49,30,26,12,75
419,2023/02/15,12,6,3,0,15
420,2023/02/15,11,6,0,0,11
462,2023/02/15,12,0,7,0,19
519,2023/02/15,16,6,1,0,17
525,2023/02/15,9,5,1,0,10
596,2023/02/15,11,0,4,2,15
597,2023/02/15,34,18,11,1,45
598,2023/02/15,5,0,2,0,7
1035,2023/02/15,14,6,6,0,20
1084,2023/02/15,12,10,12,0,24
1111,2023/02/15,12,6,1,0,13
1112,2023/02/15,13,0,0,0,13
1113,2023/02/15,10,6,2,0,12
1114,2023/02/15,15,0,1,0,16
1115,2023/02/15,11,6,4,0,15
1117,2023/02/15,6,0,2,0,8
1118,2023/02/15,9,0,0,0,9
1119,2023/02/15,8,6,2,0,10
1692,2023/02/15,6,6,2,0,8
1693,2023/02/15,7,0,2,0,9
1747,2023/02/15,38,35,28,2,66
1772,2023/02/15,13,0,0,0,13
1782,2023/02/15,27,27,19,0,46
1795,2023/02/15,31,14,13,0,44
1914,2023/02/15,13,0,0,0,13
1923,2023/02/15,13,6,4,0,17
1934,2023/02/15,2,0,2,0,4
1963,2023/02/15,23,6,8,0,31
1984,2023/02/15,13,6,5,0,18
2135,2023/02/15,10,6,2,0,12
2136,2023/02/15,8,0,0,0,8
2148,2023/02/15,13,0,2,0,15
2183,2023/02/15,16,6,5,0,21
2193,2023/02/15,25,21,24,6,49
2237,2023/02/15,10,6,2,0,12
2358,2023/02/15,10,0,6,0,16
2361,2023/02/15,5,0,4,0,9
2445,2023/02/15,9,6,4,0,13
2449,2023/02/15,13,0,4,0,17
2451,2023/02/15,37,0,16,5,53
2475,2023/02/15,11,0,0,0,11
2476,2023/02/15,11,0,1,0,12
2507,2023/02/15,28,12,7,0,35
2525,2023/02/15,13,6,2,0,15
2562,2023/02/15,11,0,1,0,12
2582,2023/02/15,13,4,3,0,16
2586,2023/02/15,17,20,14,0,31
2631,2023/02/15,10,6,3,0,13
2685,2023/02/15,7,4,5,0,12
2723,2023/02/15,14,8,2,0,16
2730,2023/02/15,10,0,1,0,11
2731,2023/02/15,14,6,2,0,16
2732,2023/02/15,9,0,1,0,10
2734,2023/02/15,2,0,0,0,2
2735,2023/02/15,13,4,1,0,14
2761,2023/02/15,26,15,19,0,45
2788,2023/02/15,43,28,26,12,69
2802,2023/02/15,9,6,1,0,10
2812,2023/02/15,11,6,1,0,12
2813,2023/02/15,7,6,1,0,8
2814,2023/02/15,12,6,0,0,12
2913,2023/02/15,6,0,1,0,7
2914,2023/02/15,10,0,0,0,10
3015,2023/02/15,5,0,2,0,7
3033,2023/02/15,10,6,0,0,10
3035,2023/02/15,7,0,0,0,7
4446,2023/02/15,36,12,18,5,54
12136,2023/02/15,29,33,28,1,57
12516,2023/02/15,13,4,2,0,15
12518,2023/02/15,7,0,4,0,11
12523,2023/02/15,11,4,5,0,16
16276,2023/02/15,5,0,2,0,7
19322,2023/02/15,14,6,0,0,14
19329,2023/02/15,3,0,0,0,3
19520,2023/02/15,11,8,3,0,14
20901,2023/02/15,6,0,0,0,6
21099,2023/02/15,7,0,0,0,7
21102,2023/02/15,7,0,2,0,9
21103,2023/02/15,13,10,1,0,14
21132,2023/02/15,32,12,20,11,52
21171,2023/02/15,6,4,0,0,6
21174,2023/02/15,17,12,14,3,31
21175,2023/02/15,19,12,9,3,28
21176,2023/02/15,18,8,0,6,18
75,2023/02/16,39,36,38,0,77
76,2023/02/16,40,40,39,0,79
99,2023/02/16,12,0,1,0,13
117,2023/02/16,16,8,2,0,18
118,2023/02/16,9,0,2,0,11
119,2023/02/16,7,0,3,0,10
120,2023/02/16,6,4,2,0,8
149,2023/02/16,5,6,0,0,5
184,2023/02/16,33,12,11,0,44
195,2023/02/16,24,27,31,0,55
218,2023/02/16,35,36,39,0,74
296,2023/02/16,10,0,7,3,17
300,2023/02/16,10,4,6,0,16
304,2023/02/16,19,4,5,4,24
317,2023/02/16,15,0,6,0,21
343,2023/02/16,14,8,3,0,17
353,2023/02/16,10,0,0,0,10
373,2023/02/16,1,0,0,1,1
374,2023/02/16,14,0,5,0,19
388,2023/02/16,41,30,38,4,79
419,2023/02/16,15,6,5,0,20
420,2023/02/16,11,0,3,0,14
462,2023/02/16,14,8,8,0,22
519,2023/02/16,21,6,11,0,32
525,2023/02/16,8,0,0,0,8
596,2023/02/16,13,8,3,3,16
597,2023/02/16,33,12,19,0,52
598,2023/02/16,9,6,3,0,12
1035,2023/02/16,8,0,3,0,11
1084,2023/02/16,15,15,12,1,27
1111,2023/02/16,11,0,0,0,11
1112,2023/02/16,13,0,0,0,13
1113,2023/02/16,8,0,0,0,8
1114,2023/02/16,14,0,0,0,14
1115,2023/02/16,7,0,2,0,9
1117,2023/02/16,4,0,0,0,4
1118,2023/02/16,9,0,3,0,12
1119,2023/02/16,6,0,1,0,7
1692,2023/02/16,10,6,2,0,12
1693,2023/02/16,5,0,4,0,9
1747,2023/02/16,23,15,19,0,42
1782,2023/02/16,32,24,26,1,58
1795,2023/02/16,18,0,13,0,31
1914,2023/02/16,13,0,0,0,13
1923,2023/02/16,9,0,2,0,11
1934,2023/02/16,0,0,0,0,0
1963,2023/02/16,15,0,4,0,19
1984,2023/02/16,14,6,6,0,20
2135,2023/02/16,8,6,5,0,13
2136,2023/02/16,8,6,1,0,9
2148,2023/02/16,11,0,5,0,16
2183,2023/02/16,17,6,10,0,27
2193,2023/02/16,7,12,8,0,15
2237,2023/02/16,8,0,1,0,9
2358,2023/02/16,4,0,5,0,9
2361,2023/02/16,1,0,0,0,1
2445,2023/02/16,11,6,8,0,19
2449,2023/02/16,9,0,2,7,11
2451,2023/02/16,36,20,20,0,56
2475,2023/02/16,11,0,0,0,11
2476,2023/02/16,10,0,1,0,11
2507,2023/02/16,33,12,13,0,46
2525,2023/02/16,11,0,2,0,13
2562,2023/02/16,16,6,3,0,19
2582,2023/02/16,15,4,1,0,16
2586,2023/02/16,23,20,14,0,37
2631,2023/02/16,13,6,6,0,19
2685,2023/02/16,2,0,0,0,2
2723,2023/02/16,12,0,0,0,12
2730,2023/02/16,9,0,2,0,11
2731,2023/02/16,12,0,1,0,13
2732,2023/02/16,8,0,0,0,8
2734,2023/02/16,6,4,4,0,10
2735,2023/02/16,16,4,6,0,22
2761,2023/02/16,27,20,21,0,48
2788,2023/02/16,33,28,21,4,54
2802,2023/02/16,8,0,1,0,9
2812,2023/02/16,10,0,1,0,11
2813,2023/02/16,6,6,1,0,7
2814,2023/02/16,12,0,1,0,13
2913,2023/02/16,5,0,1,0,6
2914,2023/02/16,10,0,0,0,10
3015,2023/02/16,3,0,1,0,4
3033,2023/02/16,10,0,1,0,11
3035,2023/02/16,7,0,0,0,7
4446,2023/02/16,22,9,9,2,31
12136,2023/02/16,31,33,36,0,67
12516,2023/02/16,15,4,2,0,17
12518,2023/02/16,3,0,2,0,5
12523,2023/02/16,10,4,2,0,12
16062,2023/02/16,8,6,2,0,10
16276,2023/02/16,3,0,3,0,6
19322,2023/02/16,14,0,0,0,14
19329,2023/02/16,3,6,2,0,5
19520,2023/02/16,8,0,2,0,10
20901,2023/02/16,6,0,0,0,6
21099,2023/02/16,7,0,0,0,7
21102,2023/02/16,5,0,1,0,6
21103,2023/02/16,12,0,1,0,13
21132,2023/02/16,25,24,23,2,48
21171,2023/02/16,10,4,1,0,11
21174,2023/02/16,9,8,6,0,15
21175,2023/02/16,19,12,15,3,34
21176,2023/02/16,20,8,5,4,25
75,2023/02/17,41,40,50,0,91
76,2023/02/17,41,40,63,0,104
99,2023/02/17,11,0,0,0,11
117,2023/02/17,14,0,3,0,17
118,2023/02/17,15,8,3,0,18
119,2023/02/17,4,0,0,0,4
120,2023/02/17,4,0,2,0,6
149,2023/02/17,17,6,0,0,17
184,2023/02/17,34,12,20,6,54
195,2023/02/17,29,36,40,0,69
218,2023/02/17,29,33,33,0,62
296,2023/02/17,4,4,4,0,8
300,2023/02/17,4,0,2,0,6
304,2023/02/17,10,0,3,0,13
317,2023/02/17,15,6,9,0,24
343,2023/02/17,11,0,1,0,12
353,2023/02/17,10,0,0,0,10
373,2023/02/17,6,6,3,0,9
374,2023/02/17,9,0,1,0,10
388,2023/02/17,29,30,30,0,59
419,2023/02/17,10,0,4,0,14
420,2023/02/17,8,0,3,0,11
462,2023/02/17,13,8,4,0,17
519,2023/02/17,22,12,14,0,36
525,2023/02/17,8,0,4,0,12
596,2023/02/17,15,8,4,0,19
597,2023/02/17,32,18,13,0,45
598,2023/02/17,6,0,3,0,9
1035,2023/02/17,11,6,9,0,20
1084,2023/02/17,22,20,12,0,34
1111,2023/02/17,11,0,1,0,12
1112,2023/02/17,13,0,2,0,15
1113,2023/02/17,8,0,0,0,8
1114,2023/02/17,20,6,3,0,23
1115,2023/02/17,11,6,3,0,14
1117,2023/02/17,4,0,0,0,4
1118,2023/02/17,12,6,2,0,14
1119,2023/02/17,5,0,0,0,5
1692,2023/02/17,8,0,7,0,15
1693,2023/02/17,7,6,1,0,8
1747,2023/02/17,34,30,31,0,65
1772,2023/02/17,13,0,1,0,14
1782,2023/02/17,38,33,38,3,76
1795,2023/02/17,19,14,16,0,35
1914,2023/02/17,13,0,3,0,16
1923,2023/02/17,7,0,0,0,7
1934,2023/02/17,0,0,0,0,0
1963,2023/02/17,17,6,6,0,23
1984,2023/02/17,8,0,3,0,11
2135,2023/02/17,15,6,3,0,18
2136,2023/02/17,13,0,2,0,15
2148,2023/02/17,6,0,3,0,9
2183,2023/02/17,13,6,5,0,18
2193,2023/02/17,17,18,18,0,35
2237,2023/02/17,13,6,2,0,15
2358,2023/02/17,7,8,1,0,8
2361,2023/02/17,1,0,0,0,1
2445,2023/02/17,15,12,14,0,29
2449,2023/02/17,0,0,0,0,0
2451,2023/02/17,31,15,20,1,51
2475,2023/02/17,11,0,1,0,12
2476,2023/02/17,9,0,1,0,10
2507,2023/02/17,32,12,6,0,38
2525,2023/02/17,15,6,1,0,16
2562,2023/02/17,13,0,4,0,17
2582,2023/02/17,13,0,2,0,15
2586,2023/02/17,25,16,15,0,40
2631,2023/02/17,13,6,10,0,23
2685,2023/02/17,18,16,6,0,24
2723,2023/02/17,12,0,1,0,13
2730,2023/02/17,7,0,2,0,9
2731,2023/02/17,11,0,0,0,11
2732,2023/02/17,16,8,1,0,17
2734,2023/02/17,2,0,0,0,2
2735,2023/02/17,10,0,7,0,17
2761,2023/02/17,36,30,18,0,54
2788,2023/02/17,32,24,28,4,60
2802,2023/02/17,13,6,0,0,13
2812,2023/02/17,9,0,1,0,10
2813,2023/02/17,11,0,1,0,12
2814,2023/02/17,11,0,2,0,13
2913,2023/02/17,10,6,2,0,12
2914,2023/02/17,10,0,3,0,13
3015,2023/02/17,10,8,3,0,13
3033,2023/02/17,9,0,0,0,9
3035,2023/02/17,7,0,0,0,7
4446,2023/02/17,26,15,13,5,39
12136,2023/02/17,25,30,31,0,56
12516,2023/02/17,13,0,1,0,14
12518,2023/02/17,5,4,4,0,9
12523,2023/02/17,16,8,9,0,25
16062,2023/02/17,12,0,1,0,13
16276,2023/02/17,0,0,0,0,0
19322,2023/02/17,14,0,1,0,15
19329,2023/02/17,7,0,0,0,7
19520,2023/02/17,6,0,2,0,8
20901,2023/02/17,6,0,1,0,7
21099,2023/02/17,7,0,1,0,8
21102,2023/02/17,4,0,0,0,4
21103,2023/02/17,11,0,2,0,13
21132,2023/02/17,6,6,10,0,16
21171,2023/02/17,13,4,4,0,17
21174,2023/02/17,18,16,16,0,34
21175,2023/02/17,5,4,4,1,9
21176,2023/02/17,19,8,8,1,27
75,2023/02/18,31,40,24,0,55
76,2023/02/18,30,52,29,0,59
99,2023/02/18,11,0,0,0,11
117,2023/02/18,11,0,2,0,13
118,2023/02/18,12,0,5,0,17
119,2023/02/18,8,4,0,2,8
120,2023/02/18,6,4,1,0,7
149,2023/02/18,17,0,1,0,18
184,2023/02/18,17,9,13,0,30
195,2023/02/18,26,36,30,0,56
218,2023/02/18,26,30,27,0,53
296,2023/02/18,0,0,0,0,0
300,2023/02/18,6,4,3,1,9
304,2023/02/18,7,0,4,0,11
317,2023/02/18,6,0,5,2,11
343,2023/02/18,10,0,4,0,14
353,2023/02/18,10,0,0,0,10
373,2023/02/18,3,0,3,0,6
374,2023/02/18,12,4,4,0,16
388,2023/02/18,23,24,17,0,40
419,2023/02/18,6,0,0,0,6
420,2023/02/18,5,0,1,1,6
462,2023/02/18,17,8,10,0,27
519,2023/02/18,14,6,10,0,24
525,2023/02/18,4,0,0,1,4
596,2023/02/18,11,0,6,0,17
597,2023/02/18,19,0,17,0,36
598,2023/02/18,3,0,2,0,5
1035,2023/02/18,2,0,2,0,4
1084,2023/02/18,10,0,5,0,15
1111,2023/02/18,10,0,2,0,12
1112,2023/02/18,11,0,1,0,12
1113,2023/02/18,8,0,2,0,10
1114,2023/02/18,17,0,0,0,17
1115,2023/02/18,8,0,1,0,9
1117,2023/02/18,4,0,1,0,5
1118,2023/02/18,10,0,2,0,12
1119,2023/02/18,11,6,0,0,11
1692,2023/02/18,7,6,1,0,8
1693,2023/02/18,6,0,0,0,6
1747,2023/02/18,28,25,29,0,57
1772,2023/02/18,12,0,3,0,15
1782,2023/02/18,27,30,15,0,42
1795,2023/02/18,24,21,16,0,40
1914,2023/02/18,10,0,1,0,11
1923,2023/02/18,7,0,1,0,8
1934,2023/02/18,5,5,4,0,9
1963,2023/02/18,11,0,3,0,14
1984,2023/02/18,5,0,1,0,6
2135,2023/02/18,18,6,8,0,26
2136,2023/02/18,11,0,0,0,11
2148,2023/02/18,3,0,2,0,5
2183,2023/02/18,8,0,6,0,14
2193,2023/02/18,23,24,13,4,36
2237,2023/02/18,11,0,3,0,14
2358,2023/02/18,10,4,2,0,12
2361,2023/02/18,8,7,6,0,14
2445,2023/02/18,7,6,6,0,13
2449,2023/02/18,0,0,0,0,0
2451,2023/02/18,10,0,9,0,19
2475,2023/02/18,10,0,1,0,11
2476,2023/02/18,8,0,1,0,9
2507,2023/02/18,44,18,12,1,56
2525,2023/02/18,14,0,5,0,19
2562,2023/02/18,9,0,1,0,10
2582,2023/02/18,11,0,2,0,13
2586,2023/02/18,38,28,14,1,52
2602,2023/02/18,10,0,1,0,11
2631,2023/02/18,9,6,3,0,12
2685,2023/02/18,20,8,5,0,25
2723,2023/02/18,11,0,0,0,11
2730,2023/02/18,11,6,2,0,13
2731,2023/02/18,11,0,5,0,16
2732,2023/02/18,15,0,1,0,16
2734,2023/02/18,6,4,4,0,10
2735,2023/02/18,7,4,4,0,11
2761,2023/02/18,38,20,12,0,50
2788,2023/02/18,32,32,17,0,49
2802,2023/02/18,13,0,2,0,15
2812,2023/02/18,8,0,2,0,10
2813,2023/02/18,16,6,1,0,17
2814,2023/02/18,9,0,1,0,10
2913,2023/02/18,8,0,5,0,13
2914,2023/02/18,7,0,0,0,7
3015,2023/02/18,15,8,2,0,17
3033,2023/02/18,9,0,2,0,11
3035,2023/02/18,7,0,0,0,7
4446,2023/02/18,17,9,8,0,25
12136,2023/02/18,21,27,24,0,45
12516,2023/02/18,12,0,1,0,13
12518,2023/02/18,5,4,3,0,8
12523,2023/02/18,15,8,5,0,20
16062,2023/02/18,11,0,0,0,11
16276,2023/02/18,0,0,0,0,0
19322,2023/02/18,13,0,1,0,14
19329,2023/02/18,13,6,0,0,13
19520,2023/02/18,4,0,0,0,4
20901,2023/02/18,5,0,1,0,6
21099,2023/02/18,6,0,0,0,6
21102,2023/02/18,4,0,0,0,4
21103,2023/02/18,9,0,0,0,9
21132,2023/02/18,17,21,12,0,29
21171,2023/02/18,13,4,2,1,15
21174,2023/02/18,18,16,10,0,28
21175,2023/02/18,12,12,7,0,19
21176,2023/02/18,18,8,2,4,20
75,2023/02/19,55,48,35,2,90
76,2023/02/19,41,40,29,0,70
99,2023/02/19,19,0,0,0,19
117,2023/02/19,9,0,1,4,10
118,2023/02/19,7,0,4,0,11
119,2023/02/19,6,0,0,2,6
120,2023/02/19,9,4,1,0,10
149,2023/02/19,14,0,1,0,15
184,2023/02/19,4,0,2,0,6
195,2023/02/19,22,27,22,0,44
218,2023/02/19,35,36,21,0,56
296,2023/02/19,8,8,7,0,15
300,2023/02/19,6,4,6,0,12
304,2023/02/19,7,4,5,0,12
317,2023/02/19,-1,0,6,0,5
343,2023/02/19,6,0,3,0,9
353,2023/02/19,10,0,1,0,11
373,2023/02/19,6,6,4,1,10
374,2023/02/19,12,4,4,0,16
388,2023/02/19,18,12,10,0,28
419,2023/02/19,12,6,6,0,18
420,2023/02/19,3,0,0,2,3
462,2023/02/19,15,8,8,0,23
519,2023/02/19,10,6,1,0,11
525,2023/02/19,3,0,1,0,4
596,2023/02/19,13,8,7,0,20
597,2023/02/19,14,12,9,0,23
598,2023/02/19,7,6,1,0,8
1035,2023/02/19,6,6,1,0,7
1084,2023/02/19,20,15,11,0,31
1111,2023/02/19,17,0,1,0,18
1112,2023/02/19,5,0,0,0,5
1113,2023/02/19,14,6,0,0,14
1114,2023/02/19,0,0,0,0,0
1115,2023/02/19,14,6,4,0,18
1117,2023/02/19,3,0,1,0,4
1118,2023/02/19,8,0,1,0,9
1119,2023/02/19,9,0,1,0,10
1692,2023/02/19,6,0,5,0,11
1693,2023/02/19,12,6,4,0,16
1747,2023/02/19,26,25,16,0,42
1772,2023/02/19,5,0,0,0,5
1773,2023/02/19,6,6,3,0,9
1774,2023/02/19,8,0,1,0,9
1782,2023/02/19,27,15,24,3,51
1795,2023/02/19,8,0,4,0,12
1914,2023/02/19,7,0,0,0,7
1923,2023/02/19,7,6,2,0,9
1934,2023/02/19,6,5,1,0,7
1963,2023/02/19,14,6,7,4,21
1984,2023/02/19,4,0,0,0,4
2135,2023/02/19,9,0,5,0,14
2136,2023/02/19,10,0,0,0,10
2148,2023/02/19,1,0,2,0,3
2183,2023/02/19,2,0,1,0,3
2193,2023/02/19,18,12,11,5,29
2237,2023/02/19,8,0,1,0,9
2358,2023/02/19,20,12,3,0,23
2361,2023/02/19,9,7,1,0,10
2445,2023/02/19,7,6,2,0,9
2449,2023/02/19,6,6,6,0,12
2451,2023/02/19,61,60,23,0,84
2475,2023/02/19,12,0,1,0,13
2476,2023/02/19,12,0,2,0,14
2507,2023/02/19,37,6,5,2,42
2525,2023/02/19,9,0,6,0,15
2562,2023/02/19,8,0,6,0,14
2582,2023/02/19,9,0,4,0,13
2586,2023/02/19,43,20,12,0,55
2602,2023/02/19,2,0,0,0,2
2631,2023/02/19,6,0,2,0,8
2685,2023/02/19,31,16,3,3,34
2723,2023/02/19,11,0,2,0,13
2730,2023/02/19,13,6,5,0,18
2731,2023/02/19,5,6,4,0,9
2732,2023/02/19,13,0,1,0,14
2734,2023/02/19,6,4,3,0,9
2735,2023/02/19,3,0,4,0,7
2761,2023/02/19,46,20,12,0,58
2788,2023/02/19,28,12,18,5,46
2802,2023/02/19,11,0,3,0,14
2812,2023/02/19,12,0,5,0,17
2813,2023/02/19,12,0,3,0,15
2814,2023/02/19,4,0,1,0,5
2913,2023/02/19,3,0,1,0,4
2914,2023/02/19,9,0,3,0,12
3015,2023/02/19,11,0,3,0,14
3033,2023/02/19,8,0,1,0,9
3035,2023/02/19,3,0,1,0,4
4446,2023/02/19,18,9,5,1,23
12136,2023/02/19,21,24,17,0,38
12516,2023/02/19,11,0,1,0,12
12518,2023/02/19,6,4,2,0,8
12523,2023/02/19,18,8,10,0,28
16062,2023/02/19,3,0,1,0,4
16276,2023/02/19,4,4,2,0,6
19322,2023/02/19,12,0,1,0,13
19329,2023/02/19,13,0,1,0,14
19520,2023/02/19,12,8,2,0,14
20901,2023/02/19,8,0,0,0,8
21097,2023/02/19,4,0,1,0,5
21102,2023/02/19,14,10,0,0,14
21103,2023/02/19,9,0,3,0,12
21132,2023/02/19,23,18,12,5,35
21171,2023/02/19,14,4,5,0,19
21174,2023/02/19,20,12,8,0,28
21175,2023/02/19,17,12,10,0,27
21176,2023/02/19,12,0,1,5,13
75,2023/02/20,46,28,39,0,85
76,2023/02/20,64,52,52,4,116
99,2023/02/20,19,0,0,0,19
117,2023/02/20,4,0,3,0,7
118,2023/02/20,3,0,3,0,6
119,2023/02/20,4,0,1,0,5
120,2023/02/20,8,0,1,0,9
149,2023/02/20,13,0,6,0,19
184,2023/02/20,8,6,6,0,14
195,2023/02/20,36,36,29,0,65
218,2023/02/20,44,30,41,4,85
296,2023/02/20,9,8,7,0,16
300,2023/02/20,0,0,1,0,1
304,2023/02/20,6,4,5,0,11
317,2023/02/20,-1,6,5,0,4
343,2023/02/20,3,0,2,0,5
353,2023/02/20,9,0,0,0,9
373,2023/02/20,1,0,2,0,3
374,2023/02/20,8,0,5,0,13
388,2023/02/20,41,33,24,5,65
419,2023/02/20,6,0,0,0,6
420,2023/02/20,1,0,2,0,3
462,2023/02/20,15,8,14,0,29
519,2023/02/20,21,12,5,0,26
525,2023/02/20,2,0,0,0,2
596,2023/02/20,14,8,2,0,16
597,2023/02/20,17,12,10,1,27
598,2023/02/20,6,0,2,0,8
1035,2023/02/20,11,6,2,0,13
1084,2023/02/20,19,10,7,0,26
1111,2023/02/20,16,0,0,0,16
1112,2023/02/20,5,0,0,0,5
1113,2023/02/20,14,0,0,0,14
1114,2023/02/20,0,0,0,0,0
1115,2023/02/20,10,0,0,0,10
1117,2023/02/20,2,0,0,0,2
1118,2023/02/20,7,0,1,0,8
1119,2023/02/20,8,0,0,0,8
1692,2023/02/20,7,6,6,0,13
1693,2023/02/20,8,0,8,0,16
1747,2023/02/20,33,25,17,0,50
1772,2023/02/20,5,0,1,0,6
1773,2023/02/20,3,0,1,0,4
1774,2023/02/20,7,0,0,0,7
1782,2023/02/20,18,18,18,0,36
1795,2023/02/20,25,21,10,0,35
1914,2023/02/20,7,0,0,0,7
1923,2023/02/20,5,0,1,0,6
1934,2023/02/20,5,0,1,0,6
1963,2023/02/20,9,6,10,0,19
1984,2023/02/20,10,6,1,3,11
2135,2023/02/20,4,0,2,0,6
2136,2023/02/20,10,0,1,0,11
2148,2023/02/20,-1,0,1,0,0
2183,2023/02/20,7,6,1,0,8
2193,2023/02/20,26,24,35,0,61
2237,2023/02/20,7,0,0,0,7
2358,2023/02/20,17,0,5,0,22
2361,2023/02/20,15,7,3,0,18
2445,2023/02/20,11,6,2,0,13
2449,2023/02/20,6,6,6,0,12
2451,2023/02/20,38,0,11,0,49
2475,2023/02/20,11,0,0,0,11
2476,2023/02/20,10,0,0,0,10
2507,2023/02/20,36,6,8,3,44
2525,2023/02/20,3,0,0,0,3
2562,2023/02/20,8,6,9,0,17
2582,2023/02/20,5,0,4,0,9
2586,2023/02/20,43,12,14,1,57
2602,2023/02/20,2,0,0,0,2
2631,2023/02/20,4,0,0,0,4
2685,2023/02/20,29,4,4,1,33
2723,2023/02/20,17,8,1,0,18
2730,2023/02/20,8,0,3,0,11
2731,2023/02/20,1,0,2,0,3
2732,2023/02/20,12,0,0,0,12
2734,2023/02/20,3,0,4,0,7
2735,2023/02/20,3,4,3,0,6
2761,2023/02/20,44,10,22,0,66
2788,2023/02/20,24,20,21,0,45
2802,2023/02/20,8,0,0,0,8
2812,2023/02/20,7,0,0,0,7
2813,2023/02/20,9,0,4,0,13
2814,2023/02/20,3,0,1,0,4
2913,2023/02/20,2,0,1,0,3
2914,2023/02/20,12,6,0,0,12
3015,2023/02/20,8,0,2,0,10
3033,2023/02/20,7,0,0,0,7
3035,2023/02/20,2,0,1,0,3
4446,2023/02/20,24,12,7,0,31
12136,2023/02/20,34,30,29,2,63
12516,2023/02/20,10,0,8,0,18
12518,2023/02/20,4,0,2,0,6
12523,2023/02/20,8,0,5,0,13
16062,2023/02/20,2,0,0,0,2
16276,2023/02/20,2,0,1,0,3
19322,2023/02/20,11,0,0,0,11
19329,2023/02/20,12,0,0,0,12
19520,2023/02/20,10,0,3,0,13
19521,2023/02/20,0,0,1,0,1
20901,2023/02/20,14,6,0,0,14
21097,2023/02/20,3,0,0,0,3
21102,2023/02/20,14,0,0,0,14
21103,2023/02/20,6,0,0,0,6
21132,2023/02/20,27,21,24,2,51
21171,2023/02/20,9,0,1,0,10
21174,2023/02/20,24,12,12,0,36
21175,2023/02/20,23,16,7,0,30
21176,2023/02/20,6,0,2,4,8
75,2023/02/21,51,44,49,1,100
76,2023/02/21,68,60,65,6,133
99,2023/02/21,19,0,0,0,19
117,2023/02/21,1,0,1,0,2
118,2023/02/21,0,0,0,0,0
119,2023/02/21,3,0,3,0,6
120,2023/02/21,11,4,4,0,15
149,2023/02/21,7,0,0,0,7
184,2023/02/21,14,12,13,0,27
195,2023/02/21,49,42,37,1,86
218,2023/02/21,39,39,33,1,72
296,2023/02/21,6,4,2,0,8
300,2023/02/21,3,4,4,0,7
304,2023/02/21,5,4,1,0,6
317,2023/02/21,0,6,6,0,6
343,2023/02/21,1,0,0,0,1
353,2023/02/21,9,0,1,0,10
373,2023/02/21,-1,0,0,0,-1
374,2023/02/21,3,0,0,0,3
388,2023/02/21,33,21,25,13,58
419,2023/02/21,12,6,7,0,19
420,2023/02/21,5,6,3,0,8
462,2023/02/21,9,8,5,0,14
519,2023/02/21,22,6,8,0,30
525,2023/02/21,7,5,0,2,7
596,2023/02/21,12,0,8,0,20
597,2023/02/21,18,12,13,0,31
598,2023/02/21,10,6,2,0,12
1035,2023/02/21,15,6,3,0,18
1084,2023/02/21,23,10,12,0,35
1111,2023/02/21,16,0,1,0,17
1112,2023/02/21,11,6,0,0,11
1113,2023/02/21,14,0,0,0,14
1114,2023/02/21,6,6,1,0,7
1115,2023/02/21,10,0,1,0,11
1117,2023/02/21,2,0,1,0,3
1118,2023/02/21,12,6,2,0,14
1119,2023/02/21,8,0,1,0,9
1692,2023/02/21,1,0,0,0,1
1693,2023/02/21,0,0,0,0,0
1747,2023/02/21,41,25,23,0,64
1772,2023/02/21,12,8,1,0,13
1773,2023/02/21,2,0,2,0,4
1774,2023/02/21,7,0,4,0,11
1782,2023/02/21,27,27,16,0,43
1795,2023/02/21,29,14,23,0,52
1914,2023/02/21,7,0,2,0,9
1923,2023/02/21,10,6,1,0,11
1934,2023/02/21,9,5,6,0,15
1963,2023/02/21,5,6,6,0,11
1984,2023/02/21,6,0,0,0,6
2135,2023/02/21,8,6,0,0,8
2136,2023/02/21,9,0,0,0,9
2148,2023/02/21,2,4,2,0,4
2183,2023/02/21,12,6,0,0,12
2193,2023/02/21,15,24,23,0,38
2237,2023/02/21,13,6,3,0,16
2358,2023/02/21,12,0,6,0,18
2361,2023/02/21,19,7,5,0,24
2445,2023/02/21,15,6,10,0,25
2449,2023/02/21,0,0,0,0,0
2451,2023/02/21,27,0,13,0,40
2475,2023/02/21,11,0,0,0,11
2476,2023/02/21,10,0,1,0,11
2507,2023/02/21,25,0,7,0,32
2525,2023/02/21,9,6,0,0,9
2562,2023/02/21,-1,0,0,0,-1
2582,2023/02/21,5,4,2,0,7
2586,2023/02/21,40,12,23,2,63
2602,2023/02/21,10,8,2,0,12
2631,2023/02/21,10,6,1,1,11
2685,2023/02/21,24,0,2,8,26
2723,2023/02/21,16,0,1,0,17
2730,2023/02/21,5,0,2,0,7
2731,2023/02/21,5,6,1,0,6
2732,2023/02/21,12,0,1,0,13
2734,2023/02/21,3,4,1,0,4
2735,2023/02/21,4,4,3,0,7
2761,2023/02/21,32,10,17,1,49
2788,2023/02/21,23,20,18,1,41
2802,2023/02/21,8,0,1,0,9
2812,2023/02/21,7,0,0,0,7
2813,2023/02/21,5,0,1,0,6
2814,2023/02/21,8,6,0,0,8
2913,2023/02/21,1,0,0,0,1
2914,2023/02/21,12,0,0,0,12
3015,2023/02/21,14,8,2,0,16
3033,2023/02/21,7,0,0,0,7
3035,2023/02/21,7,6,0,0,7
4446,2023/02/21,30,12,9,0,39
12136,2023/02/21,39,36,32,6,71
12516,2023/02/21,6,4,1,1,7
12518,2023/02/21,6,4,2,0,8
12523,2023/02/21,7,4,4,0,11
16062,2023/02/21,8,6,1,0,9
16276,2023/02/21,5,4,0,0,5
19322,2023/02/21,11,0,0,0,11
19329,2023/02/21,12,0,0,0,12
19520,2023/02/21,7,0,0,0,7
19521,2023/02/21,7,8,1,0,8
20901,2023/02/21,14,0,1,0,15
20920,2023/02/21,12,12,1,0,13
21102,2023/02/21,14,0,0,0,14
21103,2023/02/21,6,0,0,0,6
21132,2023/02/21,16,15,17,2,33
21171,2023/02/21,8,0,1,5,9
21174,2023/02/21,24,12,12,1,36
21175,2023/02/21,28,12,2,7,30
21176,2023/02/21,4,4,4,0,8
75,2023/02/22,41,80,48,0,89
76,2023/02/22,33,36,49,0,82
99,2023/02/22,19,0,0,0,19
117,2023/02/22,0,8,0,0,0
118,2023/02/22,8,8,8,0,16
119,2023/02/22,4,4,1,0,5
120,2023/02/22,11,4,0,0,11
149,2023/02/22,7,0,0,0,7
184,2023/02/22,13,24,12,0,25
195,2023/02/22,41,60,49,0,90
218,2023/02/22,37,33,39,0,76
296,2023/02/22,12,16,1,0,13
300,2023/02/22,-1,8,0,0,-1
304,2023/02/22,8,8,2,0,10
317,2023/02/22,6,18,5,0,11
343,2023/02/22,9,8,0,0,9
353,2023/02/22,8,0,2,0,10
373,2023/02/22,5,12,6,0,11
374,2023/02/22,7,8,2,0,9
388,2023/02/22,22,57,29,0,51
419,2023/02/22,11,6,11,0,22
420,2023/02/22,2,0,3,0,5
462,2023/02/22,12,16,5,0,17
519,2023/02/22,20,6,5,0,25
525,2023/02/22,5,0,0,0,5
596,2023/02/22,8,8,5,0,13
597,2023/02/22,17,30,17,0,34
598,2023/02/22,8,0,1,0,9
1035,2023/02/22,12,0,8,0,20
1084,2023/02/22,15,20,11,0,26
1111,2023/02/22,15,0,1,0,16
1112,2023/02/22,11,0,0,0,11
1113,2023/02/22,14,0,0,0,14
1114,2023/02/22,11,6,5,0,16
1115,2023/02/22,9,0,2,0,11
1117,2023/02/22,1,0,0,0,1
1118,2023/02/22,10,0,0,0,10
1119,2023/02/22,7,0,0,0,7
1692,2023/02/22,1,6,0,0,1
1693,2023/02/22,0,0,0,0,0
1747,2023/02/22,48,50,26,0,74
1772,2023/02/22,11,0,1,0,12
1773,2023/02/22,6,6,0,0,6
1774,2023/02/22,3,0,0,0,3
1782,2023/02/22,29,18,23,0,52
1795,2023/02/22,6,14,6,0,12
1914,2023/02/22,5,0,0,0,5
1923,2023/02/22,9,0,2,0,11
1934,2023/02/22,3,0,1,0,4
1963,2023/02/22,5,6,5,0,10
1984,2023/02/22,6,6,1,0,7
2135,2023/02/22,14,6,1,0,15
2136,2023/02/22,9,0,0,0,9
2148,2023/02/22,0,4,1,0,1
2183,2023/02/22,12,6,3,0,15
2193,2023/02/22,13,21,24,0,37
2237,2023/02/22,10,0,1,0,11
2358,2023/02/22,10,4,4,0,14
2361,2023/02/22,14,0,5,0,19
2445,2023/02/22,5,0,2,0,7
2449,2023/02/22,6,6,2,0,8
2451,2023/02/22,14,25,12,0,26
2475,2023/02/22,11,0,0,0,11
2476,2023/02/22,9,0,0,0,9
2507,2023/02/22,24,12,16,5,40
2525,2023/02/22,15,6,1,0,16
2562,2023/02/22,-1,6,0,0,-1
2582,2023/02/22,3,4,2,0,5
2586,2023/02/22,27,12,23,2,50
2602,2023/02/22,8,0,2,0,10
2631,2023/02/22,8,6,5,0,13
2685,2023/02/22,14,0,6,7,20
2723,2023/02/22,15,0,1,0,16
2730,2023/02/22,9,6,0,0,9
2731,2023/02/22,10,6,0,0,10
2732,2023/02/22,11,0,0,0,11
2734,2023/02/22,6,8,4,0,10
2735,2023/02/22,5,8,2,0,7
2761,2023/02/22,24,25,19,1,43
2788,2023/02/22,16,40,21,2,37
2802,2023/02/22,7,0,0,0,7
2812,2023/02/22,13,6,3,0,16
2813,2023/02/22,4,6,0,0,4
2814,2023/02/22,8,0,0,0,8
2913,2023/02/22,7,6,3,0,10
2914,2023/02/22,12,0,1,0,13
3015,2023/02/22,11,0,3,1,14
3033,2023/02/22,7,0,1,0,8
3035,2023/02/22,7,0,1,0,8
4446,2023/02/22,32,12,16,3,48
12136,2023/02/22,34,63,38,0,72
12516,2023/02/22,4,0,3,0,7
12518,2023/02/22,8,8,2,0,10
12523,2023/02/22,3,4,2,0,5
16062,2023/02/22,7,0,0,0,7
16276,2023/02/22,5,4,0,0,5
19322,2023/02/22,10,0,0,1,10
19329,2023/02/22,12,0,0,0,12
19520,2023/02/22,7,0,0,0,7
19521,2023/02/22,14,8,1,0,15
20901,2023/02/22,13,0,0,0,13
20920,2023/02/22,23,12,1,0,24
21102,2023/02/22,14,0,1,0,15
21103,2023/02/22,16,10,4,0,20
21132,2023/02/22,9,36,9,0,18
21171,2023/02/22,2,0,2,0,4
21174,2023/02/22,23,12,16,2,39
21175,2023/02/22,31,12,12,5,43
21176,2023/02/22,8,8,8,0,16
75,2023/02/23,33,0,35,0,68
76,2023/02/23,16,32,36,0,52
99,2023/02/23,19,0,0,0,19
117,2023/02/23,8,0,1,0,9
118,2023/02/23,0,0,0,0,0
119,2023/02/23,3,0,3,0,6
120,2023/02/23,11,0,2,0,13
149,2023/02/23,7,0,0,0,7
184,2023/02/23,13,0,13,0,26
195,2023/02/23,22,0,34,0,56
218,2023/02/23,28,30,25,0,53
296,2023/02/23,19,0,6,0,25
300,2023/02/23,7,0,2,0,9
304,2023/02/23,10,0,3,0,13
317,2023/02/23,7,0,7,0,14
343,2023/02/23,9,0,2,0,11
353,2023/02/23,6,0,0,0,6
373,2023/02/23,5,0,6,0,11
374,2023/02/23,9,0,6,0,15
388,2023/02/23,23,0,27,0,50
419,2023/02/23,0,0,0,0,0
420,2023/02/23,-1,0,0,0,-1
462,2023/02/23,15,0,13,0,28
519,2023/02/23,15,0,4,0,19
525,2023/02/23,5,0,1,0,6
596,2023/02/23,7,0,4,0,11
597,2023/02/23,18,0,18,0,36
598,2023/02/23,7,0,4,0,11
1035,2023/02/23,4,0,2,0,6
1084,2023/02/23,19,0,11,0,30
1111,2023/02/23,14,0,0,0,14
1112,2023/02/23,11,0,0,0,11
1113,2023/02/23,14,0,0,0,14
1114,2023/02/23,6,0,4,0,10
1115,2023/02/23,7,0,0,0,7
1117,2023/02/23,1,0,0,0,1
1118,2023/02/23,10,0,2,0,12
1119,2023/02/23,7,0,1,0,8
1692,2023/02/23,7,0,6,0,13
1693,2023/02/23,0,0,0,0,0
1747,2023/02/23,42,0,35,0,77
1772,2023/02/23,10,0,0,0,10
1773,2023/02/23,6,0,0,0,6
1774,2023/02/23,3,0,1,0,4
1782,2023/02/23,36,30,35,0,71
1795,2023/02/23,14,0,12,0,26
1914,2023/02/23,5,0,1,0,6
1923,2023/02/23,7,0,0,0,7
1934,2023/02/23,2,0,2,0,4
1963,2023/02/23,0,0,0,0,0
1984,2023/02/23,11,0,1,0,12
2135,2023/02/23,13,0,1,0,14
2136,2023/02/23,9,0,0,0,9
2148,2023/02/23,3,0,4,0,7
2183,2023/02/23,15,0,2,0,17
2193,2023/02/23,16,27,20,0,36
2237,2023/02/23,9,0,1,0,10
2358,2023/02/23,6,0,1,0,7
2361,2023/02/23,9,0,1,0,10
2445,2023/02/23,9,6,6,0,15
2449,2023/02/23,4,0,5,0,9
2451,2023/02/23,27,0,22,0,49
2475,2023/02/23,11,0,0,0,11
2476,2023/02/23,9,0,0,0,9
2507,2023/02/23,9,0,9,0,18
2525,2023/02/23,14,0,0,0,14
2562,2023/02/23,5,0,3,0,8
2582,2023/02/23,6,0,3,0,9
2586,2023/02/23,2,0,1,0,3
2602,2023/02/23,6,0,1,0,7
2631,2023/02/23,9,0,4,0,13
2685,2023/02/23,1,0,0,0,1
2723,2023/02/23,14,0,1,0,15
2730,2023/02/23,9,0,2,0,11
2731,2023/02/23,10,0,2,0,12
2732,2023/02/23,11,0,0,0,11
2734,2023/02/23,6,0,3,0,9
2735,2023/02/23,7,0,2,0,9
2761,2023/02/23,19,0,19,0,38
2788,2023/02/23,21,0,21,0,42
2802,2023/02/23,7,0,2,0,9
2812,2023/02/23,10,0,1,0,11
2813,2023/02/23,10,0,3,0,13
2814,2023/02/23,8,0,1,0,9
2913,2023/02/23,4,0,3,0,7
2914,2023/02/23,11,0,0,0,11
3015,2023/02/23,7,0,5,1,12
3033,2023/02/23,6,0,0,0,6
3035,2023/02/23,6,0,1,0,7
4446,2023/02/23,13,0,7,0,20
12136,2023/02/23,26,0,32,0,58
12516,2023/02/23,1,0,1,0,2
12518,2023/02/23,10,0,8,0,18
12523,2023/02/23,5,0,4,0,9
16062,2023/02/23,7,0,0,0,7
16276,2023/02/23,9,0,2,0,11
19322,2023/02/23,10,0,0,0,10
19329,2023/02/23,12,0,1,0,13
19520,2023/02/23,7,0,1,0,8
19521,2023/02/23,13,0,5,0,18
20901,2023/02/23,13,0,1,0,14
20920,2023/02/23,22,0,0,0,22
21102,2023/02/23,13,0,0,0,13
21103,2023/02/23,12,0,0,0,12
21132,2023/02/23,24,0,28,0,52
21171,2023/02/23,0,0,0,0,0
21174,2023/02/23,5,0,2,0,7
21175,2023/02/23,14,0,15,0,29
21176,2023/02/23,4,4,4,0,8
75,2023/02/24,30,40,38,0,68
76,2023/02/24,36,56,54,0,90
99,2023/02/24,19,0,0,0,19
117,2023/02/24,7,0,4,0,11
118,2023/02/24,8,8,2,0,10
119,2023/02/24,4,4,4,0,8
120,2023/02/24,9,0,4,0,13
149,2023/02/24,13,6,0,0,13
184,2023/02/24,16,15,20,0,36
195,2023/02/24,29,36,40,0,69
218,2023/02/24,42,39,49,0,91
296,2023/02/24,17,4,2,0,19
300,2023/02/24,9,4,2,0,11
304,2023/02/24,11,4,2,0,13
317,2023/02/24,6,6,4,0,10
343,2023/02/24,15,8,2,0,17
353,2023/02/24,6,0,0,0,6
373,2023/02/24,-1,0,0,0,-1
374,2023/02/24,7,4,2,0,9
388,2023/02/24,36,30,34,0,70
419,2023/02/24,6,6,5,0,11
420,2023/02/24,5,6,3,0,8
462,2023/02/24,10,8,7,0,17
519,2023/02/24,23,12,11,0,34
525,2023/02/24,4,0,3,0,7
596,2023/02/24,13,12,6,0,19
597,2023/02/24,35,30,30,0,65
598,2023/02/24,3,0,2,0,5
1035,2023/02/24,8,6,6,0,14
1084,2023/02/24,31,20,24,0,55
1111,2023/02/24,14,0,3,0,17
1112,2023/02/24,11,0,3,0,14
1113,2023/02/24,14,0,3,0,17
1114,2023/02/24,2,0,2,0,4
1115,2023/02/24,13,6,3,0,16
1117,2023/02/24,1,0,0,0,1
1118,2023/02/24,8,0,1,0,9
1119,2023/02/24,6,0,1,0,7
1692,2023/02/24,7,6,5,0,12
1693,2023/02/24,6,6,2,0,8
1747,2023/02/24,39,20,25,0,64
1772,2023/02/24,10,0,0,0,10
1773,2023/02/24,12,6,4,0,16
1774,2023/02/24,10,8,1,0,11
1782,2023/02/24,24,30,37,0,61
1795,2023/02/24,15,14,12,0,27
1914,2023/02/24,10,6,1,0,11
1923,2023/02/24,7,0,2,0,9
1934,2023/02/24,6,5,1,0,7
1963,2023/02/24,12,12,4,0,16
1984,2023/02/24,16,6,6,2,22
2135,2023/02/24,12,0,3,0,15
2136,2023/02/24,9,0,2,0,11
2148,2023/02/24,3,4,3,0,6
2183,2023/02/24,19,6,7,0,26
2193,2023/02/24,17,15,23,0,40
2237,2023/02/24,8,0,2,0,10
2358,2023/02/24,9,4,3,0,12
2361,2023/02/24,8,7,6,0,14
2445,2023/02/24,9,6,7,0,16
2449,2023/02/24,5,6,5,0,10
2451,2023/02/24,31,25,19,0,50
2475,2023/02/24,11,0,0,0,11
2476,2023/02/24,9,0,2,0,11
2507,2023/02/24,11,12,11,0,22
2525,2023/02/24,14,0,3,0,17
2562,2023/02/24,8,6,3,0,11
2582,2023/02/24,6,4,1,0,7
2586,2023/02/24,1,0,5,0,6
2602,2023/02/24,5,0,0,0,5
2631,2023/02/24,11,6,5,0,16
2685,2023/02/24,1,0,0,0,1
2723,2023/02/24,13,0,1,0,14
2730,2023/02/24,7,0,2,0,9
2731,2023/02/24,8,0,3,0,11
2732,2023/02/24,11,0,4,0,15
2734,2023/02/24,7,4,6,0,13
2735,2023/02/24,13,8,2,0,15
2761,2023/02/24,30,25,30,0,60
2788,2023/02/24,33,28,24,0,57
2802,2023/02/24,5,0,0,0,5
2812,2023/02/24,9,0,3,0,12
2813,2023/02/24,7,0,3,0,10
2814,2023/02/24,7,0,1,0,8
2913,2023/02/24,1,0,1,0,2
2914,2023/02/24,11,0,1,0,12
3015,2023/02/24,2,0,1,0,3
3033,2023/02/24,6,0,0,0,6
3035,2023/02/24,5,0,0,0,5
4446,2023/02/24,13,12,13,0,26
12136,2023/02/24,38,30,38,0,76
12516,2023/02/24,4,4,1,0,5
12518,2023/02/24,6,4,2,0,8
12523,2023/02/24,9,8,2,0,11
16062,2023/02/24,7,0,1,0,8
16276,2023/02/24,7,0,1,0,8
19322,2023/02/24,10,0,5,0,15
19329,2023/02/24,11,0,1,0,12
19520,2023/02/24,14,8,2,0,16
19521,2023/02/24,8,0,1,0,9
20901,2023/02/24,12,0,2,0,14
20920,2023/02/24,22,0,0,0,22
21102,2023/02/24,13,0,2,0,15
21103,2023/02/24,12,0,1,0,13
21132,2023/02/24,23,18,19,0,42
21171,2023/02/24,4,4,3,0,7
21174,2023/02/24,14,16,17,0,31
21175,2023/02/24,6,4,5,0,11
21176,2023/02/24,8,8,9,0,17
75,2023/02/25,36,44,54,0,90
76,2023/02/25,18,36,21,0,39
99,2023/02/25,19,0,2,0,21
117,2023/02/25,11,8,5,0,16
118,2023/02/25,6,0,6,0,12
119,2023/02/25,0,0,0,0,0
120,2023/02/25,5,0,1,0,6
149,2023/02/25,13,0,0,0,13
184,2023/02/25,8,12,8,0,16
195,2023/02/25,19,30,22,0,41
218,2023/02/25,23,30,30,0,53
296,2023/02/25,23,8,5,0,28
300,2023/02/25,11,4,3,0,14
304,2023/02/25,13,4,3,0,16
317,2023/02/25,14,12,3,0,17
343,2023/02/25,13,0,1,0,14
353,2023/02/25,6,0,1,0,7
373,2023/02/25,-1,0,0,0,-1
374,2023/02/25,9,4,2,0,11
388,2023/02/25,23,21,13,0,36
419,2023/02/25,1,0,1,0,2
420,2023/02/25,2,0,1,0,3
462,2023/02/25,11,8,5,0,16
519,2023/02/25,24,12,13,0,37
525,2023/02/25,6,5,4,0,10
596,2023/02/25,7,0,6,0,13
597,2023/02/25,5,0,2,0,7
598,2023/02/25,7,6,0,0,7
1035,2023/02/25,8,6,6,0,14
1084,2023/02/25,7,0,4,0,11
1111,2023/02/25,11,0,0,0,11
1112,2023/02/25,8,0,1,0,9
1113,2023/02/25,11,0,2,0,13
1114,2023/02/25,6,6,6,0,12
1115,2023/02/25,10,0,4,0,14
1117,2023/02/25,1,0,0,0,1
1118,2023/02/25,7,0,0,0,7
1119,2023/02/25,5,0,1,0,6
1692,2023/02/25,8,6,1,0,9
1693,2023/02/25,4,0,4,0,8
1747,2023/02/25,39,25,24,0,63
1772,2023/02/25,10,0,2,0,12
1773,2023/02/25,8,0,3,0,11
1774,2023/02/25,9,0,0,0,9
1782,2023/02/25,5,18,14,0,19
1795,2023/02/25,24,21,21,1,45
1914,2023/02/25,9,0,3,0,12
1923,2023/02/25,5,0,1,0,6
1934,2023/02/25,5,0,3,0,8
1963,2023/02/25,14,6,5,0,19
1984,2023/02/25,8,0,2,0,10
2135,2023/02/25,15,6,4,0,19
2136,2023/02/25,7,0,1,0,8
2148,2023/02/25,4,4,3,0,7
2183,2023/02/25,18,6,8,0,26
2193,2023/02/25,9,15,11,0,20
2237,2023/02/25,12,6,3,0,15
2358,2023/02/25,10,4,3,0,13
2361,2023/02/25,9,7,9,0,18
2445,2023/02/25,14,12,6,0,20
2449,2023/02/25,6,6,4,0,10
2451,2023/02/25,27,15,10,0,37
2475,2023/02/25,11,0,0,0,11
2476,2023/02/25,7,0,0,0,7
2507,2023/02/25,11,12,10,0,21
2525,2023/02/25,11,0,4,0,15
2562,2023/02/25,11,6,5,0,16
2582,2023/02/25,5,0,0,0,5
2586,2023/02/25,16,20,16,0,32
2602,2023/02/25,13,8,0,0,13
2631,2023/02/25,12,6,5,0,17
2685,2023/02/25,5,4,4,0,9
2723,2023/02/25,12,0,0,0,12
2730,2023/02/25,11,6,6,0,17
2731,2023/02/25,5,0,2,0,7
2732,2023/02/25,7,0,1,0,8
2734,2023/02/25,1,0,1,0,2
2735,2023/02/25,15,4,5,0,20
2761,2023/02/25,19,20,10,0,29
2788,2023/02/25,29,20,30,0,59
2802,2023/02/25,5,0,1,0,6
2812,2023/02/25,6,0,0,0,6
2813,2023/02/25,4,0,1,0,5
2814,2023/02/25,6,0,1,0,7
2913,2023/02/25,6,6,1,0,7
2914,2023/02/25,10,0,3,0,13
3015,2023/02/25,1,0,1,0,2
3033,2023/02/25,6,0,0,0,6
3035,2023/02/25,5,0,1,0,6
4446,2023/02/25,9,9,7,0,16
12136,2023/02/25,27,27,23,0,50
12516,2023/02/25,7,4,0,0,7
12518,2023/02/25,4,0,2,0,6
12523,2023/02/25,15,8,5,0,20
16062,2023/02/25,6,0,0,0,6
16276,2023/02/25,10,4,0,0,10
19322,2023/02/25,5,0,1,0,6
19329,2023/02/25,10,0,3,0,13
19520,2023/02/25,12,0,0,0,12
19521,2023/02/25,7,0,1,0,8
20901,2023/02/25,10,0,1,0,11
20920,2023/02/25,22,0,1,0,23
21097,2023/02/25,9,0,0,0,9
21102,2023/02/25,11,0,0,0,11
21103,2023/02/25,11,0,0,0,11
21132,2023/02/25,19,15,8,0,27
21171,2023/02/25,5,4,5,0,10
21174,2023/02/25,9,12,9,0,18
21175,2023/02/25,9,8,7,0,16
21176,2023/02/25,3,4,3,0,6
75,2023/02/26,22,40,35,0,57
76,2023/02/26,41,44,47,0,88
99,2023/02/26,17,0,0,0,17
117,2023/02/26,6,0,0,0,6
118,2023/02/26,8,8,0,0,8
119,2023/02/26,4,4,2,0,6
120,2023/02/26,4,0,0,0,4
149,2023/02/26,13,0,1,0,14
184,2023/02/26,12,12,8,0,20
195,2023/02/26,30,33,39,0,69
218,2023/02/26,18,24,15,0,33
296,2023/02/26,18,0,5,0,23
300,2023/02/26,12,4,2,0,14
304,2023/02/26,14,4,8,0,22
317,2023/02/26,17,6,11,0,28
343,2023/02/26,12,0,6,0,18
353,2023/02/26,5,0,0,0,5
373,2023/02/26,5,6,2,1,7
374,2023/02/26,15,8,10,0,25
388,2023/02/26,22,12,12,1,34
419,2023/02/26,6,6,4,0,10
420,2023/02/26,7,6,2,0,9
462,2023/02/26,14,8,14,0,28
519,2023/02/26,23,12,14,1,37
525,2023/02/26,2,0,0,0,2
596,2023/02/26,9,8,7,1,16
597,2023/02/26,15,12,10,0,25
598,2023/02/26,7,0,3,0,10
1035,2023/02/26,8,6,4,0,12
1084,2023/02/26,13,10,7,0,20
1112,2023/02/26,7,0,1,0,8
1113,2023/02/26,9,0,1,0,10
1114,2023/02/26,6,6,4,0,10
1115,2023/02/26,6,0,4,0,10
1117,2023/02/26,1,0,1,0,2
1118,2023/02/26,13,6,5,0,18
1119,2023/02/26,4,0,0,0,4
1692,2023/02/26,7,0,5,0,12
1693,2023/02/26,6,6,0,0,6
1747,2023/02/26,25,10,9,0,34
1772,2023/02/26,8,0,2,0,10
1773,2023/02/26,5,0,0,0,5
1774,2023/02/26,9,0,1,0,10
1782,2023/02/26,12,21,22,0,34
1795,2023/02/26,2,0,2,0,4
1914,2023/02/26,6,0,1,0,7
1923,2023/02/26,4,0,0,0,4
1934,2023/02/26,7,5,2,0,9
1963,2023/02/26,15,6,12,0,27
1984,2023/02/26,12,6,3,0,15
2135,2023/02/26,11,0,2,0,13
2136,2023/02/26,6,0,0,0,6
2148,2023/02/26,5,4,3,0,8
2183,2023/02/26,10,0,5,2,15
2193,2023/02/26,13,15,14,0,27
2237,2023/02/26,9,0,4,0,13
2358,2023/02/26,15,8,2,0,17
2361,2023/02/26,9,7,6,0,15
2445,2023/02/26,14,6,3,0,17
2449,2023/02/26,8,6,3,0,11
2451,2023/02/26,72,55,32,1,104
2475,2023/02/26,11,0,0,0,11
2476,2023/02/26,7,0,0,0,7
2507,2023/02/26,7,6,6,0,13
2525,2023/02/26,7,0,2,0,9
2562,2023/02/26,12,6,1,0,13
2582,2023/02/26,13,8,4,0,17
2586,2023/02/26,16,16,27,0,43
2602,2023/02/26,13,0,3,0,16
2631,2023/02/26,13,6,4,0,17
2685,2023/02/26,5,4,4,0,9
2723,2023/02/26,12,0,2,0,14
2730,2023/02/26,5,0,1,0,6
2731,2023/02/26,9,6,2,0,11
2732,2023/02/26,6,0,0,0,6
2734,2023/02/26,8,8,1,0,9
2735,2023/02/26,14,4,4,0,18
2761,2023/02/26,20,10,10,0,30
2788,2023/02/26,16,16,6,0,22
2802,2023/02/26,10,6,0,0,10
2812,2023/02/26,6,0,3,0,9
2813,2023/02/26,9,6,1,0,10
2814,2023/02/26,5,0,2,0,7
2913,2023/02/26,5,0,2,0,7
2914,2023/02/26,7,0,1,0,8
3015,2023/02/26,8,8,3,0,11
3033,2023/02/26,6,0,2,0,8
3035,2023/02/26,4,0,0,0,4
4446,2023/02/26,14,12,12,0,26
12136,2023/02/26,35,30,29,0,64
12516,2023/02/26,7,0,1,0,8
12518,2023/02/26,6,4,2,0,8
12523,2023/02/26,26,16,6,0,32
16062,2023/02/26,6,0,2,0,8
16276,2023/02/26,10,0,3,0,13
19322,2023/02/26,4,0,1,0,5
19329,2023/02/26,7,0,1,0,8
19520,2023/02/26,12,0,0,0,12
19521,2023/02/26,14,8,1,0,15
20901,2023/02/26,9,0,0,0,9
20920,2023/02/26,21,0,1,0,22
21097,2023/02/26,9,0,0,0,9
21102,2023/02/26,11,0,1,0,12
21103,2023/02/26,11,0,1,0,12
21132,2023/02/26,23,12,13,0,36
21171,2023/02/26,0,0,0,0,0
21174,2023/02/26,12,12,14,0,26
21175,2023/02/26,14,12,10,0,24
21176,2023/02/26,8,8,5,0,13
75,2023/02/27,23,36,28,0,51
76,2023/02/27,50,112,57,0,107
99,2023/02/27,17,0,0,0,17
117,2023/02/27,6,0,4,0,10
118,2023/02/27,8,8,0,0,8
119,2023/02/27,2,4,2,0,4
120,2023/02/27,4,4,0,0,4
149,2023/02/27,12,0,0,0,12
184,2023/02/27,16,12,8,0,24
195,2023/02/27,21,69,25,0,46
218,2023/02/27,38,36,39,0,77
296,2023/02/27,17,4,4,0,21
300,2023/02/27,14,8,3,0,17
304,2023/02/27,10,4,4,0,14
317,2023/02/27,12,6,6,0,18
343,2023/02/27,6,0,5,5,11
353,2023/02/27,5,0,0,0,5
373,2023/02/27,8,12,2,0,10
374,2023/02/27,5,8,2,0,7
388,2023/02/27,33,57,24,0,57
419,2023/02/27,8,12,5,0,13
420,2023/02/27,5,6,4,0,9
462,2023/02/27,16,24,12,0,28
519,2023/02/27,8,0,6,0,14
525,2023/02/27,2,0,0,0,2
596,2023/02/27,5,12,3,0,8
597,2023/02/27,17,30,6,0,23
598,2023/02/27,10,6,3,0,13
1035,2023/02/27,4,6,1,0,5
1084,2023/02/27,16,25,12,0,28
1111,2023/02/27,11,0,0,0,11
1112,2023/02/27,6,0,1,0,7
1113,2023/02/27,14,6,0,0,14
1114,2023/02/27,8,12,1,0,9
1115,2023/02/27,8,12,2,0,10
1117,2023/02/27,0,0,0,0,0
1118,2023/02/27,8,0,3,0,11
1119,2023/02/27,4,6,0,0,4
1692,2023/02/27,8,12,6,0,14
1693,2023/02/27,12,6,4,0,16
1747,2023/02/27,41,50,23,0,64
1772,2023/02/27,6,0,2,0,8
1773,2023/02/27,11,12,0,0,11
1774,2023/02/27,8,0,1,0,9
1782,2023/02/27,14,24,23,0,37
1795,2023/02/27,21,42,19,0,40
1914,2023/02/27,5,6,1,0,6
1923,2023/02/27,10,6,2,0,12
1934,2023/02/27,5,5,4,0,9
1963,2023/02/27,15,18,9,0,24
1984,2023/02/27,9,0,4,2,13
2135,2023/02/27,9,6,1,0,10
2136,2023/02/27,6,6,2,0,8
2148,2023/02/27,2,4,2,0,4
2183,2023/02/27,3,6,2,0,5
2193,2023/02/27,23,24,23,0,46
2237,2023/02/27,5,6,0,0,5
2358,2023/02/27,13,4,3,0,16
2361,2023/02/27,1,7,2,0,3
2445,2023/02/27,17,6,2,0,19
2449,2023/02/27,11,12,8,0,19
2451,2023/02/27,39,0,18,1,57
2475,2023/02/27,11,0,1,0,12
2476,2023/02/27,13,6,2,0,15
2507,2023/02/27,13,24,12,0,25
2525,2023/02/27,11,12,0,0,11
2562,2023/02/27,17,6,7,0,24
2582,2023/02/27,9,4,2,0,11
2586,2023/02/27,5,16,21,1,26
2602,2023/02/27,10,0,4,0,14
2631,2023/02/27,9,0,4,0,13
2685,2023/02/27,9,8,7,0,16
2723,2023/02/27,10,0,1,0,11
2730,2023/02/27,10,12,2,0,12
2731,2023/02/27,13,6,2,0,15
2732,2023/02/27,6,8,0,0,6
2734,2023/02/27,7,4,6,0,13
2735,2023/02/27,10,0,2,0,12
2761,2023/02/27,20,30,10,0,30
2788,2023/02/27,29,40,22,0,51
2802,2023/02/27,10,0,1,0,11
2812,2023/02/27,9,6,1,0,10
2813,2023/02/27,8,6,4,0,12
2814,2023/02/27,3,6,1,0,4
2913,2023/02/27,9,6,3,0,12
2914,2023/02/27,6,6,1,0,7
3015,2023/02/27,5,8,1,0,6
3033,2023/02/27,4,0,0,0,4
3035,2023/02/27,4,6,0,0,4
4446,2023/02/27,11,21,8,0,19
12136,2023/02/27,35,63,31,0,66
12516,2023/02/27,6,0,2,0,8
12518,2023/02/27,8,8,5,0,13
12523,2023/02/27,20,0,4,0,24
16062,2023/02/27,4,6,3,0,7
16276,2023/02/27,7,0,3,0,10
19322,2023/02/27,9,6,2,0,11
19329,2023/02/27,6,0,1,0,7
19520,2023/02/27,12,0,1,0,13
19521,2023/02/27,13,0,4,0,17
20901,2023/02/27,9,0,0,0,9
20920,2023/02/27,20,0,0,0,20
21097,2023/02/27,9,0,0,0,9
21102,2023/02/27,10,0,1,0,11
21103,2023/02/27,10,0,2,0,12
21132,2023/02/27,34,24,23,0,57
21171,2023/02/27,4,8,3,0,7
21174,2023/02/27,10,24,10,0,20
21175,2023/02/27,16,20,12,0,28
21176,2023/02/27,7,4,1,0,8
75,2023/02/28,43,100,51,0,94
76,2023/02/28,49,48,49,0,98
99,2023/02/28,17,0,0,0,17
117,2023/02/28,2,4,1,1,3
118,2023/02/28,16,4,2,0,18
119,2023/02/28,4,4,0,0,4
120,2023/02/28,8,0,1,0,9
149,2023/02/28,12,0,0,0,12
184,2023/02/28,20,12,9,0,29
195,2023/02/28,34,36,34,0,68
218,2023/02/28,29,30,28,0,57
296,2023/02/28,13,4,3,0,16
300,2023/02/28,15,4,2,0,17
304,2023/02/28,6,0,1,0,7
317,2023/02/28,6,6,4,0,10
343,2023/02/28,-3,0,2,0,-1
353,2023/02/28,5,0,0,0,5
373,2023/02/28,12,6,2,0,14
374,2023/02/28,11,0,4,0,15
388,2023/02/28,42,27,25,0,67
419,2023/02/28,9,6,6,0,15
420,2023/02/28,7,0,3,0,10
462,2023/02/28,12,8,3,0,15
519,2023/02/28,2,6,10,0,12
525,2023/02/28,2,5,1,0,3
596,2023/02/28,10,8,3,0,13
597,2023/02/28,29,0,14,0,43
598,2023/02/28,7,0,5,0,12
1035,2023/02/28,9,6,3,0,12
1084,2023/02/28,19,10,13,0,32
1111,2023/02/28,11,0,0,0,11
1112,2023/02/28,5,6,0,0,5
1113,2023/02/28,14,0,0,0,14
1114,2023/02/28,13,6,5,0,18
1115,2023/02/28,12,0,7,0,19
1118,2023/02/28,5,6,0,0,5
1119,2023/02/28,10,0,1,0,11
1692,2023/02/28,8,6,3,0,11
1693,2023/02/28,8,6,2,0,10
1747,2023/02/28,43,0,22,0,65
1772,2023/02/28,4,8,0,0,4
1773,2023/02/28,17,0,0,0,17
1774,2023/02/28,7,0,0,0,7
1782,2023/02/28,21,54,30,0,51
1795,2023/02/28,23,0,21,0,44
1914,2023/02/28,10,0,0,0,10
1923,2023/02/28,8,0,1,0,9
1934,2023/02/28,6,0,4,0,10
1963,2023/02/28,12,0,3,0,15
1984,2023/02/28,3,0,1,1,4
2135,2023/02/28,14,0,0,0,14
2136,2023/02/28,10,0,2,0,12
2148,2023/02/28,4,0,1,0,5
2183,2023/02/28,7,6,2,0,9
2193,2023/02/28,24,24,19,0,43
2237,2023/02/28,11,0,0,0,11
2358,2023/02/28,14,0,3,0,17
2361,2023/02/28,6,0,4,0,10
2445,2023/02/28,15,0,4,0,19
2449,2023/02/28,9,0,0,0,9
2451,2023/02/28,20,0,13,0,33
2475,2023/02/28,10,0,0,0,10
2476,2023/02/28,11,0,1,0,12
2507,2023/02/28,13,18,5,0,18
2525,2023/02/28,17,0,0,0,17
2562,2023/02/28,10,6,0,0,10
2582,2023/02/28,11,0,4,0,15
2586,2023/02/28,7,24,12,0,19
2602,2023/02/28,6,0,1,0,7
2631,2023/02/28,5,0,2,0,7
2685,2023/02/28,6,4,6,0,12
2723,2023/02/28,9,0,2,0,11
2730,2023/02/28,14,0,0,0,14
2731,2023/02/28,11,0,0,0,11
2732,2023/02/28,14,0,1,0,15
2734,2023/02/28,5,0,4,0,9
2735,2023/02/28,8,4,1,0,9
2761,2023/02/28,30,25,16,0,46
2788,2023/02/28,27,0,19,0,46
2802,2023/02/28,9,0,0,0,9
2812,2023/02/28,8,6,0,0,8
2813,2023/02/28,10,0,3,0,13
2814,2023/02/28,8,0,4,0,12
2913,2023/02/28,6,0,2,0,8
2914,2023/02/28,11,0,0,0,11
3015,2023/02/28,12,0,3,0,15
3033,2023/02/28,4,6,0,0,4
3035,2023/02/28,10,0,0,0,10
4446,2023/02/28,15,0,15,0,30
12136,2023/02/28,37,0,23,0,60
12516,2023/02/28,8,4,2,0,10
12518,2023/02/28,7,4,1,0,8
12523,2023/02/28,20,4,4,0,24
16062,2023/02/28,7,0,0,0,7
16276,2023/02/28,4,0,0,0,4
19322,2023/02/28,7,0,2,0,9
19329,2023/02/28,5,0,1,0,6
19520,2023/02/28,11,0,1,0,12
19521,2023/02/28,9,0,2,0,11
20901,2023/02/28,9,0,0,0,9
20920,2023/02/28,20,0,0,0,20
21102,2023/02/28,9,0,0,0,9
21103,2023/02/28,8,0,0,0,8
21132,2023/02/28,29,18,19,0,48
21171,2023/02/28,5,0,0,0,5
21174,2023/02/28,12,0,13,0,25
21175,2023/02/28,12,0,6,0,18
21176,2023/02/28,14,8,6,3,20
75,2023/03/01,44,12,52,0,96
76,2023/03/01,47,40,49,0,96
99,2023/03/01,17,0,1,0,18
117,2023/03/01,4,0,3,0,7
118,2023/03/01,18,0,8,0,26
119,2023/03/01,8,4,4,0,12
120,2023/03/01,7,4,2,0,9
149,2023/03/01,12,0,0,0,12
184,2023/03/01,26,27,11,0,37
195,2023/03/01,35,36,34,0,69
218,2023/03/01,38,72,39,0,77
296,2023/03/01,14,0,10,0,24
300,2023/03/01,17,0,6,0,23
304,2023/03/01,5,8,3,0,8
317,2023/03/01,8,6,8,0,16
343,2023/03/01,-6,4,1,0,-5
353,2023/03/01,5,0,2,0,7
373,2023/03/01,16,0,2,0,18
374,2023/03/01,7,4,0,0,7
388,2023/03/01,42,27,28,4,70
419,2023/03/01,9,0,6,0,15
420,2023/03/01,4,6,2,0,6
462,2023/03/01,17,8,9,0,26
519,2023/03/01,-2,12,4,0,2
525,2023/03/01,6,0,0,0,6
596,2023/03/01,15,8,4,0,19
597,2023/03/01,33,42,15,0,48
598,2023/03/01,2,0,2,0,4
1035,2023/03/01,12,6,9,0,21
1084,2023/03/01,16,0,13,0,29
1111,2023/03/01,11,0,0,0,11
1112,2023/03/01,11,0,0,0,11
1113,2023/03/01,14,0,1,0,15
1114,2023/03/01,14,0,7,0,21
1115,2023/03/01,5,0,1,0,6
1118,2023/03/01,11,6,0,0,11
1119,2023/03/01,9,0,1,0,10
1692,2023/03/01,11,0,3,0,14
1693,2023/03/01,12,0,4,0,16
1747,2023/03/01,46,40,24,0,70
1772,2023/03/01,12,0,1,0,13
1773,2023/03/01,17,0,0,0,17
1774,2023/03/01,7,0,0,0,7
1782,2023/03/01,15,30,24,0,39
1795,2023/03/01,9,7,8,0,17
1914,2023/03/01,10,0,0,0,10
1923,2023/03/01,7,6,1,0,8
1934,2023/03/01,2,5,1,0,3
1963,2023/03/01,15,6,7,0,22
1984,2023/03/01,1,6,0,0,1
2135,2023/03/01,14,0,3,0,17
2136,2023/03/01,8,0,3,0,11
2148,2023/03/01,7,4,3,0,10
2183,2023/03/01,11,0,5,1,16
2193,2023/03/01,26,24,21,0,47
2237,2023/03/01,11,0,2,0,13
2358,2023/03/01,11,0,1,4,12
2361,2023/03/01,9,7,2,0,11
2445,2023/03/01,17,6,8,6,25
2449,2023/03/01,9,6,7,0,16
2451,2023/03/01,7,25,0,0,7
2475,2023/03/01,10,0,0,0,10
2476,2023/03/01,10,0,1,0,11
2507,2023/03/01,26,12,21,0,47
2525,2023/03/01,17,0,0,0,17
2562,2023/03/01,16,0,7,0,23
2582,2023/03/01,7,4,0,0,7
2586,2023/03/01,17,48,17,1,34
2602,2023/03/01,5,8,0,0,5
2631,2023/03/01,9,6,1,0,10
2685,2023/03/01,4,12,6,0,10
2723,2023/03/01,7,0,0,0,7
2730,2023/03/01,14,0,3,0,17
2731,2023/03/01,11,0,0,0,11
2732,2023/03/01,13,0,2,0,15
2734,2023/03/01,1,4,2,0,3
2735,2023/03/01,11,0,4,0,15
2761,2023/03/01,39,20,21,0,60
2788,2023/03/01,31,48,17,0,48
2802,2023/03/01,9,0,1,0,10
2812,2023/03/01,14,0,1,0,15
2813,2023/03/01,7,0,0,0,7
2814,2023/03/01,4,0,1,0,5
2913,2023/03/01,4,0,1,0,5
2914,2023/03/01,11,0,0,0,11
3015,2023/03/01,9,0,6,0,15
3033,2023/03/01,10,0,0,0,10
3035,2023/03/01,10,0,0,0,10
4446,2023/03/01,18,24,9,0,27
12136,2023/03/01,43,30,35,0,78
12516,2023/03/01,10,4,3,0,13
12518,2023/03/01,10,0,5,0,15
12523,2023/03/01,16,0,3,0,19
16062,2023/03/01,7,6,5,0,12
16276,2023/03/01,4,0,0,1,4
19322,2023/03/01,5,6,0,0,5
19329,2023/03/01,4,0,0,0,4
19520,2023/03/01,10,0,1,0,11
19521,2023/03/01,7,8,2,0,9
20901,2023/03/01,9,0,1,0,10
20920,2023/03/01,20,0,0,0,20
21102,2023/03/01,9,0,0,0,9
21103,2023/03/01,8,0,0,0,8
21132,2023/03/01,30,21,24,0,54
21171,2023/03/01,5,0,1,0,6
21174,2023/03/01,15,16,15,0,30
21175,2023/03/01,18,12,13,0,31
21176,2023/03/01,13,8,3,1,16
75,2023/03/02,33,24,33,0,66
76,2023/03/02,40,0,40,0,80
99,2023/03/02,16,0,0,0,16
117,2023/03/02,1,0,1,0,2
118,2023/03/02,10,0,2,0,12
119,2023/03/02,8,0,3,0,11
120,2023/03/02,9,0,2,0,11
149,2023/03/02,12,0,1,0,13
184,2023/03/02,19,0,16,0,35
195,2023/03/02,35,0,40,0,75
218,2023/03/02,31,0,37,0,68
296,2023/03/02,4,0,2,0,6
300,2023/03/02,11,0,3,0,14
304,2023/03/02,10,0,3,0,13
317,2023/03/02,7,0,4,0,11
343,2023/03/02,-3,0,1,0,-2
353,2023/03/02,3,0,0,0,3
373,2023/03/02,20,6,2,0,22
374,2023/03/02,11,0,8,0,19
388,2023/03/02,30,0,29,0,59
419,2023/03/02,9,6,4,0,13
420,2023/03/02,8,0,2,0,10
462,2023/03/02,16,0,8,0,24
519,2023/03/02,6,0,3,0,9
525,2023/03/02,6,0,2,0,8
596,2023/03/02,18,0,7,0,25
597,2023/03/02,39,0,19,0,58
598,2023/03/02,0,0,0,0,0
1035,2023/03/02,9,0,1,0,10
1084,2023/03/02,9,10,9,0,18
1111,2023/03/02,11,0,0,0,11
1112,2023/03/02,11,0,2,0,13
1113,2023/03/02,13,0,0,0,13
1114,2023/03/02,7,0,4,0,11
1115,2023/03/02,4,0,0,0,4
1118,2023/03/02,17,0,1,0,18
1119,2023/03/02,8,0,0,0,8
1692,2023/03/02,8,0,3,0,11
1693,2023/03/02,8,0,2,0,10
1747,2023/03/02,26,0,23,0,49
1772,2023/03/02,11,0,1,0,12
1773,2023/03/02,17,0,3,0,20
1774,2023/03/02,7,0,1,0,8
1782,2023/03/02,28,0,29,0,57
1795,2023/03/02,14,14,16,0,30
1914,2023/03/02,10,0,2,0,12
1923,2023/03/02,12,0,2,0,14
1934,2023/03/02,5,0,2,0,7
1963,2023/03/02,8,0,2,0,10
1984,2023/03/02,7,0,3,0,10
2135,2023/03/02,11,0,0,0,11
2136,2023/03/02,5,0,1,0,6
2148,2023/03/02,4,0,4,0,8
2183,2023/03/02,5,0,3,0,8
2193,2023/03/02,33,24,27,3,60
2237,2023/03/02,9,0,3,0,12
2358,2023/03/02,10,4,2,0,12
2361,2023/03/02,13,7,8,0,21
2445,2023/03/02,3,0,2,0,5
2449,2023/03/02,8,0,0,0,8
2451,2023/03/02,25,0,16,0,41
2475,2023/03/02,10,0,0,0,10
2476,2023/03/02,9,0,0,0,9
2507,2023/03/02,16,0,13,0,29
2525,2023/03/02,17,0,0,0,17
2562,2023/03/02,9,0,1,0,10
2582,2023/03/02,11,0,2,0,13
2586,2023/03/02,41,0,30,0,71
2602,2023/03/02,13,0,1,0,14
2631,2023/03/02,14,6,2,0,16
2685,2023/03/02,5,0,5,0,10
2723,2023/03/02,7,0,2,0,9
2730,2023/03/02,11,0,0,0,11
2731,2023/03/02,11,0,3,0,14
2732,2023/03/02,11,0,2,0,13
2734,2023/03/02,3,0,4,0,7
2735,2023/03/02,7,0,3,0,10
2761,2023/03/02,30,0,25,0,55
2788,2023/03/02,32,0,31,1,63
2802,2023/03/02,8,0,0,0,8
2812,2023/03/02,13,0,2,0,15
2813,2023/03/02,7,0,3,0,10
2814,2023/03/02,3,0,0,0,3
2913,2023/03/02,3,0,0,7,3
2914,2023/03/02,11,0,2,0,13
3015,2023/03/02,3,0,4,0,7
3033,2023/03/02,10,0,0,0,10
3035,2023/03/02,10,0,0,0,10
4446,2023/03/02,12,0,14,0,26
12136,2023/03/02,32,33,30,0,62
12516,2023/03/02,7,0,1,0,8
12518,2023/03/02,5,0,5,0,10
12523,2023/03/02,13,0,5,0,18
16062,2023/03/02,8,0,1,0,9
16276,2023/03/02,3,0,1,0,4
19322,2023/03/02,11,0,1,0,12
19329,2023/03/02,4,0,0,0,4
19520,2023/03/02,9,0,3,0,12
19521,2023/03/02,13,0,1,0,14
20901,2023/03/02,8,0,0,0,8
20920,2023/03/02,20,0,1,0,21
21102,2023/03/02,9,0,0,0,9
21103,2023/03/02,8,0,0,0,8
21132,2023/03/02,8,21,20,0,28
21171,2023/03/02,8,4,3,0,11
21174,2023/03/02,12,12,12,0,24
21175,2023/03/02,8,8,9,0,17
21176,2023/03/02,1,8,13,2,14
75,2023/03/03,40,40,40,0,80
76,2023/03/03,55,56,52,0,107
99,2023/03/03,16,0,0,0,16
117,2023/03/03,4,4,4,0,8
118,2023/03/03,8,0,0,0,8
119,2023/03/03,9,4,0,0,9
120,2023/03/03,7,0,3,0,10
149,2023/03/03,11,0,0,0,11
184,2023/03/03,24,21,19,0,43
195,2023/03/03,33,39,32,0,65
218,2023/03/03,31,36,30,0,61
296,2023/03/03,6,4,3,0,9
300,2023/03/03,8,0,0,0,8
304,2023/03/03,7,0,3,0,10
317,2023/03/03,8,6,5,0,13
343,2023/03/03,0,4,2,0,2
353,2023/03/03,3,0,0,0,3
373,2023/03/03,18,0,5,0,23
374,2023/03/03,7,4,0,0,7
388,2023/03/03,31,30,28,0,59
419,2023/03/03,5,0,4,0,9
420,2023/03/03,6,0,4,0,10
462,2023/03/03,16,8,8,0,24
519,2023/03/03,15,12,14,0,29
525,2023/03/03,4,0,1,0,5
596,2023/03/03,23,12,4,0,27
597,2023/03/03,56,36,32,0,88
598,2023/03/03,6,6,1,0,7
1035,2023/03/03,14,6,7,0,21
1084,2023/03/03,30,30,11,0,41
1111,2023/03/03,11,0,0,0,11
1112,2023/03/03,9,0,2,0,11
1113,2023/03/03,13,0,1,0,14
1114,2023/03/03,3,0,4,0,7
1115,2023/03/03,10,6,2,0,12
1117,2023/03/03,8,8,0,0,8
1118,2023/03/03,16,0,2,0,18
1119,2023/03/03,8,0,3,0,11
1692,2023/03/03,11,6,8,0,19
1693,2023/03/03,6,0,5,0,11
1747,2023/03/03,27,25,23,0,50
1772,2023/03/03,10,0,0,0,10
1773,2023/03/03,14,0,0,0,14
1774,2023/03/03,6,0,0,0,6
1782,2023/03/03,32,33,31,0,63
1795,2023/03/03,12,14,12,0,24
1914,2023/03/03,8,0,0,0,8
1915,2023/03/03,6,6,1,0,7
1923,2023/03/03,10,0,1,0,11
1934,2023/03/03,3,0,3,0,6
1963,2023/03/03,12,6,7,0,19
1984,2023/03/03,10,6,6,0,16
2135,2023/03/03,11,0,3,0,14
2136,2023/03/03,4,0,1,0,5
2148,2023/03/03,4,4,2,0,6
2183,2023/03/03,8,6,8,0,16
2193,2023/03/03,26,24,19,0,45
2237,2023/03/03,6,0,1,0,7
2358,2023/03/03,12,4,3,0,15
2361,2023/03/03,12,7,8,0,20
2445,2023/03/03,7,6,6,0,13
2449,2023/03/03,14,6,5,0,19
2451,2023/03/03,34,25,21,0,55
2475,2023/03/03,10,0,3,0,13
2476,2023/03/03,9,0,0,0,9
2507,2023/03/03,15,12,12,0,27
2525,2023/03/03,17,0,2,0,19
2562,2023/03/03,14,6,1,0,15
2582,2023/03/03,9,0,1,0,10
2586,2023/03/03,35,24,26,0,61
2602,2023/03/03,12,0,1,0,13
2631,2023/03/03,18,6,4,0,22
2685,2023/03/03,8,8,8,0,16
2723,2023/03/03,5,0,2,0,7
2730,2023/03/03,11,0,1,0,12
2731,2023/03/03,8,0,0,0,8
2732,2023/03/03,9,0,2,0,11
2734,2023/03/03,3,4,4,0,7
2735,2023/03/03,8,4,3,0,11
2761,2023/03/03,35,30,22,0,57
2788,2023/03/03,24,24,18,0,42
2802,2023/03/03,8,0,1,0,9
2812,2023/03/03,11,0,0,0,11
2813,2023/03/03,10,6,2,0,12
2814,2023/03/03,9,6,2,0,11
2913,2023/03/03,2,6,4,0,6
2914,2023/03/03,9,0,0,0,9
3015,2023/03/03,7,8,0,0,7
3033,2023/03/03,10,0,0,0,10
3035,2023/03/03,10,0,1,0,11
4446,2023/03/03,10,12,12,0,22
12136,2023/03/03,38,36,40,0,78
12516,2023/03/03,6,0,4,0,10
12518,2023/03/03,4,4,2,1,6
12523,2023/03/03,12,4,3,0,15
16062,2023/03/03,7,0,0,0,7
16276,2023/03/03,2,0,1,0,3
19322,2023/03/03,10,0,0,0,10
19329,2023/03/03,4,0,1,0,5
19520,2023/03/03,6,0,2,0,8
19521,2023/03/03,12,0,0,0,12
20920,2023/03/03,19,0,0,0,19
21102,2023/03/03,9,0,0,0,9
21103,2023/03/03,8,0,0,0,8
21132,2023/03/03,12,24,18,0,30
21171,2023/03/03,9,4,1,1,10
21174,2023/03/03,20,20,17,0,37
21175,2023/03/03,11,12,11,0,22
21176,2023/03/03,-5,8,9,2,4
75,2023/03/04,52,52,54,0,106
76,2023/03/04,39,36,37,0,76
99,2023/03/04,16,0,0,0,16
117,2023/03/04,0,0,0,0,0
118,2023/03/04,8,0,0,0,8
119,2023/03/04,9,0,0,2,9
120,2023/03/04,4,0,0,0,4
149,2023/03/04,11,0,2,0,13
184,2023/03/04,14,9,10,0,24
195,2023/03/04,28,27,28,0,56
218,2023/03/04,30,30,29,0,59
296,2023/03/04,7,4,3,0,10
300,2023/03/04,8,0,1,0,9
304,2023/03/04,8,4,2,0,10
317,2023/03/04,9,6,2,0,11
343,2023/03/04,-2,0,1,0,-1
353,2023/03/04,9,6,1,0,10
373,2023/03/04,19,6,5,0,24
374,2023/03/04,7,0,4,0,11
388,2023/03/04,15,12,11,0,26
419,2023/03/04,7,6,5,0,12
420,2023/03/04,8,6,2,0,10
462,2023/03/04,16,8,7,0,23
519,2023/03/04,13,12,14,0,27
525,2023/03/04,8,5,0,0,8
596,2023/03/04,19,0,2,3,21
597,2023/03/04,24,0,10,0,34
598,2023/03/04,5,0,1,0,6
1035,2023/03/04,13,6,2,0,15
1084,2023/03/04,19,0,9,0,28
1111,2023/03/04,11,0,0,0,11
1112,2023/03/04,7,0,0,0,7
1113,2023/03/04,12,0,2,0,14
1114,2023/03/04,11,12,9,0,20
1115,2023/03/04,14,6,7,0,21
1117,2023/03/04,16,8,0,0,16
1118,2023/03/04,14,0,2,0,16
1119,2023/03/04,5,0,1,0,6
1692,2023/03/04,3,0,2,0,5
1693,2023/03/04,1,0,0,0,1
1747,2023/03/04,29,25,25,0,54
1772,2023/03/04,10,0,1,0,11
1773,2023/03/04,14,0,2,0,16
1774,2023/03/04,14,8,2,0,16
1782,2023/03/04,16,15,15,0,31
1795,2023/03/04,28,28,19,0,47
1914,2023/03/04,8,0,1,0,9
1915,2023/03/04,11,6,5,0,16
1923,2023/03/04,9,0,0,0,9
1934,2023/03/04,5,5,3,0,8
1963,2023/03/04,11,6,6,0,17
1984,2023/03/04,4,0,2,0,6
2135,2023/03/04,14,6,3,0,17
2136,2023/03/04,9,6,1,0,10
2148,2023/03/04,6,4,2,0,8
2183,2023/03/04,6,6,8,0,14
2193,2023/03/04,22,15,19,1,41
2237,2023/03/04,11,6,3,0,14
2358,2023/03/04,9,0,2,0,11
2361,2023/03/04,11,7,6,0,17
2445,2023/03/04,1,0,0,0,1
2449,2023/03/04,9,0,3,0,12
2451,2023/03/04,28,15,9,0,37
2475,2023/03/04,7,0,0,0,7
2476,2023/03/04,9,0,4,0,13
2507,2023/03/04,15,12,11,0,26
2525,2023/03/04,15,0,1,0,16
2562,2023/03/04,13,0,1,0,14
2582,2023/03/04,12,4,4,0,16
2586,2023/03/04,25,16,15,0,40
2602,2023/03/04,11,0,0,0,11
2631,2023/03/04,20,6,10,0,30
2685,2023/03/04,4,4,3,0,7
2723,2023/03/04,3,0,0,0,3
2730,2023/03/04,16,6,3,0,19
2731,2023/03/04,8,0,0,0,8
2732,2023/03/04,7,0,4,0,11
2734,2023/03/04,3,4,3,0,6
2735,2023/03/04,9,4,5,0,14
2761,2023/03/04,13,0,11,0,24
2788,2023/03/04,38,32,24,3,62
2802,2023/03/04,7,0,0,0,7
2812,2023/03/04,11,0,1,0,12
2813,2023/03/04,8,0,1,0,9
2814,2023/03/04,7,0,2,0,9
2913,2023/03/04,-2,0,3,0,1
2914,2023/03/04,9,0,2,0,11
3015,2023/03/04,7,0,3,0,10
3033,2023/03/04,10,0,0,0,10
3035,2023/03/04,9,0,0,0,9
4446,2023/03/04,10,12,11,0,21
12136,2023/03/04,22,24,18,0,40
12516,2023/03/04,2,0,1,0,3
12518,2023/03/04,5,4,2,0,7
12523,2023/03/04,13,4,1,0,14
16062,2023/03/04,13,6,2,0,15
16276,2023/03/04,5,4,0,0,5
19322,2023/03/04,10,0,0,0,10
19329,2023/03/04,9,6,2,0,11
19520,2023/03/04,4,0,0,0,4
19521,2023/03/04,12,0,3,0,15
21097,2023/03/04,9,0,1,0,10
21102,2023/03/04,9,0,0,0,9
21103,2023/03/04,8,0,1,0,9
21132,2023/03/04,5,12,12,2,17
21171,2023/03/04,11,4,2,0,13
21174,2023/03/04,11,8,11,0,22
21175,2023/03/04,8,8,8,0,16
21176,2023/03/04,-9,8,7,0,-2
75,2023/03/05,30,32,26,0,56
76,2023/03/05,50,48,38,0,88
99,2023/03/05,16,0,0,0,16
117,2023/03/05,4,4,1,0,5
118,2023/03/05,4,4,2,0,6
119,2023/03/05,8,0,2,0,10
120,2023/03/05,4,0,0,0,4
149,2023/03/05,8,0,0,1,8
184,2023/03/05,7,3,6,1,13
195,2023/03/05,36,36,19,1,55
218,2023/03/05,28,27,28,0,56
296,2023/03/05,13,8,6,0,19
300,2023/03/05,12,4,8,0,20
304,2023/03/05,14,8,4,0,18
317,2023/03/05,19,12,20,0,39
343,2023/03/05,10,4,4,0,14
353,2023/03/05,8,0,0,0,8
373,2023/03/05,14,0,8,0,22
374,2023/03/05,8,8,3,0,11
388,2023/03/05,16,12,8,0,24
419,2023/03/05,8,6,9,0,17
420,2023/03/05,6,0,6,0,12
462,2023/03/05,29,16,14,0,43
519,2023/03/05,11,12,7,0,18
525,2023/03/05,8,0,1,0,9
596,2023/03/05,22,8,4,0,26
597,2023/03/05,26,12,20,0,46
598,2023/03/05,13,6,4,0,17
1035,2023/03/05,17,6,8,0,25
1084,2023/03/05,20,10,11,0,31
1112,2023/03/05,7,0,0,0,7
1113,2023/03/05,10,0,3,0,13
1114,2023/03/05,14,12,6,0,20
1115,2023/03/05,7,0,5,0,12
1117,2023/03/05,16,0,0,0,16
1118,2023/03/05,12,0,0,0,12
1119,2023/03/05,4,0,0,0,4
1692,2023/03/05,7,6,7,0,14
1693,2023/03/05,7,6,3,0,10
1747,2023/03/05,29,25,15,0,44
1772,2023/03/05,9,0,2,0,11
1773,2023/03/05,12,0,0,0,12
1774,2023/03/05,12,0,2,0,14
1782,2023/03/05,19,18,17,0,36
1795,2023/03/05,9,0,10,0,19
1914,2023/03/05,13,6,1,0,14
1915,2023/03/05,6,0,0,0,6
1923,2023/03/05,9,0,0,0,9
1934,2023/03/05,2,0,0,0,2
1963,2023/03/05,17,12,16,0,33
1984,2023/03/05,8,6,2,0,10
2135,2023/03/05,11,0,5,0,16
2136,2023/03/05,8,0,2,0,10
2148,2023/03/05,6,8,2,0,8
2183,2023/03/05,4,6,4,0,8
2193,2023/03/05,14,12,5,0,19
2237,2023/03/05,14,6,4,0,18
2358,2023/03/05,16,8,11,0,27
2361,2023/03/05,5,0,5,0,10
2445,2023/03/05,7,6,6,0,13
2449,2023/03/05,12,6,12,0,24
2451,2023/03/05,79,60,8,0,87
2475,2023/03/05,7,0,0,0,7
2476,2023/03/05,5,0,0,0,5
2507,2023/03/05,16,12,5,0,21
2525,2023/03/05,14,0,1,0,15
2562,2023/03/05,18,6,3,0,21
2582,2023/03/05,17,0,5,0,22
2586,2023/03/05,26,16,9,5,35
2602,2023/03/05,11,0,0,0,11
2631,2023/03/05,10,0,5,0,15
2685,2023/03/05,5,4,2,0,7
2723,2023/03/05,11,8,0,0,11
2730,2023/03/05,13,0,1,0,14
2731,2023/03/05,14,6,3,0,17
2732,2023/03/05,3,0,1,0,4
2734,2023/03/05,5,4,3,0,8
2735,2023/03/05,9,4,4,0,13
2761,2023/03/05,12,10,12,0,24
2788,2023/03/05,19,8,5,6,24
2802,2023/03/05,7,0,1,0,8
2812,2023/03/05,10,0,1,0,11
2813,2023/03/05,7,0,0,0,7
2814,2023/03/05,5,0,4,0,9
2913,2023/03/05,-3,0,0,0,-3
2914,2023/03/05,7,0,0,0,7
3015,2023/03/05,12,8,2,0,14
3033,2023/03/05,10,0,0,0,10
3035,2023/03/05,9,0,0,0,9
4446,2023/03/05,11,12,5,0,16
12136,2023/03/05,28,24,15,0,43
12516,2023/03/05,5,4,3,1,8
12518,2023/03/05,7,4,4,0,11
12523,2023/03/05,20,8,10,0,30
16062,2023/03/05,11,0,1,0,12
16276,2023/03/05,5,0,2,0,7
19322,2023/03/05,10,0,0,0,10
19329,2023/03/05,7,0,1,0,8
19520,2023/03/05,12,8,2,0,14
19521,2023/03/05,9,0,0,0,9
21097,2023/03/05,8,0,0,0,8
21102,2023/03/05,9,0,0,0,9
21103,2023/03/05,7,0,0,0,7
21132,2023/03/05,3,12,10,0,13
21171,2023/03/05,13,4,1,0,14
21174,2023/03/05,12,12,7,0,19
21175,2023/03/05,12,12,6,0,18
21176,2023/03/05,-3,4,2,0,-1
75,2023/03/06,36,32,41,0,77
76,2023/03/06,64,52,56,2,120
99,2023/03/06,16,0,0,0,16
117,2023/03/06,7,4,3,0,10
118,2023/03/06,6,4,5,0,11
119,2023/03/06,10,4,0,0,10
120,2023/03/06,8,4,0,0,8
149,2023/03/06,8,0,0,0,8
184,2023/03/06,12,12,9,3,21
195,2023/03/06,48,33,28,8,76
218,2023/03/06,39,39,33,0,72
296,2023/03/06,15,8,5,0,20
300,2023/03/06,8,4,2,33,10
304,2023/03/06,14,4,2,0,16
317,2023/03/06,5,6,11,0,16
343,2023/03/06,10,4,2,0,12
353,2023/03/06,8,0,0,0,8
373,2023/03/06,6,0,7,0,13
374,2023/03/06,5,0,5,0,10
388,2023/03/06,41,33,20,2,61
419,2023/03/06,5,6,6,0,11
420,2023/03/06,0,0,0,0,0
462,2023/03/06,23,8,6,0,29
519,2023/03/06,10,6,3,0,13
525,2023/03/06,7,0,2,0,9
596,2023/03/06,18,0,5,3,23
597,2023/03/06,6,0,3,0,9
598,2023/03/06,9,0,3,0,12
1035,2023/03/06,9,0,3,0,12
1084,2023/03/06,19,10,10,0,29
1111,2023/03/06,11,0,2,0,13
1112,2023/03/06,13,6,1,0,14
1113,2023/03/06,7,0,2,0,9
1114,2023/03/06,8,0,4,0,12
1115,2023/03/06,2,0,1,0,3
1117,2023/03/06,16,0,0,0,16
1118,2023/03/06,12,0,1,0,13
1119,2023/03/06,10,6,0,0,10
1692,2023/03/06,6,6,6,0,12
1693,2023/03/06,4,0,3,0,7
1747,2023/03/06,34,20,17,0,51
1772,2023/03/06,7,0,0,0,7
1773,2023/03/06,12,0,2,0,14
1774,2023/03/06,10,0,0,0,10
1782,2023/03/06,29,27,27,0,56
1795,2023/03/06,20,21,11,0,31
1914,2023/03/06,12,0,0,0,12
1915,2023/03/06,6,0,1,0,7
1923,2023/03/06,9,0,0,0,9
1934,2023/03/06,7,5,4,0,11
1963,2023/03/06,7,6,7,0,14
1984,2023/03/06,12,6,1,0,13
2135,2023/03/06,6,0,2,0,8
2136,2023/03/06,6,0,2,0,8
2148,2023/03/06,4,0,2,0,6
2183,2023/03/06,6,6,3,0,9
2193,2023/03/06,33,24,15,3,48
2237,2023/03/06,10,0,3,0,13
2358,2023/03/06,5,0,1,0,6
2361,2023/03/06,7,7,3,0,10
2445,2023/03/06,7,6,4,0,11
2449,2023/03/06,6,6,6,0,12
2451,2023/03/06,71,0,17,0,88
2475,2023/03/06,13,6,1,0,14
2476,2023/03/06,5,0,0,0,5
2507,2023/03/06,23,12,13,0,36
2525,2023/03/06,13,0,0,0,13
2562,2023/03/06,15,0,8,5,23
2582,2023/03/06,12,0,5,0,17
2586,2023/03/06,36,24,14,4,50
2602,2023/03/06,11,0,0,0,11
2631,2023/03/06,5,0,1,4,6
2685,2023/03/06,11,8,8,0,19
2723,2023/03/06,19,8,2,0,21
2730,2023/03/06,12,0,2,0,14
2731,2023/03/06,11,0,0,0,11
2732,2023/03/06,10,8,2,0,12
2734,2023/03/06,2,0,2,0,4
2735,2023/03/06,5,0,1,1,6
2761,2023/03/06,20,20,27,0,47
2788,2023/03/06,32,24,16,4,48
2802,2023/03/06,6,0,1,0,7
2812,2023/03/06,9,0,0,0,9
2813,2023/03/06,13,6,1,0,14
2814,2023/03/06,1,0,0,0,1
2913,2023/03/06,3,6,3,0,6
2914,2023/03/06,7,0,1,0,8
3015,2023/03/06,10,0,1,0,11
3033,2023/03/06,10,0,1,0,11
3035,2023/03/06,9,0,0,0,9
4446,2023/03/06,18,12,15,0,33
12136,2023/03/06,46,33,31,0,77
12516,2023/03/06,1,0,1,0,2
12518,2023/03/06,7,4,6,0,13
12523,2023/03/06,10,0,6,0,16
16062,2023/03/06,10,0,0,0,10
16276,2023/03/06,3,0,0,0,3
19322,2023/03/06,10,0,1,0,11
19329,2023/03/06,6,0,2,0,8
19520,2023/03/06,10,0,0,0,10
19521,2023/03/06,9,0,1,0,10
20920,2023/03/06,19,0,0,0,19
21102,2023/03/06,9,0,0,0,9
21103,2023/03/06,7,0,1,0,8
21132,2023/03/06,17,24,13,0,30
21171,2023/03/06,12,0,2,2,14
21174,2023/03/06,17,12,17,0,34
21175,2023/03/06,18,12,3,0,21
21176,2023/03/06,-1,4,4,0,3
75,2023/03/07,43,48,33,0,76
76,2023/03/07,58,52,43,3,101
99,2023/03/07,16,0,0,0,16
117,2023/03/07,8,4,1,0,9
118,2023/03/07,1,0,0,0,1
119,2023/03/07,10,0,1,2,11
120,2023/03/07,8,0,2,0,10
149,2023/03/07,8,0,0,0,8
184,2023/03/07,15,15,3,0,18
195,2023/03/07,49,36,37,3,86
218,2023/03/07,42,36,47,2,89
296,2023/03/07,14,4,5,0,19
300,2023/03/07,-27,0,3,0,-24
304,2023/03/07,16,4,2,0,18
317,2023/03/07,-6,0,0,0,-6
343,2023/03/07,12,4,0,0,12
353,2023/03/07,8,0,0,0,8
373,2023/03/07,-1,0,0,0,-1
374,2023/03/07,4,4,3,0,7
388,2023/03/07,46,27,23,9,69
419,2023/03/07,5,6,7,0,12
420,2023/03/07,6,6,4,0,10
462,2023/03/07,25,8,9,1,34
519,2023/03/07,19,12,2,0,21
525,2023/03/07,5,0,1,1,6
596,2023/03/07,10,0,4,5,14
597,2023/03/07,21,18,9,0,30
598,2023/03/07,6,0,3,0,9
1035,2023/03/07,12,6,3,2,15
1084,2023/03/07,19,10,9,0,28
1111,2023/03/07,9,0,0,0,9
1112,2023/03/07,12,0,0,0,12
1113,2023/03/07,5,0,1,0,6
1114,2023/03/07,10,6,3,0,13
1115,2023/03/07,7,6,3,0,10
1118,2023/03/07,17,6,1,0,18
1119,2023/03/07,10,0,0,0,10
1692,2023/03/07,6,6,5,0,11
1693,2023/03/07,7,6,2,0,9
1747,2023/03/07,37,20,14,0,51
1772,2023/03/07,7,0,0,0,7
1773,2023/03/07,10,0,0,0,10
1774,2023/03/07,10,0,1,0,11
1782,2023/03/07,32,30,24,0,56
1795,2023/03/07,30,21,12,0,42
1914,2023/03/07,12,0,0,0,12
1915,2023/03/07,11,6,0,0,11
1923,2023/03/07,9,0,0,0,9
1934,2023/03/07,8,5,3,0,11
1963,2023/03/07,6,6,6,0,12
1984,2023/03/07,11,0,0,0,11
2135,2023/03/07,4,0,2,0,6
2136,2023/03/07,10,6,0,0,10
2148,2023/03/07,6,4,2,0,8
2183,2023/03/07,3,0,3,0,6
2193,2023/03/07,33,18,30,7,63
2237,2023/03/07,7,0,0,0,7
2358,2023/03/07,8,4,5,0,13
2361,2023/03/07,4,0,1,0,5
2445,2023/03/07,9,6,5,0,14
2449,2023/03/07,6,6,6,0,12
2451,2023/03/07,54,0,12,0,66
2475,2023/03/07,12,0,0,0,12
2476,2023/03/07,11,6,1,0,12
2507,2023/03/07,22,12,4,0,26
2525,2023/03/07,13,0,1,0,14
2562,2023/03/07,2,0,3,0,5
2582,2023/03/07,11,4,3,0,14
2586,2023/03/07,30,12,15,1,45
2602,2023/03/07,11,0,1,0,12
2631,2023/03/07,0,0,0,0,0
2685,2023/03/07,11,8,5,0,16
2723,2023/03/07,17,0,0,0,17
2730,2023/03/07,10,0,1,0,11
2731,2023/03/07,11,0,2,0,13
2732,2023/03/07,8,0,1,0,9
2734,2023/03/07,4,4,1,0,5
2735,2023/03/07,7,4,1,0,8
2761,2023/03/07,13,20,9,0,22
2788,2023/03/07,28,16,20,8,48
2802,2023/03/07,5,0,0,0,5
2812,2023/03/07,9,0,1,0,10
2813,2023/03/07,12,0,0,0,12
2814,2023/03/07,7,6,1,0,8
2913,2023/03/07,0,0,1,0,1
2914,2023/03/07,6,0,0,0,6
3015,2023/03/07,9,0,3,0,12
3033,2023/03/07,9,0,1,0,10
3035,2023/03/07,9,0,0,0,9
4446,2023/03/07,18,15,16,0,34
12136,2023/03/07,48,33,31,3,79
12516,2023/03/07,4,4,0,0,4
12518,2023/03/07,5,4,3,0,8
12523,2023/03/07,8,4,1,0,9
16062,2023/03/07,10,0,0,0,10
16276,2023/03/07,7,4,1,1,8
19322,2023/03/07,9,0,0,0,9
19329,2023/03/07,4,0,0,0,4
19520,2023/03/07,10,0,0,0,10
19521,2023/03/07,16,8,2,0,18
20920,2023/03/07,19,0,0,0,19
21097,2023/03/07,8,0,0,0,8
21102,2023/03/07,9,0,2,0,11
21103,2023/03/07,6,0,0,0,6
21132,2023/03/07,28,24,29,8,57
21171,2023/03/07,12,4,4,3,16
21174,2023/03/07,16,16,13,0,29
21175,2023/03/07,23,8,14,6,37
21176,2023/03/07,3,8,3,1,6
75,2023/03/08,62,52,38,3,100
76,2023/03/08,60,48,47,0,107
99,2023/03/08,16,0,1,0,17
117,2023/03/08,7,0,5,0,12
118,2023/03/08,1,0,1,0,2
119,2023/03/08,7,0,6,0,13
120,2023/03/08,6,0,2,0,8
149,2023/03/08,8,0,0,0,8
184,2023/03/08,21,9,13,0,34
195,2023/03/08,42,33,42,0,84
218,2023/03/08,32,39,37,0,69
296,2023/03/08,13,4,10,0,23
300,2023/03/08,-26,4,4,0,-22
304,2023/03/08,14,0,11,0,25
317,2023/03/08,0,6,6,0,6
343,2023/03/08,12,0,7,0,19
353,2023/03/08,8,0,1,0,9
373,2023/03/08,-1,0,0,0,-1
374,2023/03/08,5,4,5,0,10
388,2023/03/08,41,27,28,1,69
419,2023/03/08,4,6,3,0,7
420,2023/03/08,2,0,4,0,6
462,2023/03/08,23,8,14,0,37
519,2023/03/08,23,6,3,0,26
525,2023/03/08,3,0,1,0,4
596,2023/03/08,1,0,1,0,2
597,2023/03/08,30,18,7,0,37
598,2023/03/08,9,6,1,0,10
1035,2023/03/08,7,0,1,0,8
1084,2023/03/08,20,10,7,0,27
1112,2023/03/08,12,0,0,0,12
1113,2023/03/08,10,6,5,0,15
1114,2023/03/08,13,6,2,0,15
1115,2023/03/08,10,6,2,0,12
1118,2023/03/08,16,0,1,0,17
1119,2023/03/08,10,0,0,0,10
1692,2023/03/08,1,0,2,0,3
1693,2023/03/08,5,0,6,0,11
1747,2023/03/08,48,25,18,6,66
1772,2023/03/08,7,0,2,0,9
1773,2023/03/08,10,0,3,0,13
1774,2023/03/08,9,0,2,0,11
1782,2023/03/08,32,24,19,1,51
1795,2023/03/08,32,14,5,0,37
1914,2023/03/08,12,0,0,0,12
1915,2023/03/08,11,0,1,0,12
1923,2023/03/08,9,0,0,0,9
1934,2023/03/08,5,0,4,0,9
1963,2023/03/08,0,0,0,0,0
1984,2023/03/08,11,0,6,0,17
2135,2023/03/08,8,6,1,0,9
2136,2023/03/08,10,0,1,0,11
2148,2023/03/08,4,0,2,0,6
2183,2023/03/08,6,6,6,0,12
2193,2023/03/08,20,24,14,0,34
2237,2023/03/08,7,0,0,0,7
2358,2023/03/08,3,0,2,0,5
2361,2023/03/08,10,7,5,0,15
2445,2023/03/08,9,6,5,0,14
2449,2023/03/08,0,0,0,0,0
2451,2023/03/08,42,0,15,1,57
2475,2023/03/08,12,0,0,0,12
2476,2023/03/08,10,0,0,0,10
2507,2023/03/08,36,18,10,0,46
2525,2023/03/08,12,0,2,0,14
2562,2023/03/08,5,6,6,0,11
2582,2023/03/08,12,4,2,0,14
2586,2023/03/08,34,20,12,3,46
2602,2023/03/08,10,0,0,0,10
2631,2023/03/08,6,6,5,0,11
2685,2023/03/08,10,4,4,0,14
2723,2023/03/08,17,0,1,0,18
2730,2023/03/08,9,0,1,0,10
2731,2023/03/08,9,0,1,0,10
2732,2023/03/08,7,0,0,0,7
2734,2023/03/08,7,4,4,0,11
2735,2023/03/08,10,4,6,0,16
2761,2023/03/08,24,20,9,0,33
2788,2023/03/08,20,20,18,0,38
2802,2023/03/08,5,0,0,0,5
2812,2023/03/08,8,0,0,0,8
2813,2023/03/08,12,0,1,0,13
2814,2023/03/08,12,6,3,0,15
2913,2023/03/08,5,6,2,0,7
2914,2023/03/08,6,0,0,0,6
3015,2023/03/08,6,0,4,0,10
3033,2023/03/08,8,0,0,0,8
3035,2023/03/08,9,0,0,0,9
4446,2023/03/08,14,12,6,0,20
12136,2023/03/08,50,36,36,0,86
12516,2023/03/08,8,4,5,0,13
12518,2023/03/08,6,4,6,0,12
12523,2023/03/08,11,4,7,0,18
16062,2023/03/08,10,0,0,0,10
16276,2023/03/08,5,0,0,0,5
19322,2023/03/08,9,0,0,0,9
19329,2023/03/08,4,0,0,0,4
19520,2023/03/08,10,0,1,0,11
19521,2023/03/08,14,0,1,0,15
20920,2023/03/08,19,0,0,0,19
21097,2023/03/08,8,0,0,0,8
21102,2023/03/08,7,0,0,0,7
21103,2023/03/08,6,0,0,0,6
21132,2023/03/08,15,24,20,0,35
21171,2023/03/08,5,0,3,0,8
21174,2023/03/08,19,16,13,0,32
21175,2023/03/08,15,12,11,1,26
21176,2023/03/08,7,8,1,0,8
75,2023/03/09,53,32,53,6,106
76,2023/03/09,53,40,50,1,103
99,2023/03/09,15,0,0,0,15
117,2023/03/09,2,0,1,0,3
118,2023/03/09,4,4,4,0,8
119,2023/03/09,1,0,0,0,1
120,2023/03/09,4,0,0,0,4
149,2023/03/09,8,0,1,0,9
184,2023/03/09,26,18,15,0,41
195,2023/03/09,30,30,32,3,62
218,2023/03/09,31,36,31,2,62
296,2023/03/09,3,0,2,0,5
300,2023/03/09,-26,4,4,0,-22
304,2023/03/09,3,0,2,0,5
317,2023/03/09,6,12,14,0,20
343,2023/03/09,5,0,3,0,8
353,2023/03/09,7,0,0,0,7
373,2023/03/09,-1,0,0,0,-1
374,2023/03/09,8,8,7,0,15
388,2023/03/09,33,21,29,1,62
419,2023/03/09,1,0,1,0,2
420,2023/03/09,4,6,3,0,7
462,2023/03/09,9,0,5,0,14
519,2023/03/09,26,6,5,4,31
525,2023/03/09,2,0,0,0,2
596,2023/03/09,4,4,4,0,8
597,2023/03/09,41,18,9,0,50
598,2023/03/09,8,0,0,0,8
1035,2023/03/09,12,6,7,0,19
1084,2023/03/09,28,15,14,0,42
1112,2023/03/09,12,0,0,0,12
1113,2023/03/09,5,0,0,0,5
1114,2023/03/09,11,0,1,0,12
1115,2023/03/09,8,0,1,0,9
1118,2023/03/09,15,0,1,0,16
1119,2023/03/09,10,0,0,0,10
1692,2023/03/09,5,6,5,0,10
1693,2023/03/09,5,6,4,0,9
1747,2023/03/09,44,20,13,0,57
1772,2023/03/09,5,0,1,0,6
1773,2023/03/09,7,0,0,0,7
1774,2023/03/09,7,0,0,0,7
1782,2023/03/09,42,30,19,0,61
1795,2023/03/09,41,14,20,0,61
1914,2023/03/09,12,0,2,0,14
1915,2023/03/09,10,0,2,0,12
1923,2023/03/09,9,0,0,0,9
1934,2023/03/09,6,5,0,0,6
1963,2023/03/09,0,0,0,0,0
1984,2023/03/09,5,0,0,0,5
2135,2023/03/09,7,0,1,0,8
2136,2023/03/09,9,0,1,0,10
2148,2023/03/09,6,4,3,0,9
2183,2023/03/09,6,6,2,0,8
2193,2023/03/09,27,21,18,5,45
2237,2023/03/09,7,0,2,0,9
2358,2023/03/09,5,4,3,0,8
2361,2023/03/09,12,7,5,0,17
2445,2023/03/09,10,6,7,0,17
2449,2023/03/09,6,6,6,0,12
2451,2023/03/09,41,15,11,0,52
2475,2023/03/09,12,0,0,0,12
2476,2023/03/09,10,0,0,0,10
2507,2023/03/09,38,12,9,1,47
2525,2023/03/09,10,0,1,0,11
2562,2023/03/09,-1,0,0,0,-1
2582,2023/03/09,10,0,1,0,11
2586,2023/03/09,39,20,17,1,56
2602,2023/03/09,10,0,0,0,10
2631,2023/03/09,7,6,5,0,12
2685,2023/03/09,14,8,7,2,21
2723,2023/03/09,16,0,1,0,17
2730,2023/03/09,8,0,2,0,10
2731,2023/03/09,8,0,2,0,10
2732,2023/03/09,7,0,0,0,7
2734,2023/03/09,7,4,7,0,14
2735,2023/03/09,8,4,0,0,8
2761,2023/03/09,35,20,18,0,53
2788,2023/03/09,34,32,16,0,50
2802,2023/03/09,5,0,0,0,5
2812,2023/03/09,8,0,0,0,8
2813,2023/03/09,11,0,1,0,12
2814,2023/03/09,9,0,2,0,11
2913,2023/03/09,3,0,3,0,6
2914,2023/03/09,6,0,0,0,6
3015,2023/03/09,2,0,0,0,2
3033,2023/03/09,8,0,0,0,8
3035,2023/03/09,9,0,1,0,10
4446,2023/03/09,17,9,6,0,23
12136,2023/03/09,38,24,20,10,58
12516,2023/03/09,7,4,3,0,10
12518,2023/03/09,4,4,3,0,7
12523,2023/03/09,8,4,7,0,15
16062,2023/03/09,10,0,2,0,12
16276,2023/03/09,5,0,0,0,5
19322,2023/03/09,9,0,0,0,9
19329,2023/03/09,4,0,0,0,4
19520,2023/03/09,9,0,0,0,9
19521,2023/03/09,13,0,1,0,14
20920,2023/03/09,19,0,0,0,19
21097,2023/03/09,8,0,0,0,8
21103,2023/03/09,6,0,0,0,6
21132,2023/03/09,16,21,24,4,40
21171,2023/03/09,2,0,1,0,3
21174,2023/03/09,18,12,9,1,27
21175,2023/03/09,11,8,11,0,22
21176,2023/03/09,14,8,8,0,22
75,2023/03/10,42,88,41,0,83
76,2023/03/10,54,92,50,0,104
99,2023/03/10,15,0,0,0,15
117,2023/03/10,5,4,1,0,6
118,2023/03/10,4,4,3,0,7
119,2023/03/10,1,4,0,0,1
120,2023/03/10,8,4,0,0,8
149,2023/03/10,7,0,0,0,7
184,2023/03/10,29,18,21,1,50
195,2023/03/10,28,69,32,0,60
218,2023/03/10,28,30,31,0,59
296,2023/03/10,5,8,4,0,9
300,2023/03/10,-26,8,4,0,-22
304,2023/03/10,1,0,0,0,1
317,2023/03/10,4,12,5,0,9
343,2023/03/10,2,0,0,0,2
353,2023/03/10,7,0,1,0,8
373,2023/03/10,5,6,2,0,7
374,2023/03/10,5,8,4,0,9
388,2023/03/10,31,39,22,1,53
419,2023/03/10,6,6,5,0,11
420,2023/03/10,1,6,0,0,1
462,2023/03/10,12,16,5,0,17
519,2023/03/10,29,18,9,1,38
525,2023/03/10,7,5,4,0,11
596,2023/03/10,8,8,2,0,10
597,2023/03/10,68,36,14,0,82
598,2023/03/10,8,0,2,0,10
1035,2023/03/10,11,6,9,0,20
1084,2023/03/10,34,20,11,0,45
1112,2023/03/10,12,0,0,0,12
1113,2023/03/10,5,6,0,0,5
1114,2023/03/10,16,12,2,0,18
1115,2023/03/10,13,12,9,0,22
1117,2023/03/10,16,0,3,0,19
1118,2023/03/10,14,0,3,0,17
1119,2023/03/10,10,0,0,0,10
1692,2023/03/10,6,12,4,0,10
1693,2023/03/10,1,6,2,0,3
1747,2023/03/10,51,20,22,3,73
1772,2023/03/10,4,8,0,0,4
1773,2023/03/10,7,6,1,0,8
1774,2023/03/10,7,0,1,0,8
1782,2023/03/10,53,30,29,0,82
1795,2023/03/10,35,14,18,1,53
1914,2023/03/10,10,0,1,0,11
1915,2023/03/10,8,0,3,0,11
1923,2023/03/10,9,0,1,0,10
1934,2023/03/10,6,0,1,0,7
1963,2023/03/10,12,12,10,0,22
1984,2023/03/10,11,6,5,0,16
2135,2023/03/10,12,6,3,0,15
2136,2023/03/10,8,0,1,0,9
2148,2023/03/10,3,4,1,0,4
2183,2023/03/10,16,12,7,0,23
2193,2023/03/10,25,21,10,5,35
2237,2023/03/10,11,6,8,0,19
2358,2023/03/10,6,4,4,0,10
2361,2023/03/10,14,7,13,0,27
2445,2023/03/10,9,6,5,0,14
2449,2023/03/10,6,12,2,0,8
2451,2023/03/10,55,25,26,1,81
2475,2023/03/10,12,0,0,0,12
2476,2023/03/10,10,0,0,0,10
2507,2023/03/10,40,12,15,0,55
2525,2023/03/10,9,0,3,0,12
2562,2023/03/10,5,12,5,0,10
2582,2023/03/10,9,4,5,0,14
2586,2023/03/10,45,24,15,0,60
2602,2023/03/10,10,0,1,0,11
2631,2023/03/10,8,12,4,0,12
2685,2023/03/10,13,8,7,0,20
2723,2023/03/10,15,0,0,0,15
2730,2023/03/10,6,0,0,0,6
2731,2023/03/10,6,6,5,0,11
2732,2023/03/10,15,8,1,0,16
2734,2023/03/10,4,8,3,0,7
2735,2023/03/10,12,8,6,0,18
2761,2023/03/10,42,40,19,0,61
2788,2023/03/10,50,56,21,12,71
2802,2023/03/10,5,0,2,0,7
2812,2023/03/10,8,0,0,0,8
2813,2023/03/10,10,0,1,0,11
2814,2023/03/10,7,0,2,0,9
2913,2023/03/10,6,6,3,0,9
2914,2023/03/10,12,6,1,0,13
3015,2023/03/10,2,8,2,0,4
3033,2023/03/10,8,0,1,0,9
3035,2023/03/10,8,0,0,0,8
4446,2023/03/10,26,15,9,0,35
12136,2023/03/10,44,36,42,0,86
12516,2023/03/10,8,4,5,0,13
12518,2023/03/10,5,8,4,0,9
12523,2023/03/10,5,8,1,0,6
16062,2023/03/10,8,0,1,0,9
16276,2023/03/10,5,0,0,0,5
19322,2023/03/10,9,0,1,0,10
19329,2023/03/10,10,6,3,0,13
19520,2023/03/10,9,0,0,0,9
19521,2023/03/10,12,0,2,0,14
20920,2023/03/10,19,0,0,0,19
21097,2023/03/10,8,0,0,0,8
21103,2023/03/10,6,0,0,0,6
21132,2023/03/10,6,18,13,2,19
21171,2023/03/10,1,0,1,0,2
21174,2023/03/10,24,16,16,2,40
21175,2023/03/10,8,8,8,0,16
21176,2023/03/10,14,8,6,0,20
75,2023/03/11,41,28,35,0,76
76,2023/03/11,44,32,39,2,83
99,2023/03/11,15,0,3,0,18
117,2023/03/11,4,4,3,0,7
118,2023/03/11,1,0,1,0,2
119,2023/03/11,5,0,1,0,6
120,2023/03/11,8,4,1,0,9
184,2023/03/11,19,12,14,0,33
195,2023/03/11,32,21,32,0,64
218,2023/03/11,30,63,35,0,65
296,2023/03/11,5,8,4,0,9
300,2023/03/11,-26,4,4,0,-22
304,2023/03/11,1,8,0,0,1
317,2023/03/11,14,18,8,0,22
343,2023/03/11,2,4,0,0,2
353,2023/03/11,6,0,0,0,6
373,2023/03/11,10,12,7,0,17
374,2023/03/11,5,8,5,0,10
388,2023/03/11,19,18,14,1,33
419,2023/03/11,7,12,5,0,12
420,2023/03/11,7,6,4,0,11
462,2023/03/11,15,16,4,0,19
519,2023/03/11,5,0,6,1,11
525,2023/03/11,4,5,1,0,5
596,2023/03/11,6,8,1,0,7
597,2023/03/11,17,18,8,0,25
598,2023/03/11,6,6,2,0,8
1035,2023/03/11,9,12,5,0,14
1084,2023/03/11,23,10,11,1,34
1112,2023/03/11,12,0,0,0,12
1113,2023/03/11,11,0,0,0,11
1114,2023/03/11,20,0,7,0,27
1115,2023/03/11,10,0,3,0,13
1117,2023/03/11,13,0,0,0,13
1118,2023/03/11,11,0,2,0,13
1119,2023/03/11,10,0,0,0,10
1692,2023/03/11,9,6,5,0,14
1693,2023/03/11,4,0,3,0,7
1747,2023/03/11,37,30,26,0,63
1772,2023/03/11,12,0,1,0,13
1773,2023/03/11,12,0,0,0,12
1774,2023/03/11,6,8,2,0,8
1782,2023/03/11,44,33,20,6,64
1795,2023/03/11,46,28,17,0,63
1914,2023/03/11,9,0,0,0,9
1915,2023/03/11,5,6,0,0,5
1923,2023/03/11,8,0,0,0,8
1934,2023/03/11,5,5,1,0,6
1963,2023/03/11,8,18,6,0,14
1984,2023/03/11,6,6,3,0,9
2135,2023/03/11,9,0,5,0,14
2136,2023/03/11,7,0,0,0,7
2148,2023/03/11,6,4,4,0,10
2183,2023/03/11,16,6,7,0,23
2193,2023/03/11,28,27,21,8,49
2237,2023/03/11,3,0,1,0,4
2358,2023/03/11,6,12,1,0,7
2361,2023/03/11,8,14,6,0,14
2445,2023/03/11,10,12,7,0,17
2449,2023/03/11,11,12,2,0,13
2451,2023/03/11,25,50,11,0,36
2475,2023/03/11,12,0,0,0,12
2476,2023/03/11,10,0,1,0,11
2507,2023/03/11,17,6,15,0,32
2525,2023/03/11,6,0,3,0,9
2562,2023/03/11,7,6,5,0,12
2582,2023/03/11,8,0,0,0,8
2586,2023/03/11,40,12,13,12,53
2602,2023/03/11,9,0,0,0,9
2631,2023/03/11,35,6,6,0,41
2685,2023/03/11,10,8,5,0,15
2723,2023/03/11,15,0,1,0,16
2730,2023/03/11,6,6,2,0,8
2731,2023/03/11,7,0,0,0,7
2732,2023/03/11,14,0,1,0,15
2734,2023/03/11,5,8,2,0,7
2735,2023/03/11,10,0,8,0,18
2761,2023/03/11,22,5,14,0,36
2788,2023/03/11,18,8,22,15,40
2802,2023/03/11,3,6,0,0,3
2812,2023/03/11,8,0,2,0,10
2813,2023/03/11,9,0,3,0,12
2814,2023/03/11,5,6,2,0,7
2913,2023/03/11,6,6,2,0,8
2914,2023/03/11,11,0,1,0,12
3015,2023/03/11,8,0,1,0,9
3033,2023/03/11,7,0,0,0,7
3035,2023/03/11,8,0,1,0,9
4446,2023/03/11,32,27,14,7,46
12136,2023/03/11,20,36,22,0,42
12516,2023/03/11,3,0,2,0,5
12518,2023/03/11,5,4,5,0,10
12523,2023/03/11,8,16,4,0,12
16062,2023/03/11,7,0,1,0,8
16276,2023/03/11,5,4,0,0,5
19322,2023/03/11,8,0,0,0,8
19329,2023/03/11,7,0,0,0,7
19520,2023/03/11,9,0,0,0,9
19521,2023/03/11,10,0,1,0,11
21097,2023/03/11,8,0,0,0,8
21103,2023/03/11,6,0,0,0,6
21132,2023/03/11,12,30,20,0,32
21171,2023/03/11,0,4,1,0,1
21174,2023/03/11,18,24,12,1,30
21175,2023/03/11,12,20,10,0,22
21176,2023/03/11,16,8,3,13,19
75,2023/03/12,34,48,38,0,72
76,2023/03/12,35,64,41,1,76
99,2023/03/12,12,0,1,0,13
117,2023/03/12,5,4,1,0,6
118,2023/03/12,0,8,0,0,0
119,2023/03/12,4,4,1,0,5
120,2023/03/12,11,0,1,0,12
184,2023/03/12,5,9,5,1,10
195,2023/03/12,21,39,27,0,48
218,2023/03/12,25,33,29,0,54
296,2023/03/12,9,8,1,0,10
300,2023/03/12,-26,8,1,0,-25
304,2023/03/12,9,4,3,0,12
317,2023/03/12,18,12,6,0,24
343,2023/03/12,6,4,1,0,7
353,2023/03/12,6,0,0,0,6
373,2023/03/12,9,0,1,0,10
374,2023/03/12,8,0,4,0,12
388,2023/03/12,22,21,10,1,32
419,2023/03/12,8,0,7,0,15
420,2023/03/12,9,0,3,0,12
462,2023/03/12,27,8,9,0,36
519,2023/03/12,-2,6,4,12,2
525,2023/03/12,8,0,1,0,9
596,2023/03/12,13,4,4,0,17
597,2023/03/12,27,0,9,10,36
598,2023/03/12,10,0,2,0,12
1035,2023/03/12,10,6,2,0,12
1084,2023/03/12,21,10,9,9,30
1112,2023/03/12,12,0,2,0,14
1113,2023/03/12,11,6,2,0,13
1114,2023/03/12,13,6,0,0,13
1115,2023/03/12,7,6,4,0,11
1117,2023/03/12,13,0,0,0,13
1118,2023/03/12,9,0,1,0,10
1119,2023/03/12,10,0,1,0,11
1692,2023/03/12,10,6,5,0,15
1693,2023/03/12,1,6,1,0,2
1747,2023/03/12,26,0,12,2,38
1772,2023/03/12,11,0,3,0,14
1773,2023/03/12,12,0,1,0,13
1774,2023/03/12,12,0,0,0,12
1782,2023/03/12,33,12,13,7,46
1795,2023/03/12,29,0,13,9,42
1914,2023/03/12,9,0,1,0,10
1915,2023/03/12,11,0,3,0,14
1923,2023/03/12,8,0,2,0,10
1934,2023/03/12,9,5,4,2,13
1963,2023/03/12,14,0,11,0,25
1984,2023/03/12,9,0,1,0,10
2135,2023/03/12,4,6,3,0,7
2136,2023/03/12,7,6,2,0,9
2148,2023/03/12,6,0,4,0,10
2183,2023/03/12,9,6,6,0,15
2193,2023/03/12,8,0,11,0,19
2237,2023/03/12,2,6,0,0,2
2358,2023/03/12,13,0,4,0,17
2361,2023/03/12,9,0,6,0,15
2445,2023/03/12,9,6,7,0,16
2449,2023/03/12,21,6,3,0,24
2451,2023/03/12,64,0,12,2,76
2475,2023/03/12,12,0,1,0,13
2476,2023/03/12,9,0,2,0,11
2507,2023/03/12,8,0,6,1,14
2525,2023/03/12,3,6,0,0,3
2562,2023/03/12,8,6,3,0,11
2582,2023/03/12,8,0,0,0,8
2586,2023/03/12,15,16,19,0,34
2602,2023/03/12,9,0,2,0,11
2631,2023/03/12,35,0,4,0,39
2685,2023/03/12,9,0,4,1,13
2723,2023/03/12,14,0,0,0,14
2730,2023/03/12,10,0,3,0,13
2731,2023/03/12,7,6,3,0,10
2732,2023/03/12,13,0,0,0,13
2734,2023/03/12,11,0,7,0,18
2735,2023/03/12,2,4,0,0,2
2761,2023/03/12,13,20,15,0,28
2788,2023/03/12,-13,0,6,0,-7
2802,2023/03/12,9,0,1,0,10
2812,2023/03/12,6,0,0,0,6
2813,2023/03/12,6,0,3,0,9
2814,2023/03/12,9,0,3,0,12
2913,2023/03/12,10,0,0,0,10
2914,2023/03/12,10,0,1,0,11
3015,2023/03/12,7,8,1,0,8
3033,2023/03/12,7,0,0,0,7
3035,2023/03/12,7,0,1,0,8
4446,2023/03/12,23,12,6,5,29
12136,2023/03/12,16,0,21,0,37
12516,2023/03/12,1,0,0,0,1
12518,2023/03/12,4,4,3,0,7
12523,2023/03/12,20,0,10,0,30
16062,2023/03/12,6,6,1,0,7
16276,2023/03/12,9,0,1,0,10
19322,2023/03/12,8,0,1,0,9
19329,2023/03/12,7,6,2,0,9
19520,2023/03/12,9,0,1,0,10
19521,2023/03/12,9,0,2,0,11
21097,2023/03/12,8,0,0,0,8
21103,2023/03/12,6,0,1,0,7
21132,2023/03/12,1,15,9,2,10
21171,2023/03/12,3,0,1,0,4
21174,2023/03/12,17,12,9,0,26
21175,2023/03/12,10,8,11,0,21
21176,2023/03/12,0,0,1,1,1
75,2023/03/13,44,36,48,0,92
76,2023/03/13,57,48,58,1,115
99,2023/03/13,11,0,0,0,11
117,2023/03/13,8,4,2,0,10
118,2023/03/13,8,4,3,0,11
119,2023/03/13,7,0,3,0,10
120,2023/03/13,10,0,1,0,11
184,2023/03/13,8,12,7,0,15
195,2023/03/13,33,39,40,0,73
218,2023/03/13,29,36,31,0,60
296,2023/03/13,16,8,7,0,23
300,2023/03/13,-19,4,3,0,-16
304,2023/03/13,10,8,9,0,19
317,2023/03/13,24,12,10,0,34
343,2023/03/13,9,0,1,0,10
353,2023/03/13,6,0,0,0,6
373,2023/03/13,14,12,3,0,17
374,2023/03/13,4,4,3,0,7
388,2023/03/13,32,24,24,47,56
419,2023/03/13,7,18,6,0,13
420,2023/03/13,6,6,1,0,7
462,2023/03/13,26,8,10,0,36
519,2023/03/13,-12,6,5,0,-7
525,2023/03/13,7,0,0,0,7
596,2023/03/13,13,8,1,0,14
597,2023/03/13,8,12,13,1,21
598,2023/03/13,8,0,3,0,11
1035,2023/03/13,14,0,4,0,18
1084,2023/03/13,13,0,5,0,18
1112,2023/03/13,10,0,0,0,10
1113,2023/03/13,15,0,0,0,15
1114,2023/03/13,19,0,4,0,23
1115,2023/03/13,9,0,0,0,9
1117,2023/03/13,13,0,0,0,13
1118,2023/03/13,8,0,0,0,8
1119,2023/03/13,9,0,0,0,9
1692,2023/03/13,11,6,9,0,20
1693,2023/03/13,6,0,2,0,8
1747,2023/03/13,22,30,17,0,39
1772,2023/03/13,8,0,1,0,9
1773,2023/03/13,11,0,0,0,11
1774,2023/03/13,12,0,1,0,13
1782,2023/03/13,25,21,26,0,51
1795,2023/03/13,21,14,10,0,31
1914,2023/03/13,8,0,0,0,8
1915,2023/03/13,8,0,0,0,8
1923,2023/03/13,6,0,2,0,8
1934,2023/03/13,8,0,3,0,11
1963,2023/03/13,15,18,10,0,25
1984,2023/03/13,8,0,0,0,8
2135,2023/03/13,7,6,1,0,8
2136,2023/03/13,11,0,0,0,11
2148,2023/03/13,2,4,0,0,2
2183,2023/03/13,9,0,5,0,14
2193,2023/03/13,18,21,12,0,30
2237,2023/03/13,8,6,1,0,9
2358,2023/03/13,9,0,2,0,11
2361,2023/03/13,3,7,4,0,7
2445,2023/03/13,8,0,6,0,14
2449,2023/03/13,24,6,11,0,35
2451,2023/03/13,50,0,13,1,63
2475,2023/03/13,11,0,1,0,12
2476,2023/03/13,7,0,0,0,7
2507,2023/03/13,1,12,8,1,9
2525,2023/03/13,9,0,1,0,10
2562,2023/03/13,11,6,5,0,16
2582,2023/03/13,8,8,2,0,10
2586,2023/03/13,12,0,15,0,27
2602,2023/03/13,7,0,2,0,9
2631,2023/03/13,37,6,1,0,38
2685,2023/03/13,12,8,8,1,20
2723,2023/03/13,14,0,3,0,17
2730,2023/03/13,7,0,4,0,11
2731,2023/03/13,10,0,1,0,11
2732,2023/03/13,13,0,0,0,13
2734,2023/03/13,4,4,3,0,7
2735,2023/03/13,6,4,4,0,10
2761,2023/03/13,18,20,27,0,45
2788,2023/03/13,-17,24,6,0,-11
2802,2023/03/13,8,0,0,0,8
2812,2023/03/13,6,0,0,0,6
2813,2023/03/13,3,6,1,0,4
2814,2023/03/13,6,0,0,0,6
2913,2023/03/13,10,0,1,0,11
2914,2023/03/13,9,0,0,0,9
3015,2023/03/13,14,0,2,0,16
3033,2023/03/13,7,0,0,0,7
3035,2023/03/13,6,0,0,0,6
4446,2023/03/13,24,0,8,2,32
12136,2023/03/13,25,69,24,0,49
12516,2023/03/13,1,8,0,0,1
12518,2023/03/13,5,4,5,0,10
12523,2023/03/13,10,8,6,0,16
16062,2023/03/13,11,0,2,0,13
16276,2023/03/13,8,0,1,0,9
19322,2023/03/13,7,0,0,0,7
19329,2023/03/13,11,0,0,0,11
19520,2023/03/13,8,0,0,0,8
19521,2023/03/13,7,0,0,0,7
20920,2023/03/13,19,0,1,0,20
21103,2023/03/13,5,0,0,0,5
21132,2023/03/13,5,27,16,1,21
21171,2023/03/13,6,8,2,0,8
21174,2023/03/13,20,0,12,0,32
21175,2023/03/13,7,12,9,0,16
21176,2023/03/13,2,8,4,3,6
75,2023/03/14,32,36,47,0,79
76,2023/03/14,46,44,40,5,86
99,2023/03/14,11,0,0,0,11
117,2023/03/14,10,4,2,0,12
118,2023/03/14,9,0,4,0,13
119,2023/03/14,4,4,2,0,6
120,2023/03/14,9,0,0,0,9
184,2023/03/14,13,15,7,0,20
195,2023/03/14,32,36,40,0,72
218,2023/03/14,34,30,43,0,77
296,2023/03/14,17,4,5,0,22
300,2023/03/14,-18,0,4,0,-14
304,2023/03/14,9,8,2,0,11
317,2023/03/14,26,12,8,0,34
343,2023/03/14,8,4,1,0,9
353,2023/03/14,6,0,0,0,6
373,2023/03/14,17,0,7,0,24
374,2023/03/14,5,8,5,0,10
388,2023/03/14,-15,24,19,0,4
419,2023/03/14,13,0,7,0,20
420,2023/03/14,11,0,4,0,15
462,2023/03/14,24,0,5,0,29
519,2023/03/14,-11,6,4,0,-7
525,2023/03/14,7,0,0,0,7
596,2023/03/14,20,0,5,4,25
597,2023/03/14,6,12,15,13,21
598,2023/03/14,5,6,1,0,6
1035,2023/03/14,16,6,5,0,21
1084,2023/03/14,8,10,10,0,18
1112,2023/03/14,10,0,1,0,11
1113,2023/03/14,15,0,3,0,18
1114,2023/03/14,15,0,3,0,18
1115,2023/03/14,9,6,3,0,12
1117,2023/03/14,13,0,2,0,15
1118,2023/03/14,8,0,1,0,9
1119,2023/03/14,9,0,2,0,11
1692,2023/03/14,8,0,5,0,13
1693,2023/03/14,4,6,3,0,7
1747,2023/03/14,25,0,19,0,44
1772,2023/03/14,7,8,1,0,8
1773,2023/03/14,11,0,1,0,12
1774,2023/03/14,11,0,1,0,12
1782,2023/03/14,20,21,19,0,39
1795,2023/03/14,11,14,9,0,20
1914,2023/03/14,8,0,0,0,8
1915,2023/03/14,8,0,1,0,9
1923,2023/03/14,4,0,1,0,5
1934,2023/03/14,5,0,3,0,8
1963,2023/03/14,11,12,5,0,16
1984,2023/03/14,8,6,1,0,9
2135,2023/03/14,12,0,2,0,14
2136,2023/03/14,11,0,1,0,12
2148,2023/03/14,6,4,3,0,9
2183,2023/03/14,4,0,1,0,5
2193,2023/03/14,33,27,22,5,55
2237,2023/03/14,13,0,1,0,14
2358,2023/03/14,15,8,5,0,20
2361,2023/03/14,6,0,6,0,12
2445,2023/03/14,8,6,4,0,12
2449,2023/03/14,19,0,8,0,27
2451,2023/03/14,36,0,13,0,49
2475,2023/03/14,10,0,0,0,10
2476,2023/03/14,7,0,1,0,8
2507,2023/03/14,4,12,7,0,11
2525,2023/03/14,8,0,1,0,9
2562,2023/03/14,12,6,6,0,18
2582,2023/03/14,14,4,0,0,14
2586,2023/03/14,13,16,7,0,20
2602,2023/03/14,5,0,1,0,6
2631,2023/03/14,36,0,2,0,38
2685,2023/03/14,11,8,12,0,23
2723,2023/03/14,11,0,0,0,11
2730,2023/03/14,3,0,1,0,4
2731,2023/03/14,9,0,2,0,11
2732,2023/03/14,13,0,1,0,14
2734,2023/03/14,5,4,2,0,7
2735,2023/03/14,6,8,3,0,9
2761,2023/03/14,11,20,10,0,21
2788,2023/03/14,1,0,34,0,35
2812,2023/03/14,6,0,1,0,7
2813,2023/03/14,8,0,2,0,10
2814,2023/03/14,6,6,1,0,7
2913,2023/03/14,9,0,2,0,11
2914,2023/03/14,9,0,0,0,9
3015,2023/03/14,12,0,2,0,14
3033,2023/03/14,7,0,1,0,8
3035,2023/03/14,6,0,0,0,6
4446,2023/03/14,14,9,10,0,24
12136,2023/03/14,40,0,41,0,81
12516,2023/03/14,9,0,2,0,11
12518,2023/03/14,4,8,4,0,8
12523,2023/03/14,12,0,5,0,17
16062,2023/03/14,9,0,0,0,9
16276,2023/03/14,7,0,1,2,8
19322,2023/03/14,7,0,0,0,7
19329,2023/03/14,11,0,2,0,13
19520,2023/03/14,8,0,2,0,10
19521,2023/03/14,7,8,0,0,7
20920,2023/03/14,18,0,0,0,18
21097,2023/03/14,8,0,1,0,9
21103,2023/03/14,5,0,1,0,6
21132,2023/03/14,15,21,24,0,39
21171,2023/03/14,8,4,0,1,8
21174,2023/03/14,20,12,20,0,40
21175,2023/03/14,10,0,11,0,21
21176,2023/03/14,-1,4,4,1,3
75,2023/03/15,22,0,28,0,50
76,2023/03/15,45,0,50,0,95
99,2023/03/15,11,0,1,0,12
117,2023/03/15,12,0,2,0,14
118,2023/03/15,5,0,2,0,7
119,2023/03/15,6,0,2,0,8
120,2023/03/15,9,0,2,1,11
184,2023/03/15,21,0,10,0,31
195,2023/03/15,28,0,34,0,62
218,2023/03/15,33,9,32,0,65
296,2023/03/15,16,0,8,0,24
300,2023/03/15,11,4,2,0,13
304,2023/03/15,15,0,6,0,21
317,2023/03/15,30,0,5,0,35
343,2023/03/15,11,0,1,0,12
353,2023/03/15,6,0,0,0,6
373,2023/03/15,10,0,3,0,13
374,2023/03/15,8,0,6,0,14
388,2023/03/15,11,0,35,0,46
419,2023/03/15,6,0,5,0,11
420,2023/03/15,7,0,4,0,11
462,2023/03/15,19,0,5,0,24
519,2023/03/15,18,0,7,0,25
525,2023/03/15,7,0,0,0,7
596,2023/03/15,11,0,9,0,20
597,2023/03/15,-9,0,21,0,12
598,2023/03/15,10,0,2,0,12
1035,2023/03/15,17,6,6,0,23
1084,2023/03/15,8,0,12,0,20
1112,2023/03/15,9,0,0,0,9
1113,2023/03/15,12,0,0,0,12
1114,2023/03/15,12,0,4,0,16
1115,2023/03/15,12,0,3,0,15
1117,2023/03/15,11,0,2,0,13
1118,2023/03/15,7,0,2,0,9
1119,2023/03/15,7,0,0,0,7
1692,2023/03/15,3,0,1,0,4
1693,2023/03/15,7,0,4,0,11
1747,2023/03/15,31,25,32,0,63
1772,2023/03/15,14,0,0,0,14
1773,2023/03/15,10,0,1,0,11
1774,2023/03/15,10,0,0,0,10
1782,2023/03/15,22,0,23,0,45
1795,2023/03/15,16,0,13,0,29
1914,2023/03/15,8,0,0,0,8
1915,2023/03/15,7,0,1,0,8
1923,2023/03/15,3,0,1,0,4
1934,2023/03/15,2,0,2,0,4
1963,2023/03/15,18,0,6,0,24
1984,2023/03/15,13,0,1,1,14
2135,2023/03/15,10,0,2,0,12
2136,2023/03/15,10,0,2,0,12
2148,2023/03/15,7,0,5,0,12
2183,2023/03/15,9,6,1,0,10
2193,2023/03/15,21,15,22,1,43
2237,2023/03/15,12,0,1,0,13
2358,2023/03/15,10,0,5,0,15
2361,2023/03/15,0,0,0,0,0
2445,2023/03/15,10,6,0,0,10
2449,2023/03/15,11,0,4,0,15
2451,2023/03/15,23,0,13,0,36
2475,2023/03/15,10,0,0,0,10
2476,2023/03/15,6,0,2,0,8
2507,2023/03/15,9,0,5,0,14
2525,2023/03/15,7,0,1,0,8
2562,2023/03/15,12,0,5,0,17
2582,2023/03/15,18,0,3,0,21
2586,2023/03/15,22,16,22,0,44
2602,2023/03/15,4,0,0,0,4
2631,2023/03/15,34,0,4,0,38
2685,2023/03/15,3,4,4,0,7
2723,2023/03/15,11,0,1,0,12
2730,2023/03/15,2,0,1,0,3
2731,2023/03/15,7,0,1,0,8
2732,2023/03/15,12,0,4,0,16
2734,2023/03/15,7,0,2,0,9
2735,2023/03/15,11,0,7,0,18
2761,2023/03/15,21,0,21,0,42
2788,2023/03/15,-13,20,14,3,1
2812,2023/03/15,5,0,0,0,5
2813,2023/03/15,6,0,1,0,7
2814,2023/03/15,11,0,0,0,11
2913,2023/03/15,7,0,0,0,7
2914,2023/03/15,9,0,0,0,9
3015,2023/03/15,10,0,2,0,12
3033,2023/03/15,6,0,0,0,6
3035,2023/03/15,6,0,1,0,7
4446,2023/03/15,13,0,10,0,23
12136,2023/03/15,35,36,36,0,71
12516,2023/03/15,7,0,3,0,10
12518,2023/03/15,8,0,0,0,8
12523,2023/03/15,7,0,6,0,13
16062,2023/03/15,9,0,0,0,9
16276,2023/03/15,4,0,2,0,6
19322,2023/03/15,7,0,0,0,7
19329,2023/03/15,9,0,0,0,9
19520,2023/03/15,6,0,1,0,7
19521,2023/03/15,15,0,0,0,15
20920,2023/03/15,18,0,0,0,18
21097,2023/03/15,7,0,0,0,7
21103,2023/03/15,4,0,0,0,4
21132,2023/03/15,12,0,21,0,33
21171,2023/03/15,11,0,7,0,18
21174,2023/03/15,12,12,13,0,25
21175,2023/03/15,11,12,19,0,30
21176,2023/03/15,0,0,10,0,10
75,2023/03/16,41,48,53,0,94
76,2023/03/16,56,56,35,0,91
99,2023/03/16,10,0,0,0,10
117,2023/03/16,10,0,2,0,12
118,2023/03/16,7,4,2,0,9
119,2023/03/16,4,0,3,0,7
120,2023/03/16,6,0,1,0,7
184,2023/03/16,32,18,14,0,46
195,2023/03/16,32,30,31,0,63
218,2023/03/16,37,33,37,0,74
296,2023/03/16,8,0,4,0,12
300,2023/03/16,17,8,1,0,18
304,2023/03/16,9,0,1,0,10
317,2023/03/16,25,0,4,0,29
343,2023/03/16,10,0,5,0,15
353,2023/03/16,6,0,1,0,7
373,2023/03/16,7,0,3,2,10
374,2023/03/16,10,8,5,0,15
388,2023/03/16,27,24,18,0,45
419,2023/03/16,1,0,0,0,1
420,2023/03/16,3,0,2,0,5
462,2023/03/16,14,0,3,0,17
519,2023/03/16,17,6,7,0,24
525,2023/03/16,12,5,1,0,13
596,2023/03/16,-3,4,5,0,2
597,2023/03/16,18,12,15,0,33
598,2023/03/16,8,0,0,0,8
1035,2023/03/16,11,0,2,0,13
1084,2023/03/16,15,20,15,0,30
1112,2023/03/16,9,0,0,0,9
1113,2023/03/16,12,0,3,0,15
1114,2023/03/16,8,0,6,0,14
1115,2023/03/16,9,0,2,0,11
1117,2023/03/16,9,0,0,0,9
1118,2023/03/16,5,0,0,0,5
1119,2023/03/16,7,0,1,0,8
1692,2023/03/16,8,6,5,0,13
1693,2023/03/16,9,6,4,0,13
1747,2023/03/16,7,15,14,0,21
1772,2023/03/16,14,0,1,0,15
1773,2023/03/16,9,0,0,0,9
1774,2023/03/16,10,0,2,0,12
1782,2023/03/16,20,21,23,0,43
1795,2023/03/16,0,0,0,0,0
1914,2023/03/16,8,0,2,0,10
1915,2023/03/16,6,0,0,0,6
1923,2023/03/16,8,6,3,0,11
1934,2023/03/16,5,5,1,0,6
1963,2023/03/16,12,0,8,0,20
1984,2023/03/16,11,0,3,0,14
2135,2023/03/16,8,0,2,0,10
2136,2023/03/16,8,0,0,0,8
2148,2023/03/16,6,4,2,0,8
2183,2023/03/16,14,6,5,0,19
2193,2023/03/16,16,18,17,0,33
2237,2023/03/16,11,0,4,0,15
2358,2023/03/16,5,0,2,0,7
2361,2023/03/16,7,7,7,0,14
2445,2023/03/16,16,6,4,0,20
2449,2023/03/16,7,0,4,0,11
2451,2023/03/16,29,20,14,0,43
2475,2023/03/16,10,0,1,0,11
2476,2023/03/16,4,0,2,0,6
2507,2023/03/16,24,12,13,0,37
2525,2023/03/16,6,0,0,0,6
2562,2023/03/16,13,6,0,0,13
2582,2023/03/16,15,0,1,0,16
2586,2023/03/16,12,20,20,0,32
2602,2023/03/16,12,8,2,0,14
2631,2023/03/16,5,0,4,0,9
2685,2023/03/16,6,8,7,0,13
2723,2023/03/16,10,0,2,0,12
2730,2023/03/16,7,6,1,0,8
2731,2023/03/16,6,0,0,0,6
2732,2023/03/16,8,0,0,0,8
2734,2023/03/16,9,4,0,0,9
2735,2023/03/16,12,8,4,0,16
2761,2023/03/16,8,20,22,0,30
2788,2023/03/16,7,20,13,0,20
2812,2023/03/16,5,0,0,0,5
2813,2023/03/16,5,0,0,0,5
2814,2023/03/16,11,0,6,0,17
2913,2023/03/16,7,0,1,1,8
2914,2023/03/16,9,0,0,0,9
3015,2023/03/16,8,0,6,0,14
3033,2023/03/16,6,0,1,0,7
3035,2023/03/16,5,0,1,0,6
4446,2023/03/16,9,9,11,0,20
12136,2023/03/16,29,27,28,1,57
12516,2023/03/16,8,4,1,0,9
12518,2023/03/16,12,4,4,0,16
12523,2023/03/16,9,8,4,0,13
16062,2023/03/16,9,0,1,0,10
16276,2023/03/16,2,0,0,0,2
19322,2023/03/16,7,0,0,0,7
19329,2023/03/16,9,0,1,0,10
19520,2023/03/16,5,0,1,0,6
19521,2023/03/16,15,0,1,0,16
20920,2023/03/16,18,0,0,0,18
21097,2023/03/16,7,0,0,0,7
21103,2023/03/16,4,0,2,0,6
21132,2023/03/16,24,21,22,0,46
21171,2023/03/16,8,0,2,0,10
21174,2023/03/16,5,4,4,0,9
21175,2023/03/16,-3,12,6,0,3
21176,2023/03/16,6,8,4,0,10
75,2023/03/17,35,80,41,0,76
76,2023/03/17,77,92,51,0,128
99,2023/03/17,10,0,3,0,13
117,2023/03/17,8,0,2,0,10
118,2023/03/17,9,8,5,0,14
119,2023/03/17,5,4,2,0,7
120,2023/03/17,5,0,1,0,6
184,2023/03/17,39,24,9,0,48
195,2023/03/17,40,72,32,0,72
218,2023/03/17,36,36,31,0,67
296,2023/03/17,4,4,3,0,7
300,2023/03/17,20,4,6,0,26
304,2023/03/17,12,4,6,0,18
317,2023/03/17,21,6,12,0,33
343,2023/03/17,5,4,0,0,5
353,2023/03/17,5,0,0,0,5
373,2023/03/17,2,0,2,0,4
374,2023/03/17,9,8,4,0,13
388,2023/03/17,39,45,22,0,61
419,2023/03/17,7,12,6,0,13
420,2023/03/17,7,6,6,0,13
462,2023/03/17,19,16,10,0,29
519,2023/03/17,22,12,10,0,32
525,2023/03/17,11,0,3,0,14
596,2023/03/17,0,8,3,0,3
597,2023/03/17,27,24,15,0,42
598,2023/03/17,8,0,3,0,11
1035,2023/03/17,15,6,4,2,19
1084,2023/03/17,20,20,11,0,31
1112,2023/03/17,9,0,0,0,9
1113,2023/03/17,9,0,0,0,9
1114,2023/03/17,2,6,2,0,4
1115,2023/03/17,13,6,1,0,14
1117,2023/03/17,9,0,1,0,10
1118,2023/03/17,11,6,2,0,13
1119,2023/03/17,6,0,1,0,7
1692,2023/03/17,9,12,4,0,13
1693,2023/03/17,11,6,5,0,16
1747,2023/03/17,13,20,15,0,28
1772,2023/03/17,13,0,1,0,14
1773,2023/03/17,9,0,2,0,11
1774,2023/03/17,8,0,2,0,10
1782,2023/03/17,26,30,15,0,41
1795,2023/03/17,28,49,16,0,44
1914,2023/03/17,6,0,0,0,6
1915,2023/03/17,12,12,4,0,16
1923,2023/03/17,5,0,2,0,7
1934,2023/03/17,4,5,2,0,6
1963,2023/03/17,4,12,4,0,8
1984,2023/03/17,8,6,4,0,12
2135,2023/03/17,6,6,1,0,7
2136,2023/03/17,8,0,0,0,8
2148,2023/03/17,8,8,2,0,10
2183,2023/03/17,15,12,1,0,16
2193,2023/03/17,8,9,7,0,15
2237,2023/03/17,7,0,6,0,13
2358,2023/03/17,7,4,1,0,8
2361,2023/03/17,14,14,7,0,21
2445,2023/03/17,18,6,10,1,28
2449,2023/03/17,9,12,8,0,17
2451,2023/03/17,50,35,16,0,66
2475,2023/03/17,9,0,1,0,10
2476,2023/03/17,2,6,0,0,2
2507,2023/03/17,28,36,10,0,38
2525,2023/03/17,12,6,3,0,15
2562,2023/03/17,19,12,13,0,32
2582,2023/03/17,14,0,1,0,15
2586,2023/03/17,8,28,13,0,21
2602,2023/03/17,10,0,2,0,12
2631,2023/03/17,1,0,1,0,2
2685,2023/03/17,7,8,9,0,16
2723,2023/03/17,8,0,0,0,8
2730,2023/03/17,6,0,0,0,6
2731,2023/03/17,12,6,2,0,14
2732,2023/03/17,8,0,0,0,8
2734,2023/03/17,13,4,8,0,21
2735,2023/03/17,16,16,2,0,18
2761,2023/03/17,10,25,20,0,30
2788,2023/03/17,18,48,17,0,35
2802,2023/03/17,8,0,0,0,8
2812,2023/03/17,5,6,0,0,5
2813,2023/03/17,11,6,1,0,12
2814,2023/03/17,5,0,0,0,5
2913,2023/03/17,11,6,2,3,13
2914,2023/03/17,9,0,0,0,9
3015,2023/03/17,2,0,0,0,2
3033,2023/03/17,5,0,0,0,5
3035,2023/03/17,4,0,0,0,4
4446,2023/03/17,10,12,5,0,15
12136,2023/03/17,41,42,36,0,77
12516,2023/03/17,11,8,3,0,14
12518,2023/03/17,12,12,10,0,22
12523,2023/03/17,13,12,3,0,16
16062,2023/03/17,8,0,0,0,8
16276,2023/03/17,2,0,0,0,2
19322,2023/03/17,7,0,0,0,7
19329,2023/03/17,8,0,0,0,8
19520,2023/03/17,4,8,0,0,4
19521,2023/03/17,14,0,5,0,19
20920,2023/03/17,18,0,0,0,18
21097,2023/03/17,7,0,0,0,7
21103,2023/03/17,2,10,2,0,4
21132,2023/03/17,22,39,18,0,40
21171,2023/03/17,6,0,1,0,7
21174,2023/03/17,21,20,15,0,36
21175,2023/03/17,3,12,11,0,14
21176,2023/03/17,10,8,2,0,12
75,2023/03/18,28,0,29,0,57
76,2023/03/18,62,0,27,0,89
99,2023/03/18,7,0,0,0,7
117,2023/03/18,6,0,3,4,9
118,2023/03/18,8,0,2,0,10
119,2023/03/18,3,0,2,0,5
120,2023/03/18,4,0,0,0,4
184,2023/03/18,33,0,19,4,52
195,2023/03/18,41,0,25,1,66
218,2023/03/18,41,36,28,0,69
296,2023/03/18,5,0,4,0,9
300,2023/03/18,14,0,4,0,18
304,2023/03/18,6,0,2,0,8
317,2023/03/18,15,0,2,0,17
343,2023/03/18,9,0,3,1,12
353,2023/03/18,5,0,0,0,5
373,2023/03/18,0,0,2,0,2
374,2023/03/18,9,0,5,0,14
388,2023/03/18,32,0,14,0,46
419,2023/03/18,7,0,1,0,8
420,2023/03/18,1,0,0,0,1
462,2023/03/18,17,0,6,0,23
519,2023/03/18,12,0,6,4,18
525,2023/03/18,8,0,1,1,9
596,2023/03/18,-3,0,6,0,3
597,2023/03/18,12,0,9,0,21
598,2023/03/18,5,0,2,0,7
1035,2023/03/18,9,0,3,0,12
1084,2023/03/18,9,0,12,0,21
1112,2023/03/18,9,0,1,0,10
1113,2023/03/18,9,0,1,0,10
1114,2023/03/18,6,0,6,0,12
1115,2023/03/18,12,0,2,0,14
1117,2023/03/18,8,0,0,0,8
1118,2023/03/18,9,0,1,0,10
1119,2023/03/18,5,0,0,0,5
1692,2023/03/18,11,0,5,0,16
1693,2023/03/18,6,0,6,0,12
1747,2023/03/18,28,30,15,0,43
1772,2023/03/18,12,0,2,0,14
1773,2023/03/18,7,0,2,0,9
1774,2023/03/18,6,0,0,0,6
1782,2023/03/18,35,24,15,0,50
1795,2023/03/18,33,0,15,0,48
1914,2023/03/18,6,0,0,0,6
1915,2023/03/18,14,0,2,0,16
1923,2023/03/18,3,0,1,0,4
1934,2023/03/18,7,0,1,0,8
1963,2023/03/18,12,0,7,0,19
1984,2023/03/18,10,0,1,0,11
2135,2023/03/18,11,0,2,0,13
2136,2023/03/18,8,0,0,0,8
2148,2023/03/18,10,0,2,0,12
2183,2023/03/18,20,0,2,0,22
2193,2023/03/18,23,21,7,0,30
2237,2023/03/18,1,0,0,0,1
2358,2023/03/18,6,0,4,0,10
2361,2023/03/18,14,7,4,0,18
2445,2023/03/18,13,6,9,1,22
2449,2023/03/18,7,0,6,0,13
2451,2023/03/18,34,0,5,0,39
2475,2023/03/18,8,0,0,0,8
2476,2023/03/18,8,0,2,0,10
2507,2023/03/18,36,0,6,0,42
2525,2023/03/18,9,0,4,0,13
2562,2023/03/18,12,0,5,0,17
2582,2023/03/18,13,0,3,0,16
2586,2023/03/18,7,0,11,0,18
2602,2023/03/18,8,0,0,0,8
2631,2023/03/18,0,0,0,0,0
2685,2023/03/18,2,4,5,0,7
2723,2023/03/18,8,0,0,0,8
2730,2023/03/18,6,0,2,0,8
2731,2023/03/18,10,0,0,0,10
2732,2023/03/18,8,0,1,0,9
2734,2023/03/18,5,0,3,0,8
2735,2023/03/18,22,0,1,0,23
2761,2023/03/18,0,10,9,0,9
2788,2023/03/18,25,0,18,0,43
2802,2023/03/18,8,0,0,0,8
2812,2023/03/18,11,0,1,0,12
2813,2023/03/18,10,0,0,0,10
2814,2023/03/18,5,0,3,0,8
2913,2023/03/18,6,0,3,0,9
2914,2023/03/18,9,0,2,0,11
3015,2023/03/18,2,0,1,0,3
3035,2023/03/18,4,0,0,0,4
4446,2023/03/18,17,12,5,0,22
12136,2023/03/18,23,15,10,0,33
12516,2023/03/18,12,0,3,0,15
12518,2023/03/18,10,0,3,0,13
12523,2023/03/18,14,0,4,0,18
16062,2023/03/18,8,0,1,0,9
16276,2023/03/18,2,0,2,0,4
19322,2023/03/18,7,0,1,0,8
19329,2023/03/18,8,0,2,0,10
19520,2023/03/18,12,0,1,0,13
19521,2023/03/18,9,0,4,0,13
20920,2023/03/18,18,0,0,0,18
21097,2023/03/18,7,0,1,0,8
21099,2023/03/18,6,0,2,0,8
21103,2023/03/18,10,0,2,0,12
21132,2023/03/18,22,0,6,1,28
21171,2023/03/18,5,0,0,1,5
21174,2023/03/18,18,12,7,0,25
21175,2023/03/18,4,12,5,0,9
21176,2023/03/18,12,4,3,0,15
75,2023/03/19,41,44,29,0,70
76,2023/03/19,75,40,26,10,101
99,2023/03/19,7,0,0,0,7
117,2023/03/19,-1,0,1,1,0
118,2023/03/19,6,0,6,0,12
119,2023/03/19,1,0,0,0,1
120,2023/03/19,4,0,0,0,4
184,2023/03/19,16,6,4,0,20
195,2023/03/19,42,27,19,2,61
218,2023/03/19,40,27,25,6,65
296,2023/03/19,9,8,2,0,11
300,2023/03/19,10,0,1,0,11
304,2023/03/19,8,4,4,0,12
317,2023/03/19,19,6,5,0,24
343,2023/03/19,5,0,2,0,7
353,2023/03/19,5,0,0,0,5
373,2023/03/19,4,6,3,0,7
374,2023/03/19,12,8,2,2,14
388,2023/03/19,36,18,14,2,50
419,2023/03/19,12,6,4,1,16
420,2023/03/19,7,6,2,0,9
462,2023/03/19,19,8,7,0,26
519,2023/03/19,8,6,6,0,14
525,2023/03/19,6,0,1,0,7
596,2023/03/19,-1,8,2,0,1
597,2023/03/19,15,12,7,0,22
598,2023/03/19,9,6,3,0,12
1035,2023/03/19,12,6,6,0,18
1084,2023/03/19,12,15,8,0,20
1112,2023/03/19,8,0,1,0,9
1113,2023/03/19,8,0,1,0,9
1114,2023/03/19,6,6,7,0,13
1115,2023/03/19,16,6,0,0,16
1117,2023/03/19,8,0,0,0,8
1118,2023/03/19,8,0,0,0,8
1119,2023/03/19,5,0,0,0,5
1692,2023/03/19,12,6,5,0,17
1693,2023/03/19,0,0,0,0,0
1747,2023/03/19,33,20,22,0,55
1772,2023/03/19,10,0,1,0,11
1773,2023/03/19,5,0,1,0,6
1774,2023/03/19,6,0,0,0,6
1782,2023/03/19,38,18,11,1,49
1795,2023/03/19,18,0,12,0,30
1914,2023/03/19,6,0,0,0,6
1915,2023/03/19,12,0,1,0,13
1923,2023/03/19,8,6,1,0,9
1934,2023/03/19,6,0,0,0,6
1963,2023/03/19,11,6,3,0,14
1984,2023/03/19,9,0,4,0,13
2135,2023/03/19,9,0,3,0,12
2136,2023/03/19,8,0,4,0,12
2148,2023/03/19,16,8,2,0,18
2183,2023/03/19,24,6,12,0,36
2193,2023/03/19,27,12,7,14,34
2237,2023/03/19,7,6,3,0,10
2358,2023/03/19,14,12,5,0,19
2361,2023/03/19,17,7,5,0,22
2445,2023/03/19,9,6,9,0,18
2449,2023/03/19,7,6,0,0,7
2451,2023/03/19,79,50,5,0,84
2475,2023/03/19,8,0,1,0,9
2476,2023/03/19,6,0,1,0,7
2507,2023/03/19,30,0,9,0,39
2525,2023/03/19,5,0,2,0,7
2562,2023/03/19,7,0,3,0,10
2582,2023/03/19,10,0,2,0,12
2586,2023/03/19,16,20,12,0,28
2602,2023/03/19,8,0,0,0,8
2631,2023/03/19,6,6,3,0,9
2685,2023/03/19,5,8,4,0,9
2723,2023/03/19,8,0,0,0,8
2730,2023/03/19,10,6,3,0,13
2731,2023/03/19,10,0,5,0,15
2732,2023/03/19,7,0,2,0,9
2734,2023/03/19,10,8,1,0,11
2735,2023/03/19,21,0,4,0,25
2761,2023/03/19,11,20,4,0,15
2788,2023/03/19,23,16,10,8,33
2802,2023/03/19,8,0,0,0,8
2812,2023/03/19,10,0,1,0,11
2813,2023/03/19,10,0,1,0,11
2814,2023/03/19,8,6,2,0,10
2913,2023/03/19,9,6,0,0,9
2914,2023/03/19,7,0,1,0,8
3015,2023/03/19,9,8,6,0,15
3035,2023/03/19,10,6,1,0,11
4446,2023/03/19,24,12,13,1,37
12136,2023/03/19,34,24,23,1,57
12516,2023/03/19,13,4,2,0,15
12518,2023/03/19,11,4,0,0,11
12523,2023/03/19,26,16,9,0,35
16062,2023/03/19,7,0,1,0,8
16276,2023/03/19,4,4,1,0,5
19322,2023/03/19,6,0,2,0,8
19329,2023/03/19,6,0,1,0,7
19520,2023/03/19,11,0,2,0,13
19521,2023/03/19,5,0,1,0,6
20920,2023/03/19,18,0,0,0,18
21097,2023/03/19,6,0,0,0,6
21099,2023/03/19,4,0,0,0,4
21103,2023/03/19,8,0,1,0,9
21132,2023/03/19,27,12,13,8,40
21171,2023/03/19,4,0,0,0,4
21174,2023/03/19,23,12,6,0,29
21175,2023/03/19,11,12,5,0,16
21176,2023/03/19,13,4,3,5,16
75,2023/03/20,52,40,29,6,81
76,2023/03/20,79,40,35,3,114
99,2023/03/20,7,0,0,0,7
117,2023/03/20,-3,0,1,0,-2
118,2023/03/20,0,0,0,0,0
119,2023/03/20,5,4,1,0,6
120,2023/03/20,8,4,2,0,10
184,2023/03/20,15,3,5,2,20
195,2023/03/20,54,33,26,1,80
218,2023/03/20,40,30,31,0,71
296,2023/03/20,15,8,11,0,26
300,2023/03/20,9,0,1,0,10
304,2023/03/20,8,4,3,0,11
317,2023/03/20,20,6,14,5,34
343,2023/03/20,3,0,1,0,4
353,2023/03/20,5,0,1,0,6
373,2023/03/20,7,6,4,0,11
374,2023/03/20,16,8,4,0,20
388,2023/03/20,38,18,6,2,44
419,2023/03/20,13,6,10,0,23
420,2023/03/20,5,0,4,0,9
462,2023/03/20,20,8,6,0,26
519,2023/03/20,8,6,4,0,12
525,2023/03/20,5,0,1,0,6
596,2023/03/20,1,4,3,0,4
597,2023/03/20,26,18,7,0,33
598,2023/03/20,6,0,0,0,6
1035,2023/03/20,6,0,1,0,7
1084,2023/03/20,14,10,6,0,20
1112,2023/03/20,7,0,1,0,8
1113,2023/03/20,7,0,0,0,7
1114,2023/03/20,5,6,1,0,6
1115,2023/03/20,16,0,2,0,18
1117,2023/03/20,8,0,0,0,8
1118,2023/03/20,8,0,2,0,10
1119,2023/03/20,5,0,0,0,5
1692,2023/03/20,13,6,6,0,19
1693,2023/03/20,6,6,6,0,12
1747,2023/03/20,31,20,16,1,47
1772,2023/03/20,9,0,1,0,10
1773,2023/03/20,4,0,0,0,4
1774,2023/03/20,14,8,0,0,14
1782,2023/03/20,50,24,8,11,58
1795,2023/03/20,20,14,4,0,24
1914,2023/03/20,6,0,0,0,6
1915,2023/03/20,11,0,2,0,13
1923,2023/03/20,7,0,2,0,9
1934,2023/03/20,11,5,2,0,13
1963,2023/03/20,20,12,14,0,34
1984,2023/03/20,5,0,3,0,8
2135,2023/03/20,6,0,2,0,8
2136,2023/03/20,4,0,0,0,4
2148,2023/03/20,14,0,2,0,16
2183,2023/03/20,12,0,4,3,16
2193,2023/03/20,18,12,18,0,36
2237,2023/03/20,10,6,2,0,12
2358,2023/03/20,9,0,8,0,17
2361,2023/03/20,19,7,2,0,21
2445,2023/03/20,0,0,0,0,0
2449,2023/03/20,7,0,3,0,10
2451,2023/03/20,74,0,13,0,87
2475,2023/03/20,7,0,0,0,7
2476,2023/03/20,5,0,0,0,5
2507,2023/03/20,27,6,7,0,34
2525,2023/03/20,3,0,0,0,3
2562,2023/03/20,4,0,4,0,8
2582,2023/03/20,8,0,2,0,10
2586,2023/03/20,20,16,19,0,39
2602,2023/03/20,8,0,0,0,8
2631,2023/03/20,3,0,4,0,7
2685,2023/03/20,9,8,4,0,13
2723,2023/03/20,8,0,0,0,8
2730,2023/03/20,7,0,1,0,8
2731,2023/03/20,5,0,3,0,8
2732,2023/03/20,5,0,1,0,6
2734,2023/03/20,9,0,0,0,9
2735,2023/03/20,17,0,1,0,18
2761,2023/03/20,27,20,12,1,39
2788,2023/03/20,17,12,7,4,24
2802,2023/03/20,8,0,0,0,8
2812,2023/03/20,9,0,0,0,9
2813,2023/03/20,9,0,1,0,10
2814,2023/03/20,6,0,1,0,7
2913,2023/03/20,9,0,2,0,11
2914,2023/03/20,6,0,1,0,7
3015,2023/03/20,3,0,2,0,5
3035,2023/03/20,9,0,0,0,9
4446,2023/03/20,22,12,10,6,32
12136,2023/03/20,37,27,28,0,65
12516,2023/03/20,11,0,3,0,14
12518,2023/03/20,11,0,5,0,16
12523,2023/03/20,17,0,4,0,21
16062,2023/03/20,6,0,3,0,9
16063,2023/03/20,6,6,2,0,8
16276,2023/03/20,3,0,1,0,4
19322,2023/03/20,4,0,0,0,4
19329,2023/03/20,5,0,2,0,7
19520,2023/03/20,9,0,0,0,9
19521,2023/03/20,12,8,1,0,13
20920,2023/03/20,18,0,0,0,18
21097,2023/03/20,6,0,0,0,6
21103,2023/03/20,7,0,1,0,8
21132,2023/03/20,24,18,22,0,46
21171,2023/03/20,8,4,2,0,10
21174,2023/03/20,29,12,5,0,34
21175,2023/03/20,18,12,9,8,27
21176,2023/03/20,5,0,3,0,8
21570,2023/03/20,6,6,1,0,7
21577,2023/03/20,8,8,3,0,11
21578,2023/03/20,8,8,5,0,13
75,2023/03/21,57,72,41,14,98
76,2023/03/21,81,40,36,13,117
99,2023/03/21,7,0,1,0,8
117,2023/03/21,0,8,3,0,3
118,2023/03/21,4,8,2,0,6
119,2023/03/21,8,4,1,0,9
120,2023/03/21,6,0,2,0,8
184,2023/03/21,8,15,6,0,14
195,2023/03/21,57,60,35,8,92
218,2023/03/21,38,30,33,0,71
296,2023/03/21,8,8,1,0,9
300,2023/03/21,12,8,0,0,12
304,2023/03/21,9,4,4,0,13
317,2023/03/21,7,6,5,0,12
343,2023/03/21,2,0,0,0,2
353,2023/03/21,4,0,1,0,5
373,2023/03/21,3,6,5,0,8
374,2023/03/21,12,8,11,0,23
388,2023/03/21,48,45,15,10,63
419,2023/03/21,9,12,6,0,15
420,2023/03/21,7,6,5,0,12
462,2023/03/21,23,8,5,0,28
519,2023/03/21,10,12,2,0,12
525,2023/03/21,4,0,0,0,4
596,2023/03/21,6,12,3,0,9
597,2023/03/21,31,30,10,0,41
598,2023/03/21,6,6,3,0,9
1035,2023/03/21,5,6,0,0,5
1084,2023/03/21,18,25,8,3,26
1112,2023/03/21,6,0,1,0,7
1113,2023/03/21,7,6,0,0,7
1114,2023/03/21,10,12,2,0,12
1115,2023/03/21,14,0,5,0,19
1117,2023/03/21,8,0,2,0,10
1118,2023/03/21,6,0,1,0,7
1119,2023/03/21,11,6,1,0,12
1692,2023/03/21,7,0,5,0,12
1693,2023/03/21,6,6,3,0,9
1747,2023/03/21,39,40,20,2,59
1772,2023/03/21,8,0,2,0,10
1773,2023/03/21,10,6,0,0,10
1774,2023/03/21,14,0,1,0,15
1782,2023/03/21,43,27,15,9,58
1795,2023/03/21,30,28,13,0,43
1914,2023/03/21,6,0,2,0,8
1915,2023/03/21,9,0,0,0,9
1923,2023/03/21,5,0,0,0,5
1934,2023/03/21,9,0,1,2,10
1963,2023/03/21,12,18,9,0,21
1984,2023/03/21,2,0,0,0,2
2135,2023/03/21,4,6,3,0,7
2136,2023/03/21,4,6,1,0,5
2148,2023/03/21,12,0,1,0,13
2183,2023/03/21,5,0,3,0,8
2193,2023/03/21,18,18,26,0,44
2237,2023/03/21,8,0,3,0,11
2358,2023/03/21,1,8,0,0,1
2361,2023/03/21,24,7,6,0,30
2445,2023/03/21,6,12,0,0,6
2449,2023/03/21,16,12,4,0,20
2451,2023/03/21,61,0,16,0,77
2475,2023/03/21,7,0,1,0,8
2476,2023/03/21,11,6,1,0,12
2507,2023/03/21,26,6,9,6,35
2525,2023/03/21,3,6,0,0,3
2562,2023/03/21,12,12,6,0,18
2582,2023/03/21,6,0,1,0,7
2586,2023/03/21,17,16,21,1,38
2602,2023/03/21,8,0,0,0,8
2631,2023/03/21,5,6,2,0,7
2685,2023/03/21,13,8,5,0,18
2723,2023/03/21,8,0,3,0,11
2730,2023/03/21,6,6,1,0,7
2731,2023/03/21,2,6,1,0,3
2732,2023/03/21,4,8,1,0,5
2734,2023/03/21,9,4,1,0,10
2735,2023/03/21,16,0,4,0,20
2761,2023/03/21,24,35,16,0,40
2788,2023/03/21,30,40,24,3,54
2812,2023/03/21,9,0,3,0,12
2813,2023/03/21,8,0,2,0,10
2814,2023/03/21,5,0,0,0,5
2913,2023/03/21,7,0,0,0,7
2914,2023/03/21,5,0,0,0,5
3015,2023/03/21,1,8,2,0,3
3035,2023/03/21,9,0,1,0,10
4446,2023/03/21,15,9,10,3,25
12136,2023/03/21,39,66,34,0,73
12516,2023/03/21,8,4,2,0,10
12518,2023/03/21,10,4,6,0,16
12523,2023/03/21,13,4,4,0,17
16062,2023/03/21,3,0,0,0,3
16063,2023/03/21,10,6,4,0,14
16276,2023/03/21,2,4,1,0,3
19322,2023/03/21,4,6,1,0,5
19329,2023/03/21,3,0,1,0,4
19520,2023/03/21,9,0,1,0,10
19521,2023/03/21,11,0,1,0,12
20920,2023/03/21,18,0,0,0,18
21097,2023/03/21,6,0,0,0,6
21103,2023/03/21,6,0,0,0,6
21132,2023/03/21,21,33,16,0,37
21171,2023/03/21,10,4,1,0,11
21174,2023/03/21,36,12,15,12,51
21175,2023/03/21,13,12,7,2,20
21176,2023/03/21,2,0,0,0,2
21570,2023/03/21,5,6,0,0,5
21577,2023/03/21,5,4,1,0,6
21578,2023/03/21,3,4,0,0,3
75,2023/03/22,38,0,35,1,73
76,2023/03/22,48,36,44,3,92
99,2023/03/22,6,0,0,0,6
117,2023/03/22,1,0,2,0,3
118,2023/03/22,6,0,6,0,12
119,2023/03/22,7,0,3,0,10
120,2023/03/22,4,0,0,0,4
184,2023/03/22,16,0,10,0,26
195,2023/03/22,42,0,35,5,77
218,2023/03/22,27,30,27,0,54
296,2023/03/22,11,0,10,0,21
300,2023/03/22,16,0,4,0,20
304,2023/03/22,5,0,3,0,8
317,2023/03/22,2,0,2,0,4
343,2023/03/22,2,0,0,0,2
353,2023/03/22,3,0,0,0,3
373,2023/03/22,4,0,6,0,10
374,2023/03/22,9,0,6,0,15
388,2023/03/22,34,0,26,3,60
419,2023/03/22,9,0,8,0,17
420,2023/03/22,2,0,1,0,3
462,2023/03/22,17,0,6,1,23
519,2023/03/22,14,0,9,0,23
525,2023/03/22,4,0,1,2,5
596,2023/03/22,7,0,5,0,12
597,2023/03/22,39,0,10,0,49
598,2023/03/22,9,0,5,0,14
1035,2023/03/22,11,0,5,0,16
1084,2023/03/22,22,0,6,0,28
1111,2023/03/22,15,0,1,0,16
1112,2023/03/22,5,0,0,0,5
1113,2023/03/22,13,0,0,0,13
1114,2023/03/22,14,0,1,0,15
1115,2023/03/22,9,0,2,0,11
1117,2023/03/22,6,0,1,0,7
1118,2023/03/22,5,0,0,0,5
1119,2023/03/22,10,0,1,0,11
1692,2023/03/22,2,0,0,0,2
1693,2023/03/22,3,0,2,0,5
1747,2023/03/22,32,0,21,0,53
1772,2023/03/22,6,0,0,0,6
1773,2023/03/22,10,0,0,0,10
1774,2023/03/22,13,0,3,0,16
1782,2023/03/22,34,0,23,3,57
1795,2023/03/22,31,0,20,1,51
1914,2023/03/22,4,0,2,0,6
1915,2023/03/22,9,0,0,0,9
1923,2023/03/22,5,0,0,0,5
1934,2023/03/22,6,0,2,2,8
1963,2023/03/22,15,0,11,0,26
1984,2023/03/22,2,0,0,1,2
2135,2023/03/22,7,0,0,0,7
2136,2023/03/22,9,0,2,0,11
2148,2023/03/22,11,0,6,1,17
2183,2023/03/22,2,0,1,0,3
2193,2023/03/22,13,21,18,0,31
2237,2023/03/22,5,0,1,0,6
2358,2023/03/22,9,0,3,0,12
2361,2023/03/22,18,0,5,0,23
2445,2023/03/22,12,0,4,0,16
2449,2023/03/22,12,0,8,0,20
2451,2023/03/22,45,0,10,18,55
2475,2023/03/22,6,0,0,0,6
2476,2023/03/22,10,0,0,0,10
2507,2023/03/22,13,0,6,3,19
2525,2023/03/22,9,0,1,0,10
2562,2023/03/22,6,0,4,0,10
2582,2023/03/22,5,0,0,0,5
2586,2023/03/22,19,24,11,0,30
2602,2023/03/22,8,0,2,0,10
2631,2023/03/22,3,0,3,0,6
2685,2023/03/22,12,4,1,0,13
2723,2023/03/22,5,0,2,0,7
2730,2023/03/22,11,0,1,0,12
2731,2023/03/22,7,0,0,0,7
2732,2023/03/22,11,0,1,0,12
2734,2023/03/22,12,0,1,0,13
2735,2023/03/22,12,0,5,0,17
2761,2023/03/22,33,0,13,0,46
2788,2023/03/22,22,0,16,6,38
2812,2023/03/22,6,0,0,0,6
2813,2023/03/22,6,0,0,0,6
2814,2023/03/22,5,0,2,0,7
2913,2023/03/22,7,0,4,0,11
2914,2023/03/22,5,0,0,0,5
3015,2023/03/22,7,0,0,0,7
3035,2023/03/22,8,0,0,0,8
4446,2023/03/22,2,0,2,0,4
12136,2023/03/22,34,0,29,1,63
12516,2023/03/22,10,0,2,0,12
12518,2023/03/22,4,0,2,0,6
12523,2023/03/22,13,0,5,0,18
16062,2023/03/22,3,0,0,0,3
16063,2023/03/22,6,0,1,0,7
16276,2023/03/22,5,0,3,0,8
19322,2023/03/22,9,0,0,0,9
19329,2023/03/22,2,0,0,0,2
19520,2023/03/22,8,0,1,0,9
19521,2023/03/22,10,0,0,0,10
20920,2023/03/22,18,0,1,0,19
21097,2023/03/22,6,0,0,0,6
21103,2023/03/22,6,0,1,0,7
21132,2023/03/22,16,0,14,0,30
21171,2023/03/22,5,0,1,0,6
21174,2023/03/22,17,8,8,0,25
21175,2023/03/22,16,12,12,0,28
21176,2023/03/22,10,8,4,0,14
21570,2023/03/22,11,0,0,0,11
21577,2023/03/22,8,0,6,0,14
21578,2023/03/22,7,0,7,0,14
75,2023/03/23,50,48,58,0,108
76,2023/03/23,37,36,44,0,81
99,2023/03/23,6,0,0,0,6
117,2023/03/23,-1,0,0,0,-1
118,2023/03/23,4,4,4,0,8
119,2023/03/23,8,4,4,0,12
120,2023/03/23,4,0,0,0,4
184,2023/03/23,21,15,15,0,36
195,2023/03/23,36,33,34,0,70
218,2023/03/23,30,30,35,2,65
296,2023/03/23,1,0,0,0,1
300,2023/03/23,16,4,5,1,21
304,2023/03/23,6,4,4,0,10
317,2023/03/23,6,6,6,0,12
343,2023/03/23,6,4,2,0,8
353,2023/03/23,3,0,0,0,3
373,2023/03/23,-2,0,0,0,-2
374,2023/03/23,3,0,4,0,7
388,2023/03/23,23,18,17,2,40
419,2023/03/23,1,0,0,0,1
420,2023/03/23,1,0,0,0,1
462,2023/03/23,18,8,5,0,23
519,2023/03/23,11,6,10,0,21
525,2023/03/23,1,0,0,0,1
596,2023/03/23,10,8,4,2,14
597,2023/03/23,35,6,17,0,52
598,2023/03/23,4,0,0,0,4
1035,2023/03/23,12,6,1,0,13
1084,2023/03/23,26,10,12,7,38
1111,2023/03/23,14,0,1,0,15
1113,2023/03/23,13,0,0,0,13
1114,2023/03/23,13,0,2,0,15
1115,2023/03/23,7,0,0,0,7
1117,2023/03/23,5,0,0,0,5
1118,2023/03/23,11,6,0,0,11
1119,2023/03/23,9,0,1,0,10
1692,2023/03/23,8,6,6,0,14
1693,2023/03/23,1,0,1,0,2
1747,2023/03/23,31,20,11,0,42
1772,2023/03/23,6,0,0,0,6
1773,2023/03/23,10,0,0,0,10
1774,2023/03/23,10,0,1,0,11
1782,2023/03/23,26,18,19,5,45
1795,2023/03/23,17,7,17,0,34
1914,2023/03/23,2,0,0,0,2
1915,2023/03/23,9,0,1,0,10
1923,2023/03/23,5,0,1,0,6
1934,2023/03/23,7,5,3,0,10
1963,2023/03/23,10,6,10,0,20
1984,2023/03/23,7,6,4,0,11
2135,2023/03/23,7,0,1,0,8
2136,2023/03/23,7,0,1,0,8
2148,2023/03/23,4,0,3,0,7
2183,2023/03/23,7,6,3,0,10
2193,2023/03/23,14,18,17,0,31
2237,2023/03/23,10,6,4,0,14
2358,2023/03/23,6,0,5,0,11
2361,2023/03/23,13,0,7,0,20
2445,2023/03/23,14,6,6,0,20
2449,2023/03/23,10,6,9,0,19
2451,2023/03/23,18,0,9,0,27
2476,2023/03/23,10,0,1,0,11
2507,2023/03/23,16,12,10,2,26
2525,2023/03/23,8,0,1,0,9
2562,2023/03/23,8,6,8,0,16
2582,2023/03/23,9,4,2,0,11
2586,2023/03/23,24,16,12,0,36
2602,2023/03/23,6,0,0,0,6
2631,2023/03/23,6,6,3,0,9
2685,2023/03/23,19,8,10,5,29
2723,2023/03/23,3,0,0,0,3
2730,2023/03/23,10,0,0,0,10
2731,2023/03/23,7,0,1,0,8
2732,2023/03/23,10,0,0,0,10
2734,2023/03/23,11,0,4,0,15
2735,2023/03/23,11,4,3,2,14
2761,2023/03/23,40,20,14,8,54
2788,2023/03/23,20,20,26,0,46
2812,2023/03/23,6,0,0,0,6
2813,2023/03/23,6,0,1,0,7
2814,2023/03/23,9,6,4,0,13
2913,2023/03/23,3,0,2,1,5
2914,2023/03/23,11,6,0,0,11
3015,2023/03/23,15,8,0,0,15
3033,2023/03/23,5,0,0,0,5
3035,2023/03/23,8,0,0,0,8
4446,2023/03/23,15,15,11,0,26
12136,2023/03/23,31,27,31,0,62
12516,2023/03/23,8,0,3,0,11
12518,2023/03/23,2,0,1,0,3
12523,2023/03/23,8,0,3,0,11
16062,2023/03/23,9,6,1,0,10
16063,2023/03/23,5,0,2,0,7
16276,2023/03/23,2,0,1,0,3
19322,2023/03/23,9,0,0,0,9
19329,2023/03/23,8,6,0,0,8
19520,2023/03/23,7,0,1,0,8
19521,2023/03/23,10,0,0,0,10
20920,2023/03/23,17,0,0,0,17
21097,2023/03/23,6,0,0,0,6
21103,2023/03/23,5,0,1,0,6
21132,2023/03/23,23,21,24,0,47
21171,2023/03/23,4,0,1,0,5
21174,2023/03/23,9,0,7,0,16
21175,2023/03/23,5,0,2,6,7
21176,2023/03/23,14,8,7,0,21
21570,2023/03/23,11,0,0,0,11
21577,2023/03/23,2,0,0,0,2
21578,2023/03/23,0,0,0,0,0
75,2023/03/24,29,36,30,0,59
76,2023/03/24,30,40,31,0,61
99,2023/03/24,6,0,1,0,7
117,2023/03/24,3,4,2,0,5
118,2023/03/24,0,0,0,0,0
119,2023/03/24,4,0,2,0,6
120,2023/03/24,0,0,0,0,0
149,2023/03/24,7,0,2,0,9
184,2023/03/24,18,12,18,0,36
195,2023/03/24,31,30,29,0,60
218,2023/03/24,23,30,25,0,48
296,2023/03/24,9,8,6,0,15
300,2023/03/24,10,0,7,0,17
304,2023/03/24,6,4,1,0,7
317,2023/03/24,12,12,12,0,24
343,2023/03/24,4,0,2,0,6
353,2023/03/24,9,6,0,0,9
373,2023/03/24,6,6,5,0,11
374,2023/03/24,3,4,4,0,7
388,2023/03/24,10,6,12,0,22
419,2023/03/24,6,6,4,0,10
420,2023/03/24,6,6,3,0,9
462,2023/03/24,13,0,6,1,19
519,2023/03/24,14,12,8,0,22
525,2023/03/24,5,5,1,0,6
596,2023/03/24,17,12,7,0,24
597,2023/03/24,42,24,20,10,62
598,2023/03/24,4,0,1,0,5
1035,2023/03/24,12,6,5,0,17
1084,2023/03/24,27,20,12,0,39
1111,2023/03/24,13,0,1,0,14
1113,2023/03/24,13,0,1,0,14
1114,2023/03/24,17,6,4,0,21
1115,2023/03/24,13,6,2,0,15
1117,2023/03/24,5,0,0,0,5
1118,2023/03/24,11,0,2,0,13
1119,2023/03/24,8,0,1,0,9
1692,2023/03/24,6,6,5,0,11
1693,2023/03/24,6,6,3,0,9
1747,2023/03/24,35,15,32,0,67
1772,2023/03/24,14,8,1,0,15
1773,2023/03/24,10,0,0,0,10
1774,2023/03/24,9,0,1,0,10
1782,2023/03/24,21,18,18,0,39
1795,2023/03/24,22,21,27,0,49
1914,2023/03/24,8,6,2,0,10
1915,2023/03/24,8,0,1,0,9
1923,2023/03/24,10,6,1,0,11
1934,2023/03/24,4,0,3,0,7
1963,2023/03/24,6,6,7,0,13
1984,2023/03/24,9,6,2,0,11
2135,2023/03/24,12,6,3,0,15
2136,2023/03/24,6,0,0,0,6
2148,2023/03/24,5,4,4,0,9
2183,2023/03/24,8,6,4,0,12
2193,2023/03/24,13,18,13,0,26
2237,2023/03/24,12,6,3,0,15
2358,2023/03/24,5,4,2,0,7
2361,2023/03/24,13,7,9,1,22
2445,2023/03/24,14,12,6,0,20
2449,2023/03/24,6,6,6,0,12
2451,2023/03/24,28,20,16,0,44
2476,2023/03/24,9,0,0,0,9
2507,2023/03/24,9,6,11,0,20
2525,2023/03/24,7,0,0,0,7
2562,2023/03/24,6,6,2,0,8
2582,2023/03/24,7,0,6,0,13
2586,2023/03/24,32,20,19,0,51
2602,2023/03/24,6,0,1,0,7
2631,2023/03/24,9,6,7,0,16
2685,2023/03/24,12,8,6,1,18
2723,2023/03/24,3,0,0,0,3
2730,2023/03/24,10,0,1,0,11
2731,2023/03/24,6,0,0,0,6
2732,2023/03/24,10,0,2,0,12
2734,2023/03/24,7,0,2,0,9
2735,2023/03/24,6,0,2,0,8
2761,2023/03/24,38,20,14,6,52
2788,2023/03/24,10,16,11,0,21
2802,2023/03/24,8,0,2,0,10
2812,2023/03/24,12,6,0,0,12
2813,2023/03/24,5,0,1,0,6
2814,2023/03/24,5,0,0,0,5
2913,2023/03/24,6,6,2,0,8
2914,2023/03/24,11,0,1,0,12
3015,2023/03/24,15,0,1,0,16
3033,2023/03/24,5,0,0,0,5
3035,2023/03/24,8,0,1,0,9
4446,2023/03/24,16,12,15,0,31
12136,2023/03/24,35,33,34,0,69
12516,2023/03/24,5,0,3,0,8
12518,2023/03/24,9,8,5,0,14
12523,2023/03/24,9,4,3,0,12
16062,2023/03/24,8,0,1,0,9
16063,2023/03/24,9,6,2,0,11
16276,2023/03/24,5,4,5,0,10
19322,2023/03/24,9,0,1,0,10
19329,2023/03/24,8,0,0,0,8
19520,2023/03/24,6,0,1,0,7
19521,2023/03/24,10,0,1,0,11
20920,2023/03/24,17,0,0,0,17
21097,2023/03/24,6,0,0,0,6
21103,2023/03/24,14,10,0,0,14
21132,2023/03/24,18,21,20,0,38
21171,2023/03/24,7,4,3,0,10
21174,2023/03/24,10,8,8,0,18
21175,2023/03/24,12,16,9,0,21
21176,2023/03/24,11,4,7,2,18
21570,2023/03/24,11,0,3,0,14
21577,2023/03/24,2,0,2,0,4
21578,2023/03/24,8,8,2,0,10
75,2023/03/25,31,32,40,0,71
76,2023/03/25,30,32,42,0,72
99,2023/03/25,5,0,0,0,5
117,2023/03/25,5,4,5,0,10
118,2023/03/25,4,4,4,0,8
119,2023/03/25,2,0,0,0,2
120,2023/03/25,4,4,0,0,4
149,2023/03/25,5,0,0,0,5
184,2023/03/25,12,12,13,0,25
195,2023/03/25,29,27,47,0,76
218,2023/03/25,28,30,31,0,59
296,2023/03/25,7,4,5,0,12
300,2023/03/25,3,0,0,0,3
304,2023/03/25,9,4,1,0,10
317,2023/03/25,6,6,6,0,12
343,2023/03/25,6,4,1,0,7
353,2023/03/25,9,0,0,0,9
373,2023/03/25,7,6,7,0,14
374,2023/03/25,7,8,6,0,13
388,2023/03/25,16,18,15,0,31
419,2023/03/25,8,6,8,0,16
420,2023/03/25,3,0,3,0,6
462,2023/03/25,14,8,6,0,20
519,2023/03/25,12,6,7,0,19
525,2023/03/25,4,0,1,0,5
596,2023/03/25,9,0,6,0,15
597,2023/03/25,12,0,5,0,17
598,2023/03/25,3,0,0,0,3
1035,2023/03/25,7,0,6,0,13
1084,2023/03/25,15,0,7,0,22
1111,2023/03/25,12,0,2,0,14
1113,2023/03/25,12,0,0,0,12
1114,2023/03/25,19,6,4,0,23
1115,2023/03/25,11,0,1,0,12
1117,2023/03/25,5,0,1,0,6
1118,2023/03/25,9,0,1,0,10
1119,2023/03/25,7,0,1,0,8
1692,2023/03/25,7,6,6,0,13
1693,2023/03/25,9,6,9,0,18
1747,2023/03/25,28,25,19,0,47
1772,2023/03/25,13,0,0,0,13
1773,2023/03/25,10,0,0,0,10
1774,2023/03/25,8,0,1,0,9
1782,2023/03/25,20,18,12,0,32
1795,2023/03/25,15,21,13,0,28
1914,2023/03/25,6,0,0,0,6
1915,2023/03/25,7,0,1,0,8
1923,2023/03/25,9,0,1,0,10
1934,2023/03/25,1,0,0,0,1
1963,2023/03/25,11,12,11,0,22
1984,2023/03/25,7,0,2,0,9
2135,2023/03/25,9,0,2,0,11
2136,2023/03/25,6,0,0,0,6
2148,2023/03/25,5,4,4,0,9
2183,2023/03/25,10,6,10,0,20
2193,2023/03/25,9,9,14,0,23
2237,2023/03/25,9,0,2,0,11
2358,2023/03/25,7,4,3,0,10
2361,2023/03/25,3,0,2,0,5
2445,2023/03/25,8,0,7,0,15
2449,2023/03/25,0,0,0,0,0
2451,2023/03/25,22,10,10,0,32
2476,2023/03/25,9,0,0,0,9
2507,2023/03/25,10,12,12,0,22
2525,2023/03/25,13,6,3,0,16
2562,2023/03/25,10,6,10,0,20
2582,2023/03/25,5,4,1,0,6
2586,2023/03/25,29,16,15,0,44
2602,2023/03/25,5,0,0,0,5
2631,2023/03/25,8,6,8,0,16
2685,2023/03/25,9,4,3,0,12
2723,2023/03/25,11,8,0,0,11
2730,2023/03/25,9,0,2,0,11
2731,2023/03/25,6,0,0,0,6
2732,2023/03/25,8,0,1,0,9
2734,2023/03/25,9,4,3,0,12
2735,2023/03/25,4,0,0,0,4
2761,2023/03/25,23,5,14,0,37
2788,2023/03/25,19,20,25,0,44
2802,2023/03/25,6,0,1,0,7
2812,2023/03/25,12,0,0,0,12
2813,2023/03/25,4,0,1,0,5
2814,2023/03/25,5,0,1,0,6
2913,2023/03/25,4,0,3,0,7
2914,2023/03/25,10,0,0,0,10
3015,2023/03/25,14,0,2,0,16
3035,2023/03/25,7,0,0,0,7
4446,2023/03/25,10,9,11,0,21
12136,2023/03/25,24,24,32,0,56
12516,2023/03/25,6,4,2,0,8
12518,2023/03/25,8,4,4,0,12
12523,2023/03/25,10,4,4,0,14
16062,2023/03/25,7,0,0,0,7
16063,2023/03/25,7,0,0,0,7
16276,2023/03/25,0,0,0,0,0
19322,2023/03/25,8,0,0,0,8
19329,2023/03/25,8,0,0,0,8
19520,2023/03/25,5,0,0,0,5
19521,2023/03/25,9,0,0,0,9
20920,2023/03/25,17,0,0,0,17
21097,2023/03/25,6,0,0,0,6
21103,2023/03/25,14,0,1,0,15
21132,2023/03/25,13,15,9,0,22
21171,2023/03/25,4,0,2,0,6
21174,2023/03/25,14,12,9,0,23
21175,2023/03/25,11,8,8,0,19
21176,2023/03/25,6,4,2,0,8
21570,2023/03/25,8,0,1,0,9
21577,2023/03/25,4,4,4,0,8
21578,2023/03/25,6,0,3,0,9
75,2023/03/26,19,28,24,0,43
76,2023/03/26,16,28,27,0,43
117,2023/03/26,0,0,2,0,2
118,2023/03/26,8,8,1,0,9
119,2023/03/26,6,4,2,0,8
120,2023/03/26,4,0,0,0,4
149,2023/03/26,5,0,0,0,5
184,2023/03/26,2,3,2,0,4
195,2023/03/26,3,21,8,0,11
218,2023/03/26,24,27,25,0,49
296,2023/03/26,6,4,2,0,8
300,2023/03/26,3,0,4,0,7
304,2023/03/26,12,4,8,0,20
317,2023/03/26,12,12,11,0,23
343,2023/03/26,5,0,3,0,8
353,2023/03/26,9,0,0,0,9
373,2023/03/26,0,0,0,0,0
374,2023/03/26,9,8,5,0,14
388,2023/03/26,16,15,15,0,31
419,2023/03/26,6,6,6,0,12
420,2023/03/26,6,6,4,0,10
462,2023/03/26,16,8,9,0,25
519,2023/03/26,17,12,11,0,28
525,2023/03/26,8,5,0,0,8
596,2023/03/26,7,4,7,0,14
597,2023/03/26,7,0,10,0,17
598,2023/03/26,9,6,2,1,11
1035,2023/03/26,7,6,2,0,9
1084,2023/03/26,18,10,9,2,27
1111,2023/03/26,10,0,1,0,11
1112,2023/03/26,11,0,0,0,11
1113,2023/03/26,12,0,0,0,12
1114,2023/03/26,15,0,6,0,21
1115,2023/03/26,10,0,4,0,14
1117,2023/03/26,4,0,1,0,5
1118,2023/03/26,8,0,0,0,8
1119,2023/03/26,6,0,0,0,6
1692,2023/03/26,7,6,5,0,12
1693,2023/03/26,6,6,3,0,9
1747,2023/03/26,24,15,16,0,40
1772,2023/03/26,13,0,2,0,15
1773,2023/03/26,10,0,2,0,12
1774,2023/03/26,7,0,0,0,7
1782,2023/03/26,26,18,22,0,48
1795,2023/03/26,2,0,1,0,3
1914,2023/03/26,6,0,0,0,6
1915,2023/03/26,12,6,1,0,13
1923,2023/03/26,8,0,3,0,11
1934,2023/03/26,1,0,0,0,1
1963,2023/03/26,6,6,6,0,12
1984,2023/03/26,5,0,3,0,8
2135,2023/03/26,7,0,3,0,10
2136,2023/03/26,12,6,1,0,13
2148,2023/03/26,5,4,2,0,7
2183,2023/03/26,0,0,0,0,0
2193,2023/03/26,4,9,7,0,11
2237,2023/03/26,7,0,1,0,8
2358,2023/03/26,12,8,4,0,16
2361,2023/03/26,8,7,7,0,15
2445,2023/03/26,7,6,5,0,12
2449,2023/03/26,6,6,6,0,12
2451,2023/03/26,67,55,10,0,77
2476,2023/03/26,9,0,1,0,10
2507,2023/03/26,11,12,10,1,21
2525,2023/03/26,10,0,2,0,12
2562,2023/03/26,6,6,3,0,9
2582,2023/03/26,4,0,3,0,7
2586,2023/03/26,26,12,17,0,43
2602,2023/03/26,13,8,0,0,13
2631,2023/03/26,0,0,0,0,0
2685,2023/03/26,6,0,2,2,8
2723,2023/03/26,11,0,2,0,13
2730,2023/03/26,7,0,1,0,8
2731,2023/03/26,12,6,3,0,15
2732,2023/03/26,7,0,1,0,8
2734,2023/03/26,6,0,0,0,6
2735,2023/03/26,8,4,4,0,12
2761,2023/03/26,14,5,30,3,44
2788,2023/03/26,6,12,10,0,16
2802,2023/03/26,5,0,0,0,5
2812,2023/03/26,12,0,3,0,15
2813,2023/03/26,3,0,0,0,3
2814,2023/03/26,10,6,3,0,13
2913,2023/03/26,1,0,1,0,2
2914,2023/03/26,10,0,0,0,10
3015,2023/03/26,12,0,2,0,14
3035,2023/03/26,7,0,1,0,8
4446,2023/03/26,11,12,8,0,19
12136,2023/03/26,16,24,19,0,35
12516,2023/03/26,8,4,4,0,12
12518,2023/03/26,8,4,6,0,14
12523,2023/03/26,18,12,10,0,28
16062,2023/03/26,7,0,1,0,8
16063,2023/03/26,7,0,3,0,10
16276,2023/03/26,4,4,3,0,7
19322,2023/03/26,8,0,0,0,8
19329,2023/03/26,8,0,1,0,9
19520,2023/03/26,5,0,1,0,6
19521,2023/03/26,17,8,1,0,18
20920,2023/03/26,17,0,1,0,18
21097,2023/03/26,6,0,1,0,7
21103,2023/03/26,13,0,0,0,13
21132,2023/03/26,16,12,19,0,35
21171,2023/03/26,6,4,6,0,12
21174,2023/03/26,17,12,11,0,28
21175,2023/03/26,11,8,5,7,16
21176,2023/03/26,4,0,2,0,6
21570,2023/03/26,7,0,0,0,7
21577,2023/03/26,8,8,2,0,10
21578,2023/03/26,15,12,0,0,15
75,2023/03/27,39,44,28,0,67
76,2023/03/27,33,44,33,0,66
117,2023/03/27,2,4,2,0,4
118,2023/03/27,11,4,3,0,14
119,2023/03/27,4,0,0,0,4
120,2023/03/27,8,4,1,0,9
149,2023/03/27,5,0,0,0,5
184,2023/03/27,9,9,9,0,18
195,2023/03/27,30,36,29,0,59
218,2023/03/27,31,33,40,0,71
296,2023/03/27,12,8,8,0,20
300,2023/03/27,3,4,0,0,3
304,2023/03/27,8,4,2,1,10
317,2023/03/27,13,12,9,0,22
343,2023/03/27,6,4,1,0,7
353,2023/03/27,9,0,1,0,10
373,2023/03/27,6,6,1,0,7
374,2023/03/27,4,0,1,0,5
388,2023/03/27,28,27,16,0,44
419,2023/03/27,6,6,6,0,12
420,2023/03/27,2,0,2,0,4
462,2023/03/27,15,8,11,0,26
519,2023/03/27,12,6,3,0,15
525,2023/03/27,8,0,0,0,8
596,2023/03/27,0,0,7,0,7
597,2023/03/27,3,6,0,0,3
598,2023/03/27,6,0,2,0,8
1035,2023/03/27,5,0,5,0,10
1084,2023/03/27,12,5,15,5,27
1111,2023/03/27,9,0,0,0,9
1112,2023/03/27,11,0,0,0,11
1113,2023/03/27,12,0,1,0,13
1114,2023/03/27,9,0,5,0,14
1115,2023/03/27,6,0,3,0,9
1117,2023/03/27,3,0,1,0,4
1118,2023/03/27,8,0,0,0,8
1119,2023/03/27,6,0,0,0,6
1692,2023/03/27,8,6,6,0,14
1693,2023/03/27,9,6,6,0,15
1747,2023/03/27,23,15,15,4,38
1772,2023/03/27,11,0,0,0,11
1773,2023/03/27,8,0,0,0,8
1774,2023/03/27,7,0,0,0,7
1782,2023/03/27,22,18,35,0,57
1795,2023/03/27,15,14,12,0,27
1914,2023/03/27,6,0,0,0,6
1915,2023/03/27,11,0,2,0,13
1923,2023/03/27,5,0,0,0,5
1934,2023/03/27,6,5,0,0,6
1963,2023/03/27,12,12,8,0,20
1984,2023/03/27,8,6,2,0,10
2135,2023/03/27,10,6,0,0,10
2136,2023/03/27,11,0,2,0,13
2148,2023/03/27,3,0,0,0,3
2183,2023/03/27,6,6,6,0,12
2193,2023/03/27,21,24,18,0,39
2237,2023/03/27,6,0,2,0,8
2358,2023/03/27,8,0,5,0,13
2361,2023/03/27,8,7,7,1,15
2445,2023/03/27,8,6,4,0,12
2449,2023/03/27,6,6,7,0,13
2451,2023/03/27,57,0,16,0,73
2476,2023/03/27,8,0,0,0,8
2507,2023/03/27,5,6,5,0,10
2525,2023/03/27,8,0,1,0,9
2562,2023/03/27,9,6,7,0,16
2582,2023/03/27,1,0,0,0,1
2586,2023/03/27,17,8,20,3,37
2602,2023/03/27,13,0,2,0,15
2631,2023/03/27,6,6,6,0,12
2685,2023/03/27,10,8,9,1,19
2723,2023/03/27,9,0,0,0,9
2730,2023/03/27,6,0,0,0,6
2731,2023/03/27,9,0,0,0,9
2732,2023/03/27,6,0,0,0,6
2734,2023/03/27,6,0,5,0,11
2735,2023/03/27,8,4,3,0,11
2761,2023/03/27,-4,15,19,0,15
2788,2023/03/27,20,24,19,0,39
2802,2023/03/27,5,0,0,0,5
2812,2023/03/27,9,0,1,0,10
2813,2023/03/27,3,0,0,0,3
2814,2023/03/27,7,0,2,0,9
2913,2023/03/27,0,0,0,0,0
2914,2023/03/27,10,0,0,0,10
3015,2023/03/27,10,0,1,0,11
3035,2023/03/27,6,0,0,0,6
4446,2023/03/27,15,12,15,0,30
12136,2023/03/27,27,30,23,0,50
12516,2023/03/27,4,0,6,0,10
12518,2023/03/27,6,4,5,0,11
12523,2023/03/27,8,0,4,0,12
16062,2023/03/27,6,0,3,0,9
16063,2023/03/27,4,0,1,0,5
16276,2023/03/27,1,0,1,0,2
19322,2023/03/27,8,0,1,0,9
19329,2023/03/27,7,0,0,0,7
19520,2023/03/27,4,0,2,0,6
19521,2023/03/27,16,0,1,0,17
20920,2023/03/27,16,0,2,0,18
21097,2023/03/27,5,0,0,0,5
21103,2023/03/27,13,0,0,0,13
21132,2023/03/27,21,24,25,0,46
21171,2023/03/27,4,4,5,0,9
21174,2023/03/27,14,8,13,1,27
21175,2023/03/27,11,12,12,4,23
21176,2023/03/27,6,4,2,0,8
21570,2023/03/27,7,0,0,0,7
21577,2023/03/27,6,0,4,0,10
21578,2023/03/27,15,0,5,0,20
21598,2023/03/27,6,6,1,0,7
21599,2023/03/27,4,4,4,0,8
21600,2023/03/27,4,4,2,0,6
21601,2023/03/27,4,4,1,0,5
21605,2023/03/27,6,6,2,0,8
21606,2023/03/27,6,6,1,0,7
21607,2023/03/27,6,6,5,0,11
75,2023/03/28,55,44,36,5,91
76,2023/03/28,52,52,43,0,95
117,2023/03/28,4,4,0,0,4
118,2023/03/28,8,0,2,0,10
119,2023/03/28,4,0,1,1,5
120,2023/03/28,7,0,4,0,11
149,2023/03/28,5,0,0,0,5
184,2023/03/28,12,12,9,0,21
195,2023/03/28,41,39,21,3,62
218,2023/03/28,31,39,33,0,64
296,2023/03/28,4,0,1,0,5
300,2023/03/28,7,4,5,0,12
304,2023/03/28,5,0,2,0,7
317,2023/03/28,4,0,6,0,10
343,2023/03/28,5,0,0,0,5
353,2023/03/28,8,0,0,0,8
373,2023/03/28,11,6,10,1,21
374,2023/03/28,11,8,4,0,15
388,2023/03/28,33,21,16,6,49
419,2023/03/28,6,6,6,0,12
420,2023/03/28,6,6,4,0,10
462,2023/03/28,12,8,7,0,19
519,2023/03/28,9,0,6,0,15
525,2023/03/28,8,0,0,0,8
596,2023/03/28,-3,4,4,0,1
597,2023/03/28,21,18,10,0,31
598,2023/03/28,4,0,0,0,4
1035,2023/03/28,0,0,0,0,0
1084,2023/03/28,2,10,11,3,13
1112,2023/03/28,11,0,0,0,11
1113,2023/03/28,11,0,2,0,13
1114,2023/03/28,4,0,0,0,4
1115,2023/03/28,3,0,1,0,4
1117,2023/03/28,10,8,0,0,10
1118,2023/03/28,8,0,0,0,8
1119,2023/03/28,6,0,0,0,6
1692,2023/03/28,8,6,7,0,15
1693,2023/03/28,3,0,3,0,6
1747,2023/03/28,34,30,19,3,53
1772,2023/03/28,11,0,2,0,13
1773,2023/03/28,8,0,3,0,11
1774,2023/03/28,7,0,2,0,9
1782,2023/03/28,14,27,21,0,35
1795,2023/03/28,24,21,14,0,38
1914,2023/03/28,6,0,1,0,7
1915,2023/03/28,9,0,1,0,10
1923,2023/03/28,5,0,2,0,7
1934,2023/03/28,6,0,1,0,7
1963,2023/03/28,16,12,13,0,29
1984,2023/03/28,6,0,2,0,8
2135,2023/03/28,10,0,2,0,12
2136,2023/03/28,9,0,0,0,9
2148,2023/03/28,7,4,4,0,11
2183,2023/03/28,0,0,0,0,0
2193,2023/03/28,30,27,16,4,46
2237,2023/03/28,10,6,3,0,13
2358,2023/03/28,11,8,1,0,12
2361,2023/03/28,0,0,2,0,2
2445,2023/03/28,4,0,0,0,4
2449,2023/03/28,-1,0,0,0,-1
2451,2023/03/28,41,0,12,0,53
2476,2023/03/28,8,0,0,0,8
2507,2023/03/28,12,12,11,0,23
2525,2023/03/28,7,0,0,0,7
2562,2023/03/28,2,0,2,0,4
2582,2023/03/28,5,4,1,0,6
2586,2023/03/28,18,24,20,0,38
2602,2023/03/28,11,0,2,0,13
2631,2023/03/28,6,6,5,0,11
2685,2023/03/28,8,8,7,0,15
2723,2023/03/28,9,0,1,0,10
2730,2023/03/28,6,0,0,0,6
2731,2023/03/28,9,0,0,0,9
2732,2023/03/28,6,0,3,0,9
2734,2023/03/28,5,4,2,0,7
2735,2023/03/28,9,4,4,0,13
2761,2023/03/28,-8,15,12,0,4
2788,2023/03/28,25,24,21,0,46
2802,2023/03/28,5,0,0,0,5
2812,2023/03/28,8,0,1,0,9
2813,2023/03/28,9,6,0,0,9
2814,2023/03/28,5,0,0,0,5
2913,2023/03/28,6,6,2,0,8
2914,2023/03/28,10,0,0,0,10
3015,2023/03/28,9,0,3,0,12
3035,2023/03/28,6,0,0,0,6
4446,2023/03/28,12,12,9,0,21
12136,2023/03/28,43,39,29,0,72
12482,2023/03/28,6,6,6,0,12
12516,2023/03/28,2,4,2,0,4
12518,2023/03/28,1,0,0,0,1
12523,2023/03/28,8,4,1,0,9
16062,2023/03/28,3,0,0,0,3
16063,2023/03/28,9,6,0,0,9
16276,2023/03/28,0,0,0,0,0
19322,2023/03/28,7,0,0,0,7
19329,2023/03/28,7,0,0,0,7
19516,2023/03/28,6,6,6,0,12
19520,2023/03/28,2,0,3,0,5
19521,2023/03/28,15,0,0,0,15
20920,2023/03/28,14,0,0,0,14
21103,2023/03/28,13,0,0,0,13
21132,2023/03/28,20,24,12,0,32
21171,2023/03/28,-1,0,0,0,-1
21174,2023/03/28,8,8,9,0,17
21175,2023/03/28,3,8,6,0,9
21176,2023/03/28,12,8,1,0,13
21570,2023/03/28,13,6,0,0,13
21577,2023/03/28,6,4,5,0,11
21578,2023/03/28,18,8,5,0,23
21598,2023/03/28,5,0,0,0,5
21599,2023/03/28,0,0,0,0,0
21600,2023/03/28,2,0,1,0,3
21601,2023/03/28,3,0,2,0,5
21603,2023/03/28,6,0,2,0,8
21604,2023/03/28,6,0,2,0,8
21605,2023/03/28,4,0,3,0,7
21606,2023/03/28,5,0,1,0,6
21607,2023/03/28,1,0,1,0,2
21608,2023/03/28,6,0,3,0,9
75,2023/03/29,58,88,43,4,101
76,2023/03/29,57,92,52,9,109
99,2023/03/29,5,0,0,0,5
117,2023/03/29,8,4,1,0,9
118,2023/03/29,10,4,4,0,14
119,2023/03/29,6,8,4,0,10
120,2023/03/29,3,0,2,0,5
149,2023/03/29,5,0,0,0,5
184,2023/03/29,15,12,8,0,23
195,2023/03/29,50,66,27,9,77
218,2023/03/29,32,33,29,3,61
296,2023/03/29,11,16,3,0,14
300,2023/03/29,6,8,2,0,8
304,2023/03/29,3,8,1,0,4
317,2023/03/29,6,18,4,0,10
343,2023/03/29,5,4,2,0,7
353,2023/03/29,8,0,0,0,8
373,2023/03/29,0,6,0,0,0
374,2023/03/29,15,12,8,0,23
388,2023/03/29,41,54,17,16,58
419,2023/03/29,0,12,0,0,0
420,2023/03/29,8,6,8,0,16
462,2023/03/29,13,16,6,0,19
519,2023/03/29,14,24,6,0,20
525,2023/03/29,8,0,5,0,13
596,2023/03/29,1,12,10,0,11
597,2023/03/29,23,12,17,0,40
598,2023/03/29,10,6,2,0,12
1035,2023/03/29,6,6,2,0,8
1084,2023/03/29,-2,15,9,0,7
1112,2023/03/29,11,0,0,0,11
1113,2023/03/29,9,0,1,0,10
1114,2023/03/29,4,6,2,0,6
1115,2023/03/29,8,6,3,0,11
1117,2023/03/29,10,0,1,0,11
1118,2023/03/29,8,0,0,0,8
1119,2023/03/29,6,0,0,0,6
1692,2023/03/29,7,12,6,0,13
1693,2023/03/29,6,6,6,0,12
1747,2023/03/29,37,40,9,0,46
1772,2023/03/29,9,0,0,0,9
1773,2023/03/29,5,0,0,0,5
1774,2023/03/29,5,0,1,0,6
1782,2023/03/29,14,48,19,0,33
1795,2023/03/29,31,42,16,0,47
1914,2023/03/29,11,6,0,0,11
1915,2023/03/29,8,0,1,0,9
1923,2023/03/29,9,6,0,0,9
1934,2023/03/29,5,0,3,0,8
1963,2023/03/29,3,18,3,0,6
1984,2023/03/29,3,0,2,0,5
2135,2023/03/29,8,0,2,0,10
2136,2023/03/29,9,0,0,0,9
2148,2023/03/29,7,8,3,0,10
2183,2023/03/29,6,6,2,0,8
2193,2023/03/29,28,18,17,7,45
2237,2023/03/29,7,0,1,0,8
2358,2023/03/29,10,4,9,0,19
2361,2023/03/29,5,14,5,0,10
2445,2023/03/29,12,12,2,0,14
2449,2023/03/29,11,18,10,0,21
2451,2023/03/29,29,15,8,0,37
2476,2023/03/29,8,0,1,0,9
2507,2023/03/29,13,24,9,0,22
2525,2023/03/29,7,0,0,0,7
2562,2023/03/29,12,18,9,0,21
2582,2023/03/29,8,8,0,0,8
2586,2023/03/29,14,16,11,1,25
2602,2023/03/29,9,0,0,0,9
2631,2023/03/29,1,0,1,0,2
2685,2023/03/29,5,4,6,0,11
2723,2023/03/29,8,0,0,0,8
2730,2023/03/29,6,0,1,0,7
2731,2023/03/29,9,0,1,0,10
2732,2023/03/29,3,0,0,0,3
2734,2023/03/29,3,0,2,0,5
2735,2023/03/29,5,4,1,0,6
2761,2023/03/29,0,40,17,0,17
2788,2023/03/29,24,48,15,5,39
2802,2023/03/29,11,6,0,0,11
2812,2023/03/29,13,6,0,0,13
2813,2023/03/29,9,0,0,0,9
2814,2023/03/29,11,6,1,0,12
2913,2023/03/29,4,6,0,0,4
2914,2023/03/29,10,0,2,0,12
3015,2023/03/29,6,0,0,0,6
3035,2023/03/29,6,0,1,0,7
4446,2023/03/29,18,15,15,0,33
12136,2023/03/29,50,36,17,14,67
12482,2023/03/29,0,6,0,0,0
12516,2023/03/29,4,8,1,0,5
12518,2023/03/29,5,12,3,0,8
12523,2023/03/29,11,8,2,0,13
16062,2023/03/29,3,6,1,0,4
16063,2023/03/29,9,0,1,0,10
16276,2023/03/29,4,8,4,0,8
19322,2023/03/29,7,0,0,0,7
19329,2023/03/29,7,0,1,0,8
19516,2023/03/29,0,6,0,0,0
19520,2023/03/29,-1,8,1,0,0
19521,2023/03/29,15,0,1,0,16
21103,2023/03/29,13,0,2,0,15
21132,2023/03/29,23,39,17,4,40
21171,2023/03/29,-1,4,0,0,-1
21174,2023/03/29,15,16,7,0,22
21175,2023/03/29,9,12,10,0,19
21176,2023/03/29,15,4,7,2,22
21570,2023/03/29,13,0,1,0,14
21577,2023/03/29,5,8,2,0,7
21578,2023/03/29,13,0,6,0,19
21598,2023/03/29,11,12,2,0,13
21599,2023/03/29,4,8,3,0,7
21600,2023/03/29,5,8,4,0,9
21601,2023/03/29,5,8,2,0,7
21603,2023/03/29,10,6,5,0,15
21604,2023/03/29,10,6,1,0,11
21605,2023/03/29,7,6,3,0,10
21606,2023/03/29,10,6,3,0,13
21607,2023/03/29,0,0,0,0,0
21608,2023/03/29,3,6,1,0,4
75,2023/03/30,59,0,47,0,106
76,2023/03/30,40,0,44,0,84
99,2023/03/30,5,0,0,0,5
117,2023/03/30,7,0,1,2,8
118,2023/03/30,6,0,0,0,6
119,2023/03/30,6,0,0,0,6
120,2023/03/30,1,0,0,1,1
149,2023/03/30,5,0,0,0,5
184,2023/03/30,7,0,6,0,13
195,2023/03/30,47,0,41,0,88
218,2023/03/30,32,33,29,0,61
296,2023/03/30,16,0,5,0,21
300,2023/03/30,8,0,4,0,12
304,2023/03/30,10,0,3,0,13
317,2023/03/30,12,0,8,0,20
343,2023/03/30,7,0,1,0,8
353,2023/03/30,8,0,1,0,9
373,2023/03/30,6,0,5,0,11
374,2023/03/30,11,0,1,0,12
388,2023/03/30,32,0,21,0,53
419,2023/03/30,12,0,11,0,23
420,2023/03/30,0,0,0,0,0
462,2023/03/30,15,0,5,0,20
519,2023/03/30,20,0,5,0,25
525,2023/03/30,3,0,0,0,3
596,2023/03/30,-1,0,0,0,-1
597,2023/03/30,33,24,11,0,44
598,2023/03/30,8,0,1,0,9
1035,2023/03/30,4,0,1,0,5
1084,2023/03/30,6,10,6,0,12
1113,2023/03/30,8,0,1,0,9
1114,2023/03/30,8,0,2,0,10
1115,2023/03/30,5,0,0,0,5
1117,2023/03/30,9,0,1,0,10
1118,2023/03/30,8,0,2,0,10
1119,2023/03/30,6,0,0,0,6
1692,2023/03/30,7,0,4,0,11
1693,2023/03/30,0,0,0,0,0
1747,2023/03/30,43,0,27,0,70
1772,2023/03/30,9,0,2,0,11
1773,2023/03/30,5,0,1,0,6
1774,2023/03/30,4,0,1,0,5
1782,2023/03/30,23,0,27,1,50
1795,2023/03/30,36,0,17,0,53
1914,2023/03/30,11,0,0,0,11
1915,2023/03/30,7,0,0,0,7
1923,2023/03/30,9,0,2,0,11
1934,2023/03/30,2,0,2,0,4
1963,2023/03/30,18,0,9,0,27
1984,2023/03/30,1,0,1,0,2
2135,2023/03/30,6,0,1,0,7
2136,2023/03/30,9,0,0,0,9
2148,2023/03/30,8,0,3,0,11
2183,2023/03/30,10,6,3,0,13
2193,2023/03/30,23,18,11,1,34
2237,2023/03/30,6,0,1,0,7
2358,2023/03/30,5,0,3,0,8
2361,2023/03/30,7,0,0,0,7
2445,2023/03/30,16,6,8,0,24
2449,2023/03/30,7,0,7,0,14
2451,2023/03/30,36,0,12,0,48
2476,2023/03/30,7,0,0,0,7
2507,2023/03/30,16,0,8,0,24
2525,2023/03/30,7,0,0,0,7
2562,2023/03/30,9,0,3,0,12
2582,2023/03/30,12,0,2,0,14
2586,2023/03/30,14,12,18,0,32
2602,2023/03/30,9,0,2,0,11
2631,2023/03/30,6,6,1,0,7
2685,2023/03/30,7,8,4,0,11
2723,2023/03/30,8,0,2,0,10
2730,2023/03/30,5,0,1,0,6
2731,2023/03/30,8,0,0,0,8
2732,2023/03/30,3,0,1,0,4
2734,2023/03/30,1,0,2,0,3
2735,2023/03/30,8,0,1,0,9
2761,2023/03/30,5,0,8,0,13
2788,2023/03/30,32,0,17,0,49
2802,2023/03/30,11,0,0,0,11
2812,2023/03/30,13,0,0,0,13
2813,2023/03/30,9,0,1,0,10
2814,2023/03/30,10,0,0,0,10
2913,2023/03/30,10,0,3,0,13
2914,2023/03/30,8,0,0,0,8
3015,2023/03/30,6,0,2,0,8
3033,2023/03/30,5,0,1,0,6
3035,2023/03/30,5,0,1,0,6
4446,2023/03/30,12,9,10,1,22
12136,2023/03/30,49,30,29,0,78
12482,2023/03/30,6,0,6,0,12
12516,2023/03/30,7,0,5,0,12
12518,2023/03/30,10,0,1,0,11
12523,2023/03/30,13,0,5,0,18
16062,2023/03/30,8,0,1,0,9
16063,2023/03/30,8,0,1,0,9
16276,2023/03/30,4,0,1,0,5
19322,2023/03/30,7,0,0,0,7
19329,2023/03/30,6,0,0,0,6
19516,2023/03/30,6,0,2,0,8
19520,2023/03/30,6,0,1,0,7
19521,2023/03/30,14,0,1,0,15
21103,2023/03/30,11,0,2,0,13
21132,2023/03/30,26,0,16,0,42
21171,2023/03/30,3,0,2,0,5
21174,2023/03/30,20,12,10,0,30
21175,2023/03/30,11,12,18,0,29
21176,2023/03/30,14,8,9,7,23
21570,2023/03/30,12,0,1,0,13
21577,2023/03/30,7,0,2,0,9
21578,2023/03/30,7,0,2,0,9
21598,2023/03/30,15,0,2,0,17
21599,2023/03/30,5,0,2,0,7
21600,2023/03/30,5,0,2,0,7
21601,2023/03/30,7,0,1,0,8
21603,2023/03/30,5,0,3,0,8
21604,2023/03/30,9,0,2,0,11
21605,2023/03/30,4,0,3,0,7
21606,2023/03/30,7,0,4,0,11
21607,2023/03/30,6,6,2,0,8
21608,2023/03/30,8,0,2,0,10
75,2023/03/31,48,40,40,0,88
76,2023/03/31,40,44,42,1,82
99,2023/03/31,5,0,0,0,5
117,2023/03/31,8,4,1,0,9
118,2023/03/31,10,4,6,0,16
119,2023/03/31,6,0,0,0,6
120,2023/03/31,0,0,0,0,0
149,2023/03/31,5,0,2,0,7
184,2023/03/31,22,21,12,0,34
195,2023/03/31,45,39,42,2,87
218,2023/03/31,36,33,38,0,74
296,2023/03/31,15,4,3,0,18
300,2023/03/31,8,4,2,0,10
304,2023/03/31,7,0,3,0,10
317,2023/03/31,16,12,11,0,27
343,2023/03/31,6,0,0,0,6
353,2023/03/31,7,0,0,0,7
373,2023/03/31,7,6,4,0,11
374,2023/03/31,14,4,6,0,20
388,2023/03/31,20,9,17,2,37
419,2023/03/31,7,6,4,0,11
420,2023/03/31,6,6,2,0,8
462,2023/03/31,18,8,3,1,21
519,2023/03/31,27,12,9,0,36
525,2023/03/31,3,0,2,0,5
596,2023/03/31,7,12,7,0,14
597,2023/03/31,43,24,12,0,55
598,2023/03/31,13,6,1,0,14
1035,2023/03/31,15,12,7,1,22
1084,2023/03/31,18,20,14,1,32
1111,2023/03/31,9,0,0,0,9
1113,2023/03/31,7,0,1,0,8
1114,2023/03/31,6,0,6,0,12
1115,2023/03/31,5,0,4,0,9
1117,2023/03/31,8,0,1,0,9
1118,2023/03/31,6,0,1,0,7
1119,2023/03/31,6,0,0,0,6
1692,2023/03/31,9,6,3,1,12
1693,2023/03/31,6,6,2,0,8
1747,2023/03/31,46,30,38,0,84
1772,2023/03/31,7,0,0,0,7
1773,2023/03/31,10,6,1,0,11
1774,2023/03/31,3,0,1,0,4
1782,2023/03/31,21,27,25,0,46
1795,2023/03/31,26,7,20,0,46
1914,2023/03/31,11,0,0,0,11
1915,2023/03/31,7,0,2,0,9
1923,2023/03/31,7,0,4,0,11
1934,2023/03/31,5,5,1,0,6
1963,2023/03/31,15,6,6,0,21
1984,2023/03/31,6,6,2,0,8
2135,2023/03/31,5,0,3,0,8
2136,2023/03/31,9,0,2,0,11
2148,2023/03/31,9,4,3,0,12
2183,2023/03/31,13,6,10,0,23
2193,2023/03/31,28,18,23,2,51
2237,2023/03/31,11,6,1,0,12
2358,2023/03/31,6,4,3,0,9
2361,2023/03/31,21,14,5,0,26
2445,2023/03/31,14,6,13,0,27
2449,2023/03/31,6,6,7,0,13
2451,2023/03/31,59,35,12,0,71
2476,2023/03/31,7,0,1,0,8
2507,2023/03/31,20,12,11,0,31
2525,2023/03/31,7,0,0,0,7
2562,2023/03/31,12,6,3,0,15
2582,2023/03/31,14,4,1,0,15
2586,2023/03/31,20,24,13,0,33
2602,2023/03/31,7,0,0,0,7
2631,2023/03/31,11,6,8,0,19
2685,2023/03/31,11,8,7,0,18
2723,2023/03/31,6,0,0,0,6
2730,2023/03/31,4,0,2,0,6
2731,2023/03/31,8,0,1,0,9
2732,2023/03/31,10,8,2,0,12
2734,2023/03/31,3,4,1,0,4
2735,2023/03/31,11,4,1,0,12
2761,2023/03/31,15,20,17,0,32
2788,2023/03/31,35,20,25,5,60
2802,2023/03/31,11,0,1,0,12
2812,2023/03/31,13,0,2,0,15
2813,2023/03/31,8,0,0,0,8
2814,2023/03/31,10,0,1,0,11
2913,2023/03/31,7,0,2,0,9
2914,2023/03/31,8,0,1,0,9
3015,2023/03/31,12,8,2,0,14
3033,2023/03/31,4,0,0,0,4
3035,2023/03/31,4,0,0,0,4
4446,2023/03/31,19,18,13,0,32
12136,2023/03/31,50,30,45,8,95
12482,2023/03/31,6,6,4,0,10
12516,2023/03/31,6,4,1,0,7
12518,2023/03/31,17,8,1,0,18
12523,2023/03/31,12,4,4,0,16
16062,2023/03/31,7,0,4,0,11
16063,2023/03/31,7,0,0,0,7
16276,2023/03/31,3,0,0,0,3
19322,2023/03/31,7,0,0,0,7
19329,2023/03/31,6,0,0,0,6
19516,2023/03/31,4,0,0,0,4
19520,2023/03/31,5,0,2,0,7
19521,2023/03/31,13,0,1,0,14
21103,2023/03/31,9,0,0,0,9
21132,2023/03/31,34,24,28,7,62
21171,2023/03/31,5,4,3,0,8
21174,2023/03/31,22,12,15,3,37
21175,2023/03/31,5,12,6,0,11
21176,2023/03/31,6,8,4,0,10
21570,2023/03/31,11,0,1,0,12
21577,2023/03/31,5,0,6,0,11
21578,2023/03/31,5,0,2,0,7
21598,2023/03/31,13,0,2,0,15
21599,2023/03/31,7,4,1,0,8
21600,2023/03/31,7,4,3,0,10
21601,2023/03/31,6,0,2,0,8
21603,2023/03/31,2,0,0,0,2
21604,2023/03/31,7,0,1,0,8
21605,2023/03/31,7,6,1,0,8
21606,2023/03/31,9,6,2,0,11
21607,2023/03/31,4,0,2,0,6
21608,2023/03/31,6,0,0,0,6
75,2023/04/01,36,28,26,0,62
76,2023/04/01,40,44,41,1,81
99,2023/04/01,5,0,0,0,5
117,2023/04/01,7,0,1,0,8
118,2023/04/01,8,4,1,0,9
119,2023/04/01,6,0,1,0,7
120,2023/04/01,4,4,1,0,5
149,2023/04/01,3,0,0,0,3
184,2023/04/01,22,12,19,0,41
195,2023/04/01,40,39,36,0,76
218,2023/04/01,34,36,39,0,73
296,2023/04/01,16,4,3,0,19
300,2023/04/01,10,4,7,0,17
304,2023/04/01,8,4,2,0,10
317,2023/04/01,17,12,3,0,20
343,2023/04/01,6,0,2,0,8
353,2023/04/01,7,0,1,0,8
373,2023/04/01,9,6,4,0,13
374,2023/04/01,8,0,1,0,9
388,2023/04/01,19,18,16,0,35
419,2023/04/01,9,6,1,0,10
420,2023/04/01,4,0,1,0,5
462,2023/04/01,22,8,2,1,24
519,2023/04/01,24,6,10,0,34
525,2023/04/01,1,0,1,0,2
596,2023/04/01,0,0,7,0,7
597,2023/04/01,31,0,16,2,47
598,2023/04/01,12,0,0,0,12
1035,2023/04/01,7,0,6,0,13
1084,2023/04/01,3,0,8,0,11
1111,2023/04/01,9,0,0,0,9
1113,2023/04/01,6,0,0,0,6
1114,2023/04/01,6,6,5,0,11
1115,2023/04/01,7,6,6,0,13
1117,2023/04/01,7,0,3,0,10
1118,2023/04/01,5,0,2,0,7
1119,2023/04/01,6,0,2,0,8
1692,2023/04/01,11,6,1,0,12
1693,2023/04/01,4,0,1,0,5
1747,2023/04/01,28,20,28,0,56
1772,2023/04/01,7,0,0,0,7
1773,2023/04/01,9,0,2,0,11
1774,2023/04/01,10,8,0,0,10
1782,2023/04/01,20,24,23,0,43
1795,2023/04/01,27,21,20,0,47
1914,2023/04/01,11,0,2,0,13
1915,2023/04/01,5,0,1,0,6
1923,2023/04/01,3,0,2,0,5
1934,2023/04/01,9,5,3,0,12
1963,2023/04/01,21,12,3,0,24
1984,2023/04/01,4,0,5,0,9
2135,2023/04/01,8,6,5,0,13
2136,2023/04/01,7,0,4,0,11
2148,2023/04/01,10,4,4,0,14
2183,2023/04/01,9,6,11,0,20
2193,2023/04/01,15,12,13,0,28
2237,2023/04/01,10,0,2,0,12
2358,2023/04/01,3,0,0,0,3
2361,2023/04/01,23,7,7,0,30
2445,2023/04/01,7,6,5,0,12
2449,2023/04/01,5,6,4,0,9
2451,2023/04/01,47,0,14,0,61
2476,2023/04/01,6,0,0,0,6
2507,2023/04/01,21,12,13,0,34
2525,2023/04/01,7,0,3,0,10
2562,2023/04/01,15,6,6,0,21
2582,2023/04/01,13,0,1,0,14
2586,2023/04/01,27,20,19,2,46
2602,2023/04/01,7,0,0,0,7
2631,2023/04/01,9,6,10,0,19
2685,2023/04/01,8,4,7,0,15
2723,2023/04/01,6,0,2,0,8
2730,2023/04/01,2,0,2,0,4
2731,2023/04/01,7,0,2,0,9
2732,2023/04/01,8,0,0,0,8
2734,2023/04/01,6,4,2,0,8
2735,2023/04/01,14,4,4,0,18
2761,2023/04/01,13,15,13,5,26
2788,2023/04/01,25,20,22,0,47
2802,2023/04/01,10,0,0,0,10
2812,2023/04/01,11,0,2,0,13
2813,2023/04/01,8,0,1,0,9
2814,2023/04/01,9,0,2,0,11
2913,2023/04/01,5,0,1,0,6
2914,2023/04/01,7,0,0,0,7
3015,2023/04/01,10,0,2,0,12
3033,2023/04/01,4,0,0,0,4
3035,2023/04/01,4,0,0,0,4
4446,2023/04/01,15,9,13,0,28
12136,2023/04/01,18,21,18,0,36
12482,2023/04/01,8,6,2,0,10
12516,2023/04/01,9,4,5,0,14
12518,2023/04/01,20,4,0,0,20
12523,2023/04/01,12,4,1,0,13
16062,2023/04/01,3,0,1,0,4
16063,2023/04/01,7,0,1,0,8
16276,2023/04/01,3,0,0,0,3
19322,2023/04/01,7,0,1,0,8
19329,2023/04/01,6,0,0,0,6
19516,2023/04/01,4,0,0,0,4
19520,2023/04/01,3,0,0,0,3
19521,2023/04/01,12,0,0,0,12
21102,2023/04/01,7,0,1,0,8
21103,2023/04/01,9,0,3,0,12
21132,2023/04/01,11,12,15,1,26
21171,2023/04/01,6,4,2,0,8
21174,2023/04/01,12,8,10,0,22
21175,2023/04/01,7,8,12,0,19
21176,2023/04/01,2,0,3,0,5
21570,2023/04/01,10,0,1,0,11
21577,2023/04/01,3,4,3,0,6
21578,2023/04/01,7,4,2,0,9
21598,2023/04/01,11,0,0,0,11
21599,2023/04/01,10,4,2,0,12
21600,2023/04/01,4,0,1,0,5
21601,2023/04/01,8,4,4,0,12
21603,2023/04/01,8,6,0,0,8
21604,2023/04/01,6,0,2,0,8
21605,2023/04/01,6,0,3,0,9
21606,2023/04/01,7,0,0,0,7
21607,2023/04/01,8,6,3,0,11
21608,2023/04/01,6,0,2,0,8
